player_id,firstName,lastName,birthDate,primaryPosition,shootsCatches,season,gamesPlayed,goals,assists,points,pointsPerGame,plusMinus,shots,shootingPercentage,penaltyMinutes,timeOnIce,avgTimeOnIce,faceOffWins,faceOffLosses,faceOffTaken,faceOffPercentage,hits,blocks,takeaways,giveaways,turnoverDifferential,powerPlayGoals,powerPlayAssists,powerPlayPoints,powerPlayTimeOnIce,avgPowerPlayTimeOnIce,shortHandedGoals,shortHandedAssists,shortHandedPoints,shortHandedTimeOnIce,avgShortHandedTimeOnIce,salary
8446485,Kris,Draper,1971-05-24,C,L,2010-11,47,6,5,11,0.23,1,57,10.53,12,29468.0,10:26,95,73,168,56.55,45,11,16,8,8,0,0,0,119.0,0:2,0,0,0,2406.0,0:51,-111
8449645,Mike,Modano,1970-06-07,C,L,2010-11,40,4,11,15,0.38,-4,79,5.06,8,29876.0,12:26,133,141,274,48.54,7,10,14,13,1,1,5,6,6083.0,2:32,0,0,0,23.0,0:0,1250000
8450725,Mark,Recchi,1968-02-01,RW,L,2010-11,81,14,34,48,0.59,13,132,10.61,35,78269.0,16:6,52,45,97,53.61,81,25,16,32,-16,6,11,17,13042.0,2:41,0,1,1,3508.0,0:43,1000000
8455919,Craig,Conroy,1971-09-04,C,R,2010-11,18,2,0,2,0.11,-1,11,18.18,8,10046.0,9:18,101,88,189,53.44,21,10,4,10,-6,0,0,0,65.0,0:3,0,0,0,2521.0,2:20,500000
8456283,Adam,Foote,1971-07-10,D,R,2010-11,47,0,8,8,0.17,-9,23,0.0,33,50549.0,17:55,0,0,0,0.0,55,67,4,15,-11,0,0,0,403.0,0:8,0,0,0,8023.0,2:50,1000000
8457063,Nicklas,Lidstrom,1970-04-28,D,L,2010-11,82,16,46,62,0.76,-2,175,9.14,20,115465.0,23:28,0,0,0,0.0,49,92,33,33,0,7,32,39,19932.0,4:3,0,1,1,13142.0,2:40,6200000
8457981,Teemu,Selanne,1970-07-03,RW,R,2010-11,73,31,49,80,1.1,6,213,14.55,49,78572.0,17:56,97,121,218,44.5,15,20,37,45,-8,16,18,34,15177.0,3:27,0,0,0,98.0,0:1,3250000
8458361,Doug,Weight,1971-01-21,C,L,2010-11,18,2,7,9,0.5,-3,26,7.69,10,18927.0,17:31,57,53,110,51.82,9,4,9,20,-11,1,4,5,5364.0,4:58,0,0,0,22.0,0:1,850000
8458520,Peter,Forsberg,1973-07-20,C,L,2010-11,2,0,0,0,0.0,-4,3,0.0,4,2110.0,17:35,0,0,0,0.0,3,0,1,0,1,0,0,0,217.0,1:48,0,0,0,0.0,0:0,1000000
8458525,Brian,Rolston,1973-02-21,RW,L,2010-11,65,14,20,34,0.52,-6,168,8.33,34,68664.0,17:36,52,83,135,38.52,67,20,27,23,4,6,5,11,9719.0,2:29,0,1,1,6053.0,1:33,5062500
8458529,Alex,Kovalev,1973-02-24,RW,L,2010-11,74,16,18,34,0.46,-6,151,10.6,44,73321.0,16:30,3,7,10,30.0,14,8,38,66,-28,6,4,10,12122.0,2:43,0,0,0,597.0,0:8,-111
8458537,Ray,Whitney,1972-05-08,LW,R,2010-11,75,17,40,57,0.76,0,156,10.9,24,76296.0,16:57,45,55,100,45.0,29,15,27,32,-5,3,23,26,15647.0,3:28,0,0,0,64.0,0:0,3000000
8458541,Steve,Staios,1973-07-28,D,R,2010-11,39,3,7,10,0.26,6,23,13.04,24,34440.0,14:43,1,0,1,100.0,42,48,11,13,-2,0,0,0,519.0,0:13,1,0,1,1458.0,0:37,-111
8458543,Jassen,Cullimore,1972-12-04,D,L,2010-11,36,0,8,8,0.22,4,22,0.0,8,27280.0,12:37,0,0,0,0.0,38,34,7,15,-8,0,0,0,122.0,0:3,0,0,0,1482.0,0:41,500000
8458590,Mike,Knuble,1972-07-04,RW,R,2010-11,79,24,16,40,0.51,10,203,11.82,36,84760.0,17:52,10,23,33,30.3,74,31,45,18,27,7,5,12,11028.0,2:19,1,1,2,6566.0,1:23,-111
8458637,Sean,O'Donnell,1971-10-13,D,L,2010-11,81,1,17,18,0.22,8,34,2.94,87,75559.0,15:32,0,0,0,0.0,53,76,15,54,-39,0,0,0,222.0,0:2,0,1,1,7664.0,1:34,-111
8458938,Roman,Hamrlik,1974-04-12,D,L,2010-11,79,5,29,34,0.43,6,129,3.88,81,105605.0,22:16,0,0,0,0.0,66,192,31,53,-22,2,13,15,12148.0,2:33,0,0,0,9209.0,1:56,-111
8458943,Cory,Stillman,1973-12-20,LW,L,2010-11,65,12,27,39,0.6,5,116,10.34,24,65950.0,16:54,17,20,37,45.95,64,30,31,28,3,3,9,12,12568.0,3:13,0,0,0,84.0,0:1,3533333
8458951,Sergei,Gonchar,1974-04-13,D,L,2010-11,67,7,20,27,0.4,-15,107,6.54,20,93232.0,23:11,0,0,0,0.0,54,94,22,48,-26,5,15,20,15955.0,3:58,0,0,0,6407.0,1:35,5500000
8459004,Craig,Rivet,1974-09-13,D,R,2010-11,37,2,2,4,0.11,-12,33,6.06,35,32581.0,14:40,0,0,0,0.0,31,36,5,18,-13,0,0,0,2134.0,0:57,0,0,0,2784.0,1:15,3500000
8459053,Adrian,Aucoin,1973-07-03,D,R,2010-11,75,3,19,22,0.29,18,99,3.03,52,97478.0,21:39,1,0,1,100.0,134,75,26,22,4,0,2,2,3943.0,0:52,0,0,0,13454.0,2:59,-111
8459424,Chris,Pronger,1974-10-10,D,L,2010-11,50,4,21,25,0.5,7,112,3.57,44,67495.0,22:29,0,0,0,0.0,41,114,19,26,-7,3,11,14,11110.0,3:42,0,1,1,9257.0,3:5,4935714
8459427,Rob,Niedermayer,1974-12-28,C,L,2010-11,71,5,14,19,0.27,-8,80,6.25,22,54353.0,12:45,129,147,276,46.74,37,21,14,23,-9,0,0,0,548.0,0:7,0,0,0,3408.0,0:48,1150000
8459429,Jason,Arnott,1974-10-11,C,R,2010-11,73,17,14,31,0.42,-6,169,10.06,40,67990.0,15:31,449,445,894,50.22,42,11,30,21,9,4,4,8,9308.0,2:7,0,0,0,461.0,0:6,4500000
8459442,Saku,Koivu,1974-11-23,C,L,2010-11,75,15,30,45,0.6,-8,104,14.42,36,86112.0,19:8,707,632,1339,52.8,48,35,29,32,-3,4,11,15,10196.0,2:15,0,0,0,8873.0,1:58,-111
8459444,Todd,Bertuzzi,1975-02-02,RW,L,2010-11,81,16,29,45,0.56,-7,138,11.59,71,77551.0,15:57,18,22,40,45.0,110,21,30,46,-16,2,5,7,7719.0,1:35,0,0,0,51.0,0:0,1937500
8459457,Jamie,Langenbrunner,1975-07-24,RW,R,2010-11,70,9,23,32,0.46,-18,153,5.88,45,73253.0,17:26,11,17,28,39.29,96,25,28,36,-8,1,6,7,10194.0,2:25,0,0,0,6476.0,1:32,2800000
8459461,Brendan,Morrison,1975-08-15,C,L,2010-11,66,9,34,43,0.65,13,89,10.11,16,66113.0,16:41,378,384,762,49.61,22,18,43,37,6,3,9,12,9213.0,2:19,1,1,2,7935.0,2:0,-111
8459462,Bryan,McCabe,1975-06-08,D,L,2010-11,67,7,21,28,0.42,2,122,5.74,34,78660.0,19:34,0,0,0,0.0,86,72,8,31,-23,4,9,13,14558.0,3:37,0,0,0,3849.0,0:57,5750000
8459492,Vinny,Prospal,1975-02-17,LW,L,2010-11,29,9,14,23,0.79,4,61,14.75,8,26677.0,15:19,69,59,128,53.91,44,15,5,7,-2,2,8,10,5472.0,3:8,0,0,0,5.0,0:0,-111
8459514,Jamal,Mayers,1974-10-24,RW,R,2010-11,78,3,11,14,0.18,3,62,4.84,124,41566.0,8:52,53,45,98,54.08,105,19,24,18,6,0,0,0,107.0,0:1,0,0,0,5174.0,1:6,600000
8459587,Todd,Marchant,1973-08-12,C,L,2010-11,79,1,7,8,0.1,-18,63,1.59,26,62999.0,13:17,263,285,548,47.99,114,62,22,15,7,0,1,1,206.0,0:2,0,1,1,17108.0,3:36,-111
8459596,Andrew,Brunette,1973-08-24,LW,L,2010-11,82,18,28,46,0.56,-7,117,15.38,16,82653.0,16:47,7,11,18,38.89,27,31,18,29,-11,8,10,18,15317.0,3:6,0,0,0,68.0,0:0,-111
8459628,Hal,Gill,1975-04-06,D,L,2010-11,75,2,7,9,0.12,-9,62,3.23,43,89189.0,19:49,0,0,0,0.0,75,151,21,62,-41,0,0,0,284.0,0:3,0,1,1,17034.0,3:47,2250000
8459640,Mike,Grier,1975-01-05,RW,R,2010-11,73,5,11,16,0.22,0,107,4.67,12,63039.0,14:23,10,21,31,32.26,112,48,26,22,4,0,0,0,679.0,0:9,0,0,0,11910.0,2:43,-111
8459670,Kimmo,Timonen,1975-03-18,D,L,2010-11,82,6,31,37,0.45,11,147,4.08,36,110576.0,22:28,0,1,1,0.0,96,175,43,39,4,1,15,16,16370.0,3:19,2,0,2,16886.0,3:25,6333333
8459687,Scott,Nichol,1974-12-31,C,R,2010-11,56,4,3,7,0.12,-3,61,6.56,50,32733.0,9:44,288,197,485,59.38,114,24,17,8,9,0,0,0,89.0,0:1,0,0,0,5956.0,1:46,-111
8460492,Ed,Jovanovski,1976-06-26,D,L,2010-11,50,5,9,14,0.28,4,73,6.85,39,61435.0,20:28,0,0,0,0.0,87,91,9,37,-28,1,1,2,3613.0,1:12,0,1,1,8418.0,2:48,6500000
8460496,Ryan,Smyth,1976-02-21,LW,L,2010-11,82,23,24,47,0.57,-1,195,11.79,35,88749.0,18:2,57,75,132,43.18,25,18,33,46,-13,9,5,14,14515.0,2:57,0,0,0,1581.0,0:19,6250000
8460502,Wade,Belak,1976-07-03,RW,R,2010-11,15,0,0,0,0.0,-1,4,0.0,18,3399.0,3:46,0,0,0,0.0,20,2,0,5,-5,0,0,0,0.0,0:0,0,0,0,0.0,0:0,575000
8460503,Mattias,Ohlund,1976-09-09,D,L,2010-11,72,0,5,5,0.07,-7,39,0.0,70,80890.0,18:43,0,0,0,0.0,135,136,17,34,-17,0,1,1,857.0,0:11,0,0,0,12061.0,2:47,3607142
8460504,Ethan,Moreau,1975-09-22,LW,L,2010-11,37,1,5,6,0.16,-9,56,1.79,24,27711.0,12:28,5,12,17,29.41,73,23,7,3,4,0,1,1,156.0,0:4,0,0,0,3813.0,1:43,-111
8460527,Ryan,Johnson,1976-06-14,C,L,2010-11,34,1,5,6,0.18,-2,25,4.0,8,21115.0,10:21,197,115,312,63.14,31,34,6,5,1,0,0,0,67.0,0:1,0,0,0,2892.0,1:25,-111
8460533,Dave,Scatchard,1976-02-20,C,R,2010-11,8,0,1,1,0.12,1,6,0.0,6,2283.0,4:45,12,14,26,46.15,7,0,0,1,-1,0,0,0,9.0,0:1,0,0,0,1.0,0:0,550000
8460542,Patrik,Elias,1976-04-13,C,L,2010-11,81,21,41,62,0.77,-4,204,10.29,16,90583.0,18:38,224,274,498,44.98,62,25,45,55,-10,7,13,20,13375.0,2:45,1,0,1,10301.0,2:7,6000000
8460555,Jason,Strudwick,1975-07-17,D,L,2010-11,43,0,2,2,0.05,-16,9,0.0,23,38851.0,15:3,0,0,0,0.0,43,63,8,16,-8,0,0,0,40.0,0:0,0,0,0,5038.0,1:57,-111
8460556,Freddy,Modin,1974-10-08,LW,L,2010-11,40,7,3,10,0.25,-14,54,12.96,14,27848.0,11:36,8,12,20,40.0,19,22,14,11,3,0,0,0,1095.0,0:27,1,0,1,2417.0,1:0,800000
8460562,Chris,Drury,1976-08-20,C,R,2010-11,24,1,4,5,0.21,2,26,3.85,8,17303.0,12:0,127,98,225,56.44,19,12,9,3,6,0,0,0,874.0,0:36,0,0,0,2431.0,1:41,7050000
8460567,Chris,Clark,1976-03-08,RW,R,2010-11,53,5,10,15,0.28,-3,83,6.02,38,46563.0,14:38,3,13,16,18.75,89,9,18,9,9,2,0,2,2502.0,0:47,0,1,1,6336.0,1:59,-111
8460577,Milan,Hejduk,1976-02-14,RW,R,2010-11,71,22,34,56,0.79,-23,170,12.94,18,76350.0,17:55,2,3,5,40.0,9,31,38,23,15,10,14,24,12943.0,3:2,0,0,0,341.0,0:4,-111
8460580,Brad,Lukowich,1976-08-12,D,L,2010-11,5,0,0,0,0.0,2,3,0.0,0,3079.0,10:15,0,0,0,0.0,5,6,1,0,1,0,0,0,4.0,0:0,0,0,0,0.0,0:0,1000000
8460621,Daniel,Alfredsson,1972-12-11,RW,R,2010-11,54,14,17,31,0.57,-19,96,14.58,18,62454.0,19:16,2,10,12,16.67,41,21,45,46,-1,7,5,12,10288.0,3:10,0,0,0,6234.0,1:55,4875000
8460661,Shane,Hnidy,1975-11-08,D,R,2010-11,3,0,0,0,0.0,-2,3,0.0,2,2660.0,14:46,0,0,0,0.0,2,1,0,1,-1,0,0,0,0.0,0:0,0,0,0,62.0,0:20,500000
8460719,Steve,Sullivan,1974-07-06,LW,R,2010-11,44,10,12,22,0.5,4,79,12.66,28,42324.0,16:1,5,8,13,38.46,18,10,16,24,-8,3,4,7,7173.0,2:43,0,0,0,1587.0,0:36,3750000
8460720,Eric,Boulton,1976-08-17,LW,L,2010-11,69,6,4,10,0.14,1,51,11.76,87,37087.0,8:57,0,3,3,0.0,93,20,11,14,-3,0,0,0,338.0,0:4,0,0,0,57.0,0:0,650000
8460743,Tomas,Holmstrom,1973-01-23,LW,L,2010-11,73,18,19,37,0.51,-6,125,14.4,62,64853.0,14:48,1,0,1,100.0,81,11,18,26,-8,10,10,20,13518.0,3:5,0,0,0,37.0,0:0,-111
8462036,Daymond,Langkow,1976-09-27,C,L,2010-11,4,0,1,1,0.25,3,6,0.0,0,3542.0,14:45,23,20,43,53.49,4,0,5,4,1,0,0,0,223.0,0:55,0,0,0,154.0,0:38,-111
8462038,Shane,Doan,1976-10-10,RW,R,2010-11,72,20,40,60,0.83,5,221,9.05,67,83336.0,19:17,73,86,159,45.91,172,28,41,36,5,11,10,21,16268.0,3:45,0,0,0,2251.0,0:31,4550000
8462041,Radek,Dvorak,1977-03-09,RW,R,2010-11,66,7,15,22,0.33,2,109,6.42,24,63665.0,16:4,7,12,19,36.84,51,33,35,25,10,0,0,0,914.0,0:13,1,0,1,8804.0,2:13,-111
8462042,Jarome,Iginla,1977-07-01,RW,R,2010-11,82,43,43,86,1.05,0,289,14.88,40,103004.0,20:56,227,193,420,54.05,103,28,40,70,-30,14,16,30,19771.0,4:1,0,0,0,435.0,0:5,7000000
8462077,Jochen,Hecht,1977-06-21,C,L,2010-11,67,12,17,29,0.43,4,172,6.98,40,68658.0,17:4,314,415,729,43.07,32,26,33,26,7,0,2,2,5935.0,1:28,0,0,0,7763.0,1:55,-111
8462093,Peter,Schaefer,1977-07-12,LW,L,2010-11,16,1,1,2,0.12,-3,10,10.0,2,9289.0,9:40,13,20,33,39.39,18,7,8,1,7,0,0,0,45.0,0:2,0,0,0,1739.0,1:48,600000
8462118,Marc,Savard,1977-07-17,C,L,2010-11,25,2,8,10,0.4,-7,50,4.0,29,23705.0,15:48,167,161,328,50.91,5,4,3,18,-15,0,4,4,4468.0,2:58,0,0,0,131.0,0:5,4021428
8462129,Michal,Handzus,1977-03-11,C,L,2010-11,82,12,18,30,0.37,-5,94,12.77,20,85340.0,17:20,678,634,1312,51.68,86,48,24,39,-15,4,6,10,13321.0,2:42,0,1,1,11873.0,2:24,4000000
8462176,Brent,Sopel,1977-01-07,D,R,2010-11,71,2,5,7,0.1,6,44,4.55,16,69624.0,16:20,0,0,0,0.0,36,152,25,39,-14,0,1,1,941.0,0:13,0,0,0,13902.0,3:15,2333333
8462196,Stephane,Robidas,1977-03-03,D,R,2010-11,81,5,25,30,0.37,-7,106,4.72,67,119229.0,24:31,0,0,0,0.0,216,135,28,35,-7,1,14,15,13797.0,2:50,0,2,2,15966.0,3:17,3300000
8462225,Filip,Kuba,1976-12-29,D,L,2010-11,64,2,14,16,0.25,-26,76,2.63,16,79602.0,20:43,0,0,0,0.0,23,104,22,41,-19,0,7,7,8157.0,2:7,0,1,1,9584.0,2:29,3700000
8462535,Jody,Shelley,1976-02-07,LW,L,2010-11,58,2,2,4,0.07,0,31,6.45,127,21511.0,6:10,2,2,4,50.0,96,15,5,10,-5,0,0,0,183.0,0:3,0,0,0,4.0,0:0,1100000
8464956,Chris,Phillips,1978-03-09,D,L,2010-11,82,1,8,9,0.11,-35,81,1.23,32,105889.0,21:31,0,0,0,0.0,116,152,26,54,-28,0,1,1,891.0,0:10,0,0,0,17426.0,3:32,3500000
8464957,J-P,Dumont,1978-04-01,RW,L,2010-11,70,10,9,19,0.27,2,89,11.24,16,46968.0,11:10,1,1,2,50.0,45,8,35,23,12,1,3,4,6768.0,1:36,0,0,0,81.0,0:1,-111
8464962,Ruslan,Salei,1974-11-02,D,L,2010-11,75,2,8,10,0.13,0,75,2.67,48,80847.0,17:57,0,0,0,0.0,117,109,19,35,-16,0,0,0,330.0,0:4,0,0,0,9772.0,2:10,750000
8464966,Derek,Morris,1978-08-24,D,R,2010-11,77,5,11,16,0.21,-2,83,6.02,58,97290.0,21:3,2,1,3,66.67,117,136,14,31,-17,1,0,1,3676.0,0:47,0,1,1,11671.0,2:31,2750000
8464967,Marty,Reasoner,1977-02-26,C,L,2010-11,82,14,18,32,0.39,2,124,11.29,22,84435.0,17:9,700,584,1284,54.52,71,57,52,17,35,0,1,1,2705.0,0:32,0,0,0,13598.0,2:45,1150000
8464975,Daniel,Briere,1977-10-06,C,R,2010-11,77,34,34,68,0.88,20,246,13.82,87,84593.0,18:18,395,425,820,48.17,36,17,33,16,17,6,9,15,14164.0,3:3,0,0,0,336.0,0:4,6500000
8464977,Dainius,Zubrus,1978-06-16,C,L,2010-11,79,13,17,30,0.38,-11,115,11.3,53,81299.0,17:9,253,196,449,56.35,107,32,33,30,3,1,2,3,11390.0,2:24,0,1,1,3073.0,0:38,3400000
8464979,Marco,Sturm,1978-09-08,LW,L,2010-11,35,5,11,16,0.46,6,57,8.77,23,29896.0,14:14,6,9,15,40.0,23,6,12,11,1,1,2,3,2139.0,1:1,0,1,1,1561.0,0:44,-111
8464981,Cory,Sarich,1978-08-16,D,R,2010-11,76,4,13,17,0.22,11,75,5.33,75,81527.0,17:52,0,1,1,0.0,175,109,15,51,-36,0,0,0,334.0,0:4,0,0,0,8550.0,1:52,-111
8464984,Josh,Green,1977-11-16,C,L,2010-11,12,0,0,0,0.0,-3,10,0.0,6,7206.0,10:0,3,4,7,42.86,11,1,3,0,3,0,0,0,5.0,0:0,0,0,0,460.0,0:38,-111
8464989,Matt,Cullen,1976-11-02,C,L,2010-11,78,12,27,39,0.5,-14,150,8.0,34,84368.0,18:1,473,370,843,56.11,39,36,43,34,9,5,16,21,14610.0,3:7,4,0,4,9409.0,2:0,3500000
8464994,Steve,Begin,1978-06-14,LW,L,2010-11,2,0,0,0,0.0,-2,2,0.0,4,1177.0,9:48,0,0,0,0.0,5,0,1,0,1,0,0,0,0.0,0:0,0,0,0,0.0,0:0,550000
8465005,Colin,White,1977-12-12,D,L,2010-11,69,0,6,6,0.09,-2,50,0.0,48,78060.0,18:51,0,0,0,0.0,109,100,21,38,-17,0,0,0,200.0,0:2,0,1,1,11517.0,2:46,3000000
8465009,Zdeno,Chara,1977-03-18,D,L,2010-11,81,14,30,44,0.54,33,264,5.3,88,123613.0,25:26,0,0,0,0.0,153,111,32,62,-30,8,7,15,15265.0,3:8,1,1,2,13672.0,2:48,7500000
8465012,Tom,Poti,1977-03-22,D,L,2010-11,21,2,5,7,0.33,-4,20,10.0,8,23135.0,18:21,0,0,0,0.0,7,27,3,12,-9,0,1,1,1720.0,1:21,0,0,0,3204.0,2:32,-111
8465024,Jon,Sim,1977-09-29,LW,L,2010-11,34,1,3,4,0.12,-10,38,2.63,22,23264.0,11:24,5,6,11,45.45,53,12,13,2,11,0,1,1,684.0,0:20,0,0,0,2355.0,1:9,-111
8465025,Arron,Asham,1978-04-13,RW,R,2010-11,44,5,6,11,0.25,0,60,8.33,46,25217.0,9:33,3,6,9,33.33,107,16,7,8,-1,0,0,0,66.0,0:1,0,0,0,24.0,0:0,-111
8465026,Mark,Parrish,1977-02-02,RW,R,2010-11,2,0,0,0,0.0,-2,0,,0,1413.0,11:46,0,0,0,0.0,2,2,0,1,-1,0,0,0,6.0,0:3,0,0,0,5.0,0:2,2650000
8465042,Toni,Lydman,1977-09-25,D,L,2010-11,78,3,22,25,0.32,32,99,3.03,42,103760.0,22:10,0,0,0,0.0,141,178,11,38,-27,0,2,2,2819.0,0:36,0,0,0,17447.0,3:43,3000000
8465050,Eric,Belanger,1977-12-16,C,L,2010-11,82,13,27,40,0.49,11,127,10.24,36,85324.0,17:20,717,580,1297,55.28,71,45,45,29,16,1,4,5,7419.0,1:30,1,0,1,8841.0,1:47,750000
8465058,Michal,Rozsival,1978-09-03,D,R,2010-11,65,6,15,21,0.32,6,55,10.91,42,81909.0,21:0,0,0,0,0.0,100,108,24,24,0,2,6,8,7819.0,2:0,0,0,0,7395.0,1:53,5000000
8465059,Matt,Bradley,1978-06-13,RW,R,2010-11,61,4,7,11,0.18,-3,58,6.9,68,38378.0,10:29,4,7,11,36.36,161,15,12,5,7,0,0,0,309.0,0:5,0,0,0,204.0,0:3,1000000
8465113,Brian,Willsie,1978-03-16,RW,R,2010-11,1,0,1,1,1.0,0,0,,0,375.0,6:15,0,0,0,0.0,0,2,0,0,0,0,0,0,0.0,0:0,0,0,0,0.0,0:0,-111
8465122,Brett,Clark,1976-12-23,D,L,2010-11,82,9,22,31,0.38,2,87,10.34,14,92900.0,18:52,0,0,0,0.0,117,157,20,48,-28,6,11,17,14117.0,2:52,0,0,0,6938.0,1:24,-111
8465166,Craig,Adams,1977-04-26,RW,R,2010-11,80,4,11,15,0.19,-5,90,4.44,76,58496.0,12:11,194,271,465,41.72,171,64,24,15,9,0,0,0,124.0,0:1,2,2,4,14831.0,3:5,550000
8465170,Fernando,Pisani,1976-12-27,RW,L,2010-11,60,7,9,16,0.27,0,72,9.72,10,45263.0,12:34,34,32,66,51.52,69,21,32,13,19,1,0,1,786.0,0:13,0,0,0,5139.0,1:25,-111
8465185,Willie,Mitchell,1977-04-23,D,L,2010-11,57,5,5,10,0.18,4,59,8.47,21,74607.0,21:48,0,0,0,0.0,35,85,12,47,-35,0,0,0,365.0,0:6,1,0,1,11636.0,3:24,3500000
8465192,Samuel,Pahlsson,1977-12-17,C,L,2010-11,82,7,13,20,0.24,-13,108,6.48,30,75463.0,15:20,675,623,1298,52.0,162,49,28,8,20,0,0,0,371.0,0:4,1,0,1,13989.0,2:50,2650000
8465200,Tomas,Kaberle,1978-03-02,D,L,2010-11,82,4,43,47,0.57,4,130,3.08,18,108786.0,22:6,0,0,0,0.0,37,140,29,70,-41,0,25,25,19986.0,4:3,0,0,0,1433.0,0:17,4250000
8465202,Sami,Salo,1974-09-02,D,R,2010-11,27,3,4,7,0.26,-3,39,7.69,14,32955.0,20:20,0,0,0,0.0,6,28,3,18,-15,1,2,3,3078.0,1:54,0,0,0,4617.0,2:51,3500000
8465210,Pavel,Kubina,1977-04-15,D,R,2010-11,79,4,19,23,0.29,2,78,5.13,62,91129.0,19:13,0,0,0,0.0,90,115,19,35,-16,1,4,5,11213.0,2:21,0,0,0,4595.0,0:58,3850000
8465914,Francis,Bouillon,1975-10-17,D,L,2010-11,44,1,9,10,0.23,-3,47,2.13,27,53411.0,20:13,0,0,0,0.0,133,51,13,24,-11,0,2,2,3363.0,1:16,0,0,0,3695.0,1:23,1350000
8465951,Matt,Cooke,1978-09-07,LW,L,2010-11,67,12,18,30,0.45,14,95,12.63,129,62855.0,15:38,8,21,29,27.59,192,39,23,19,4,0,0,0,3218.0,0:48,3,3,6,11057.0,2:45,1800000
8465978,Shawn,Thornton,1977-07-23,LW,R,2010-11,79,10,10,20,0.25,8,151,6.62,122,47783.0,10:4,17,14,31,54.84,141,18,23,6,17,0,0,0,645.0,0:8,0,0,0,113.0,0:1,812500
8466035,Sergei,Samsonov,1978-10-27,LW,R,2010-11,78,13,27,40,0.51,-2,123,10.57,14,72323.0,15:27,3,8,11,27.27,56,34,43,29,14,4,9,13,12710.0,2:42,0,0,0,255.0,0:3,-111
8466138,Joe,Thornton,1979-07-02,C,L,2010-11,80,21,49,70,0.88,4,149,14.09,47,95377.0,19:52,675,565,1240,54.44,56,35,114,98,16,9,24,33,16259.0,3:23,2,0,2,5712.0,1:11,7200000
8466139,Patrick,Marleau,1979-09-15,C,L,2010-11,82,37,36,73,0.89,-3,279,13.26,16,102286.0,20:47,288,261,549,52.46,86,31,35,66,-31,11,15,26,16429.0,3:20,2,1,3,9791.0,1:59,6900000
8466140,Olli,Jokinen,1978-12-05,C,L,2010-11,79,17,37,54,0.68,-17,208,8.17,44,84263.0,17:46,552,613,1165,47.38,56,35,54,45,9,5,14,19,14803.0,3:7,0,0,0,792.0,0:10,3000000
8466142,Eric,Brewer,1979-04-17,D,L,2010-11,76,9,7,16,0.21,6,110,8.18,81,100524.0,22:2,0,0,0,0.0,145,120,23,40,-17,0,0,0,2731.0,0:35,0,0,0,14283.0,3:7,4250000
8466144,Paul,Mara,1979-09-07,D,L,2010-11,53,1,5,6,0.11,1,50,2.0,88,58130.0,18:16,0,0,0,0.0,88,85,4,12,-8,0,0,0,2826.0,0:53,0,0,0,7530.0,2:22,750000
8466145,Nick,Boynton,1979-01-14,D,R,2010-11,51,1,7,8,0.16,-1,43,2.33,40,44819.0,14:38,0,0,0,0.0,61,87,15,25,-10,0,0,0,446.0,0:8,0,0,0,2920.0,0:57,500000
8466148,Marian,Hossa,1979-01-12,RW,L,2010-11,65,25,32,57,0.88,9,205,12.2,32,76856.0,19:42,3,1,4,75.0,48,23,53,32,21,8,11,19,10531.0,2:42,2,1,3,6843.0,1:45,5275000
8466149,Daniel,Cleary,1978-12-18,RW,L,2010-11,68,26,20,46,0.68,-1,192,13.54,20,67875.0,16:38,35,56,91,38.46,112,25,18,16,2,5,3,8,6282.0,1:32,0,0,0,4805.0,1:10,2800000
8466158,Scott,Hannan,1979-01-23,D,L,2010-11,78,1,10,11,0.14,4,56,1.79,34,92601.0,19:47,0,0,0,0.0,84,122,19,41,-22,0,0,0,555.0,0:7,0,1,1,12499.0,2:40,4500000
8466160,Brenden,Morrow,1979-01-16,LW,L,2010-11,82,33,23,56,0.68,-3,209,15.79,76,94639.0,19:14,1,10,11,9.09,225,43,41,60,-19,9,4,13,18486.0,3:45,1,0,1,3665.0,0:44,4100000
8466181,Kristian,Huselius,1978-11-10,LW,L,2010-11,39,14,9,23,0.59,-17,94,14.89,10,38327.0,16:22,0,0,0,0.0,4,4,19,11,8,6,2,8,6324.0,2:42,0,0,0,53.0,0:1,-111
8466182,Henrik,Tallinder,1979-01-10,D,L,2010-11,82,5,11,16,0.2,-6,102,4.9,40,110899.0,22:32,0,0,0,0.0,67,74,26,44,-18,0,2,2,2714.0,0:33,1,0,1,11626.0,2:21,-111
8466212,Francis,Lessard,1979-05-30,RW,R,2010-11,24,0,0,0,0.0,0,6,0.0,78,5553.0,3:51,1,0,1,100.0,36,2,1,2,-1,0,0,0,0.0,0:0,0,0,0,0.0,0:0,-111
8466215,Joe,Corvo,1977-06-20,D,R,2010-11,82,11,29,40,0.49,-14,191,5.76,18,121910.0,24:46,0,1,1,0.0,55,119,60,64,-4,5,18,23,19805.0,4:1,1,0,1,13286.0,2:42,2250000
8466216,Adam,Mair,1979-02-15,C,R,2010-11,65,1,3,4,0.06,-16,58,1.72,45,35467.0,9:5,57,55,112,50.89,63,16,13,10,3,0,0,0,317.0,0:4,0,0,0,1535.0,0:23,-111
8466251,Jason,Chimera,1979-05-02,LW,L,2010-11,81,10,16,26,0.32,-10,162,6.17,64,64422.0,13:15,20,19,39,51.28,98,16,26,27,-1,2,1,3,2929.0,0:36,0,0,0,4176.0,0:51,1875000
8466285,Brian,Campbell,1979-05-23,D,L,2010-11,65,5,22,27,0.42,28,84,5.95,6,89632.0,22:58,0,0,0,0.0,28,101,21,42,-21,2,4,6,7940.0,2:2,0,0,0,6774.0,1:44,7142875
8466309,Mike,Mottau,1978-03-19,D,L,2010-11,20,0,3,3,0.15,-12,21,0.0,8,24400.0,20:20,0,0,0,0.0,17,33,4,10,-6,0,1,1,2526.0,2:6,0,0,0,2479.0,2:3,-111
8466333,Andrew,Ference,1979-03-17,D,L,2010-11,70,3,12,15,0.21,22,78,3.85,60,75513.0,17:58,0,0,0,0.0,74,82,4,28,-24,0,1,1,1483.0,0:21,0,1,1,7714.0,1:50,2250000
8466371,John,Madden,1973-05-04,C,L,2010-11,76,12,13,25,0.33,-9,107,11.21,10,69947.0,15:20,504,484,988,51.01,43,59,44,21,23,1,1,2,1476.0,0:19,1,0,1,11233.0,2:27,1000000
8466378,Martin,St. Louis,1975-06-18,RW,L,2010-11,82,31,68,99,1.21,0,254,12.2,12,103221.0,20:58,50,81,131,38.17,37,64,55,71,-16,4,37,41,22223.0,4:31,0,0,0,2282.0,0:27,5250000
8466392,Todd,White,1975-05-21,C,L,2010-11,18,1,1,2,0.11,-2,11,9.09,2,8293.0,7:40,30,26,56,53.57,1,4,3,2,1,0,0,0,475.0,0:26,0,1,1,255.0,0:14,-111
8466393,Pascal,Dupuis,1979-04-07,RW,L,2010-11,81,17,20,37,0.46,16,171,9.94,59,81939.0,16:51,6,22,28,21.43,117,55,33,14,19,0,0,0,2141.0,0:26,4,1,5,11719.0,2:24,1400000
8466398,Tom,Kostopoulos,1979-01-24,RW,R,2010-11,76,8,10,18,0.24,-4,79,10.13,74,56268.0,12:20,18,49,67,26.87,122,41,28,18,10,2,1,3,1130.0,0:14,0,0,0,7858.0,1:43,916667
8467096,Dan,Boyle,1976-07-12,D,R,2010-11,76,9,41,50,0.66,2,199,4.52,67,119641.0,26:14,0,2,2,0.0,55,139,34,51,-17,4,23,27,19560.0,4:17,0,0,0,10298.0,2:15,6666666
8467304,Andy,Sutton,1975-03-10,D,L,2010-11,39,0,4,4,0.1,1,31,0.0,87,34523.0,14:45,0,0,0,0.0,62,87,5,14,-9,0,1,1,199.0,0:5,0,2,2,5610.0,2:23,2062500
8467329,Vincent,Lecavalier,1980-04-21,C,L,2010-11,65,25,29,54,0.83,-5,210,11.9,43,71971.0,18:27,591,570,1161,50.9,93,25,35,26,9,12,16,28,15556.0,3:59,0,0,0,903.0,0:13,7727272
8467330,David,Legwand,1980-08-17,C,L,2010-11,64,17,24,41,0.64,13,130,13.08,24,72220.0,18:48,395,442,837,47.19,36,20,55,44,11,0,4,4,6160.0,1:36,2,0,2,7791.0,2:1,4500000
8467331,Brad,Stuart,1979-11-06,D,L,2010-11,67,3,17,20,0.3,4,81,3.7,40,86548.0,21:31,0,0,0,0.0,131,114,13,52,-39,1,1,2,2304.0,0:34,0,1,1,14256.0,3:32,3750000
8467332,Bryan,Allen,1980-08-21,D,L,2010-11,72,4,13,17,0.24,-1,58,6.9,82,79152.0,18:19,0,0,0,0.0,118,103,24,27,-3,0,0,0,456.0,0:6,0,0,0,9673.0,2:14,2900000
8467334,Manny,Malhotra,1980-05-18,C,L,2010-11,72,11,19,30,0.42,9,111,9.91,22,69839.0,16:9,778,483,1261,61.7,57,74,40,18,22,3,3,6,3239.0,0:44,1,1,2,11934.0,2:45,2500000
8467336,Mike,Rupp,1980-01-13,LW,L,2010-11,81,9,8,17,0.21,-4,81,11.11,124,48869.0,10:3,82,80,162,50.62,181,17,9,12,-3,0,1,1,3846.0,0:47,0,0,0,1059.0,0:13,825000
8467338,Alex,Tanguay,1979-11-21,LW,L,2010-11,79,22,47,69,0.87,0,120,18.33,24,93674.0,19:45,42,65,107,39.25,31,38,49,57,-8,3,17,20,17335.0,3:39,0,0,0,6054.0,1:16,1700000
8467344,Robyn,Regehr,1980-04-19,D,L,2010-11,79,2,15,17,0.22,2,72,2.78,58,101835.0,21:29,0,0,0,0.0,180,142,12,41,-29,1,1,2,1145.0,0:14,0,1,1,15226.0,3:12,4020000
8467346,Simon,Gagne,1980-02-29,LW,L,2010-11,63,17,23,40,0.63,-12,154,11.04,20,63839.0,16:53,6,10,16,37.5,49,20,23,21,2,7,8,15,11761.0,3:6,0,0,0,826.0,0:13,5250000
8467351,Scott,Gomez,1979-12-23,C,L,2010-11,80,7,31,38,0.48,-15,157,4.46,48,89105.0,18:33,575,622,1197,48.04,32,24,56,28,28,3,14,17,13003.0,2:42,0,1,1,4599.0,0:57,7357143
8467353,Nik,Antropov,1980-02-18,C,L,2010-11,76,16,25,41,0.54,-17,105,15.24,42,71365.0,15:39,260,274,534,48.69,62,39,35,31,4,5,11,16,11698.0,2:33,0,0,0,81.0,0:1,-111
8467361,Blair,Betts,1980-02-16,C,L,2010-11,75,5,7,12,0.16,-3,51,9.8,8,47030.0,10:27,411,406,817,50.31,82,72,18,8,10,0,0,0,126.0,0:1,1,1,2,16306.0,3:37,-111
8467365,John,Erskine,1980-06-26,D,L,2010-11,73,4,7,11,0.15,1,58,6.9,94,64950.0,14:49,0,0,0,0.0,166,120,11,37,-26,0,0,0,232.0,0:3,0,0,0,5742.0,1:18,1250000
8467370,Mike,Fisher,1980-06-05,C,R,2010-11,82,19,17,36,0.44,-17,192,9.9,43,90370.0,18:22,602,644,1246,48.31,135,89,36,43,-7,4,10,14,11770.0,2:23,0,0,0,6707.0,1:21,4200000
8467371,Mike,Ribeiro,1980-02-10,C,L,2010-11,82,19,52,71,0.87,-4,161,11.8,28,98196.0,19:57,565,648,1213,46.58,95,33,72,71,1,7,16,23,18963.0,3:51,0,0,0,4311.0,0:52,5000000
8467389,Brad,Richards,1980-05-02,C,L,2010-11,72,28,49,77,1.07,1,272,10.29,24,93850.0,21:43,501,489,990,50.61,20,22,47,73,-26,7,22,29,23058.0,5:20,0,0,0,1478.0,0:20,7800000
8467393,Jarkko,Ruutu,1975-08-23,LW,L,2010-11,73,3,9,12,0.16,-2,66,4.55,97,49807.0,11:22,8,12,20,40.0,131,29,17,23,-6,0,0,0,245.0,0:3,0,1,1,8113.0,1:51,1300000
8467396,Erik,Cole,1978-11-06,LW,L,2010-11,82,26,26,52,0.63,-1,201,12.94,49,90813.0,18:27,7,27,34,20.59,225,34,65,36,29,3,5,8,13296.0,2:42,1,1,2,6767.0,1:22,2900000
8467400,Francois,Beauchemin,1980-06-04,D,L,2010-11,81,5,12,17,0.21,-8,106,4.72,32,112134.0,23:4,0,1,1,0.0,122,182,34,90,-56,1,2,3,8071.0,1:39,0,0,0,13670.0,2:48,3800000
8467407,Brian,Gionta,1979-01-18,RW,R,2010-11,82,29,17,46,0.56,3,298,9.73,24,96525.0,19:37,19,40,59,32.2,87,31,45,27,18,7,4,11,14254.0,2:53,2,0,2,9517.0,1:56,5000000
8467408,Matt,Walker,1980-04-07,D,R,2010-11,4,0,0,0,0.0,0,3,0.0,4,2792.0,11:38,0,0,0,0.0,5,5,0,1,-1,0,0,0,0.0,0:0,0,0,0,23.0,0:5,1700000
8467412,Alexei,Ponikarovsky,1980-04-09,LW,L,2010-11,61,5,10,15,0.25,1,94,5.32,36,46114.0,12:35,1,4,5,20.0,139,28,12,27,-15,1,2,3,3399.0,0:55,0,0,0,3553.0,0:58,3200000
8467423,Shawn,Horcoff,1978-09-17,C,L,2010-11,47,9,18,27,0.57,-1,78,11.54,46,52693.0,18:41,393,420,813,48.34,32,20,29,24,5,5,5,10,7683.0,2:43,0,1,1,4402.0,1:33,5500000
8467428,Krys,Barch,1980-03-26,RW,L,2010-11,44,2,1,3,0.07,-7,16,12.5,80,13792.0,5:13,2,2,4,50.0,53,2,3,12,-9,0,0,0,296.0,0:6,0,0,0,11.0,0:0,837500
8467436,Jay,Leach,1979-09-02,D,L,2010-11,7,0,0,0,0.0,0,2,0.0,7,5982.0,14:14,0,0,0,0.0,5,6,1,1,0,0,0,0,17.0,0:2,0,0,0,274.0,0:39,-111
8467439,Jaroslav,Spacek,1974-02-11,D,L,2010-11,59,1,15,16,0.27,9,65,1.54,45,68121.0,19:14,0,0,0,0.0,61,90,30,55,-25,0,3,3,4740.0,1:20,0,1,1,8048.0,2:16,3833333
8467452,Rob,Scuderi,1978-12-30,D,L,2010-11,82,2,13,15,0.18,1,46,4.35,16,99826.0,20:17,0,0,0,0.0,64,122,22,59,-37,0,0,0,323.0,0:3,0,0,0,13636.0,2:46,3400000
8467463,Mikael,Samuelsson,1976-12-23,RW,R,2010-11,75,18,32,50,0.67,8,215,8.37,36,74844.0,16:37,9,19,28,32.14,76,21,25,36,-11,5,14,19,11187.0,2:29,0,0,0,152.0,0:2,2500000
8467466,Trent,Hunter,1980-07-05,RW,R,2010-11,17,1,3,4,0.24,-3,30,3.33,23,12914.0,12:39,0,2,2,0.0,36,5,3,2,1,0,0,0,1252.0,1:13,0,0,0,123.0,0:7,2000000
8467478,Kent,Huskins,1979-05-04,D,L,2010-11,50,2,8,10,0.2,8,38,5.26,12,49847.0,16:36,0,0,0,0.0,18,58,10,21,-11,0,0,0,294.0,0:5,0,0,0,4350.0,1:27,1700000
8467493,Chris,Neil,1979-06-18,RW,R,2010-11,80,6,10,16,0.2,-14,105,5.71,210,61260.0,12:45,3,3,6,50.0,258,21,35,20,15,0,0,0,2383.0,0:29,0,0,0,1.0,0:0,2000000
8467496,Andrei,Markov,1978-12-20,D,L,2010-11,7,1,2,3,0.43,2,20,5.0,4,9624.0,22:54,0,0,0,0.0,2,5,3,9,-6,0,1,1,1501.0,3:34,0,0,0,857.0,2:2,5750000
8467502,Ales,Kotalik,1978-12-23,RW,R,2010-11,26,4,2,6,0.23,-7,62,6.45,8,19302.0,12:22,6,5,11,54.55,38,4,7,10,-3,1,1,2,2242.0,1:26,0,0,0,30.0,0:1,3000000
8467514,Pavel,Datsyuk,1978-07-20,C,L,2010-11,56,23,36,59,1.05,11,137,16.79,15,64924.0,19:19,429,356,785,54.65,54,20,71,38,33,6,12,18,10665.0,3:10,1,0,1,2239.0,0:39,6700000
8467519,Karlis,Skrastins,1974-07-09,D,L,2010-11,74,3,5,8,0.11,-1,30,10.0,38,79699.0,17:57,0,1,1,0.0,55,139,23,19,4,0,0,0,188.0,0:2,0,1,1,14393.0,3:14,1375000
8467543,Toby,Petersen,1978-10-27,C,L,2010-11,60,2,4,6,0.1,-7,58,3.45,8,36142.0,10:2,46,74,120,38.33,56,36,22,18,4,0,0,0,302.0,0:5,2,0,2,6133.0,1:42,-111
8467545,Michael,Ryder,1980-03-31,RW,R,2010-11,79,18,23,41,0.52,-1,165,10.91,26,68663.0,14:29,5,3,8,62.5,70,19,35,28,7,8,6,14,9933.0,2:5,0,0,0,151.0,0:1,4000000
8467579,Trevor,Gillies,1979-01-30,LW,L,2010-11,39,2,0,2,0.05,-3,9,22.22,165,7181.0,3:4,0,1,1,0.0,44,6,1,1,0,0,0,0,144.0,0:3,0,0,0,0.0,0:0,-111
8467580,Mark,Eaton,1977-05-06,D,L,2010-11,34,0,3,3,0.09,-2,29,0.0,8,41535.0,20:21,0,0,0,0.0,30,82,9,14,-5,0,0,0,1115.0,0:32,0,0,0,6292.0,3:5,-111
8467831,Jeff,Halpern,1976-05-03,C,R,2010-11,72,11,15,26,0.36,6,62,17.74,29,55003.0,12:43,338,256,594,56.9,42,53,15,18,-3,0,0,0,533.0,0:7,1,0,1,10101.0,2:20,600000
8467844,Jason,Blake,1973-09-02,LW,L,2010-11,76,16,16,32,0.42,-5,187,8.56,41,67305.0,14:45,1,4,5,20.0,76,27,34,36,-2,3,4,7,6836.0,1:29,0,0,0,104.0,0:1,4000000
8467856,Brian,Rafalski,1973-09-28,D,R,2010-11,63,4,44,48,0.76,11,106,3.77,22,77198.0,20:25,0,0,0,0.0,49,54,12,57,-45,0,17,17,13413.0,3:32,0,0,0,879.0,0:13,6000000
8467875,Daniel,Sedin,1980-09-26,LW,L,2010-11,82,41,63,104,1.27,30,266,15.41,32,91281.0,18:33,4,13,17,23.53,13,12,36,48,-12,18,24,42,17761.0,3:36,0,0,0,515.0,0:6,6100000
8467876,Henrik,Sedin,1980-09-26,C,L,2010-11,82,19,75,94,1.15,26,157,12.1,40,94757.0,19:15,721,666,1387,51.98,15,21,43,38,5,8,27,35,17690.0,3:35,0,0,0,753.0,0:9,6100000
8467878,Tim,Connolly,1981-05-07,C,R,2010-11,68,13,29,42,0.62,-10,151,8.61,20,69017.0,16:54,445,524,969,45.92,24,53,22,34,-12,6,13,19,11546.0,2:49,0,0,0,7040.0,1:43,4500000
8467881,Taylor,Pyatt,1981-08-19,LW,L,2010-11,76,18,13,31,0.41,11,126,14.29,27,70705.0,15:30,6,14,20,30.0,143,48,21,14,7,2,2,4,5146.0,1:7,0,0,0,5141.0,1:7,-111
8467890,Barret,Jackman,1981-03-05,D,L,2010-11,60,0,13,13,0.22,3,65,0.0,57,74906.0,20:48,0,0,0,0.0,78,114,28,24,4,0,0,0,162.0,0:2,0,3,3,10167.0,2:49,3625000
8467899,Martin,Havlat,1981-04-19,RW,L,2010-11,78,22,40,62,0.79,-10,229,9.61,52,85879.0,18:21,3,7,10,30.0,34,24,43,47,-4,3,11,14,13432.0,2:52,0,0,0,611.0,0:7,4250000
8467906,Jonas,Andersson,1981-02-24,RW,L,2010-11,4,0,0,0,0.0,1,1,0.0,0,1453.0,6:3,0,0,0,0.0,3,1,0,0,0,0,0,0,0.0,0:0,0,0,0,0.0,0:0,-111
8467910,Nolan,Yonkman,1981-04-01,D,R,2010-11,16,0,1,1,0.06,5,8,0.0,39,11641.0,12:7,0,0,0,0.0,41,11,1,2,-1,0,0,0,66.0,0:4,0,0,0,2189.0,2:16,-111
8467915,Mike,Commodore,1979-11-07,D,R,2010-11,20,2,4,6,0.3,-8,32,6.25,44,22272.0,18:33,0,1,1,0.0,38,25,5,7,-2,0,2,2,2067.0,1:43,0,1,1,3046.0,2:32,3750000
8467917,Jordan,Leopold,1980-08-03,D,L,2010-11,71,13,22,35,0.49,-11,134,9.7,36,99380.0,23:19,0,0,0,0.0,49,123,15,50,-35,5,6,11,11707.0,2:44,0,0,0,10973.0,2:34,3000000
8467925,Adam,Hall,1980-08-14,RW,R,2010-11,82,7,11,18,0.22,-12,167,4.19,32,73059.0,14:50,360,295,655,54.96,152,59,22,18,4,0,0,0,850.0,0:10,0,0,0,13845.0,2:48,600000
8467927,Andrew,Hutchinson,1980-03-24,D,R,2010-11,5,0,1,1,0.2,-3,2,0.0,6,4590.0,15:18,0,0,0,0.0,0,8,0,1,-1,0,0,0,673.0,2:14,0,0,0,72.0,0:14,-111
8467928,Doug,Janik,1980-03-26,D,L,2010-11,7,0,0,0,0.0,-2,8,0.0,7,5551.0,13:13,0,0,0,0.0,2,7,0,5,-5,0,0,0,9.0,0:1,0,0,0,328.0,0:46,512500
8467931,Matt,Carkner,1980-11-03,D,R,2010-11,50,1,6,7,0.14,0,40,2.5,136,44652.0,14:53,0,0,0,0.0,71,59,9,22,-13,0,0,0,64.0,0:1,0,1,1,5952.0,1:59,700000
8467937,Michael,Zigomanis,1981-01-17,C,R,2010-11,8,0,1,1,0.12,0,7,0.0,4,3348.0,6:58,21,19,40,52.5,6,3,4,1,3,0,0,0,31.0,0:3,0,0,0,971.0,2:1,-111
8467943,Niklas,Hagman,1979-12-05,LW,L,2010-11,71,11,16,27,0.38,-2,140,7.86,24,58104.0,13:38,3,22,25,12.0,35,12,12,25,-13,4,3,7,7341.0,1:43,0,0,0,65.0,0:0,3000000
8467964,Mike,Comrie,1980-09-11,C,L,2010-11,21,1,5,6,0.29,-4,25,4.0,18,14896.0,11:49,15,25,40,37.5,10,5,2,3,-1,0,2,2,3398.0,2:41,0,0,0,0.0,0:0,500000
8467967,Chris,Kelly,1980-11-11,C,L,2010-11,81,14,14,28,0.35,-13,113,12.39,33,74919.0,15:24,466,450,916,50.87,81,54,40,25,15,0,0,0,988.0,0:12,1,2,3,12231.0,2:31,2125000
8467988,Ryan,Malone,1979-12-01,LW,L,2010-11,54,14,24,38,0.7,-3,149,9.4,51,51940.0,16:1,56,87,143,39.16,125,19,28,16,12,9,9,18,10514.0,3:14,0,0,0,2530.0,0:46,4500000
8468001,Derek,MacKenzie,1981-06-11,C,L,2010-11,63,9,14,23,0.37,14,76,11.84,22,41001.0,10:50,246,227,473,52.01,159,26,33,13,20,0,1,1,1413.0,0:22,1,1,2,6316.0,1:40,600000
8468064,Martin,Erat,1981-08-29,RW,L,2010-11,64,17,33,50,0.78,14,135,12.59,22,69474.0,18:5,19,25,44,43.18,57,21,35,35,0,7,8,15,9845.0,2:33,0,0,0,4259.0,1:6,4500000
8468083,Henrik,Zetterberg,1980-10-09,C,L,2010-11,80,24,56,80,1.0,-1,306,7.84,40,94002.0,19:35,516,468,984,52.44,38,19,54,60,-6,10,20,30,15605.0,3:15,0,1,1,2965.0,0:37,6083333
8468085,Radim,Vrbata,1981-06-13,RW,R,2010-11,79,19,29,48,0.61,5,240,7.92,20,77582.0,16:22,2,5,7,28.57,42,22,32,28,4,10,7,17,15310.0,3:13,0,0,0,503.0,0:6,3000000
8468086,Alexandre,Giroux,1981-06-16,LW,L,2010-11,8,1,1,2,0.25,-2,13,7.69,2,7084.0,14:45,0,2,2,0.0,16,3,1,1,0,0,0,0,1544.0,3:13,0,0,0,0.0,0:0,-111
8468095,George,Parros,1979-12-29,RW,R,2010-11,78,3,1,4,0.05,-4,33,9.09,171,30014.0,6:24,1,3,4,25.0,97,26,7,13,-6,0,0,0,68.0,0:0,0,0,0,0.0,0:0,875000
8468101,Radek,Martinek,1976-08-31,D,R,2010-11,64,3,13,16,0.25,-5,97,3.09,35,80047.0,20:50,0,0,0,0.0,69,128,34,39,-5,1,0,1,2157.0,0:33,0,0,0,9999.0,2:36,1500000
8468114,Douglas,Murray,1980-03-12,D,L,2010-11,73,1,13,14,0.19,5,102,0.98,44,85900.0,19:36,0,0,0,0.0,203,140,21,27,-6,0,1,1,1717.0,0:23,0,0,0,9067.0,2:4,2500000
8468162,Jerred,Smithson,1979-02-04,C,R,2010-11,82,5,8,13,0.16,-6,73,6.85,34,73061.0,14:50,578,428,1006,57.46,162,64,41,21,20,0,0,0,767.0,0:9,0,0,0,13477.0,2:44,762500
8468172,Ruslan,Fedotenko,1979-01-18,LW,L,2010-11,66,10,15,25,0.38,9,120,8.33,25,59380.0,14:59,12,20,32,37.5,150,50,28,7,21,0,2,2,3096.0,0:46,1,0,1,4372.0,1:6,-111
8468208,Joel,Ward,1980-12-02,RW,R,2010-11,80,10,19,29,0.36,-1,157,6.37,42,81948.0,17:4,82,86,168,48.81,67,57,51,29,22,5,0,5,7218.0,1:30,0,1,1,9033.0,1:52,1500000
8468213,Jim,Vandermeer,1980-02-21,D,L,2010-11,62,2,12,14,0.23,-15,57,3.51,74,67707.0,18:12,0,0,0,0.0,122,78,27,47,-20,0,2,2,1730.0,0:27,0,1,1,7736.0,2:4,2300000
8468224,Sean,Avery,1980-04-10,LW,L,2010-11,76,3,21,24,0.32,-4,137,2.19,174,51227.0,11:14,15,9,24,62.5,115,24,19,19,0,0,1,1,1686.0,0:22,0,0,0,8.0,0:0,3875000
8468252,Eric,Godard,1980-03-07,RW,R,2010-11,19,0,3,3,0.16,4,1,0.0,105,5898.0,5:10,0,0,0,0.0,19,2,0,1,-1,0,0,0,27.0,0:1,0,0,0,10.0,0:0,750000
8468432,Steve,Reinprecht,1976-05-07,C,L,2010-11,29,4,6,10,0.34,-2,31,12.9,6,20475.0,11:46,89,83,172,51.74,20,14,10,4,6,1,0,1,865.0,0:29,0,0,0,822.0,0:28,-111
8468434,Andy,McDonald,1977-08-25,LW,L,2010-11,58,20,30,50,0.86,18,180,11.11,26,69721.0,20:2,207,142,349,59.31,40,27,23,15,8,5,12,17,11657.0,3:20,1,0,1,3174.0,0:54,4700000
8468463,Mathieu,Darche,1976-11-26,LW,L,2010-11,59,12,14,26,0.44,7,90,13.33,10,39884.0,11:16,7,14,21,33.33,73,30,15,10,5,2,5,7,4787.0,1:21,0,0,0,40.0,0:0,-111
8468478,Mike,Weaver,1978-05-02,D,R,2010-11,82,2,11,13,0.16,1,53,3.77,34,102370.0,20:48,0,0,0,0.0,98,132,47,29,18,0,1,1,1097.0,0:13,0,0,0,16001.0,3:15,900000
8468482,Dany,Heatley,1981-01-21,LW,L,2010-11,80,26,38,64,0.8,8,217,11.98,56,94327.0,19:39,9,11,20,45.0,104,29,29,68,-39,11,19,30,15491.0,3:13,1,1,2,4949.0,1:1,7500000
8468483,Marian,Gaborik,1982-02-14,RW,L,2010-11,62,22,26,48,0.77,8,192,11.46,18,67274.0,18:5,0,0,0,0.0,46,22,34,26,8,7,9,16,11772.0,3:9,0,0,0,867.0,0:13,7500000
8468484,Rostislav,Klesla,1982-03-21,D,L,2010-11,61,4,7,11,0.18,4,67,5.97,38,69810.0,19:4,1,0,1,100.0,61,131,18,9,9,0,0,0,230.0,0:3,0,0,0,11472.0,3:8,2975000
8468485,Raffi,Torres,1981-10-08,LW,L,2010-11,80,14,15,29,0.36,4,115,12.17,78,59944.0,12:29,10,22,32,31.25,134,19,31,24,7,3,1,4,4366.0,0:54,0,0,0,19.0,0:0,1000000
8468486,Scott,Hartnell,1982-04-18,LW,L,2010-11,82,24,25,49,0.6,14,177,13.56,142,81696.0,16:36,5,5,10,50.0,168,38,31,33,-2,4,6,10,13611.0,2:45,0,0,0,294.0,0:3,4200000
8468493,Ron,Hainsey,1981-03-24,D,L,2010-11,82,3,16,19,0.23,3,83,3.61,24,88978.0,18:5,0,0,0,0.0,51,173,30,47,-17,0,1,1,2302.0,0:28,0,1,1,8948.0,1:49,4500000
8468498,Brooks,Orpik,1980-09-26,D,L,2010-11,63,1,12,13,0.21,12,56,1.79,66,78936.0,20:52,1,0,1,100.0,194,94,17,20,-3,0,0,0,378.0,0:6,0,3,3,14134.0,3:44,3750000
8468500,Alex,Frolov,1982-06-19,LW,R,2010-11,43,7,9,16,0.37,4,78,8.97,8,37220.0,14:25,1,6,7,14.29,39,15,12,10,2,0,1,1,5859.0,2:16,0,0,0,115.0,0:2,3000000
8468501,Anton,Volchenkov,1982-02-25,D,L,2010-11,57,0,8,8,0.14,3,65,0.0,36,61920.0,18:6,0,0,0,0.0,125,106,7,19,-12,0,0,0,69.0,0:1,0,0,0,7298.0,2:8,4250000
8468502,David,Hale,1981-06-18,D,L,2010-11,25,1,4,5,0.2,7,20,5.0,6,24469.0,16:18,0,0,0,0.0,29,22,8,10,-2,0,0,0,21.0,0:0,0,0,0,1996.0,1:19,675000
8468504,Brad,Boyes,1982-04-17,RW,R,2010-11,83,17,38,55,0.66,13,178,9.55,36,84627.0,16:59,136,184,320,42.5,67,33,30,29,1,6,7,13,12245.0,2:27,0,0,0,268.0,0:3,4000000
8468505,Steve,Ott,1982-08-19,C,L,2010-11,82,12,20,32,0.39,-9,120,10.0,183,84391.0,17:9,644,494,1138,56.59,252,44,25,43,-18,3,7,10,11126.0,2:15,2,2,4,10082.0,2:2,2950000
8468506,Brian,Sutherby,1982-03-01,C,L,2010-11,51,2,2,4,0.08,-10,32,6.25,58,22681.0,7:24,19,13,32,59.38,70,9,9,8,1,0,0,0,341.0,0:6,0,0,0,1892.0,0:37,812500
8468508,Justin,Williams,1981-10-04,RW,R,2010-11,73,22,35,57,0.78,14,213,10.33,59,75561.0,17:15,7,7,14,50.0,51,29,26,64,-38,5,8,13,11550.0,2:38,0,0,0,518.0,0:7,3500000
8468509,Niklas,Kronwall,1981-01-12,D,L,2010-11,77,11,26,37,0.48,5,131,8.4,36,105653.0,22:52,0,0,0,0.0,113,129,26,49,-23,5,8,13,11954.0,2:35,0,0,0,13505.0,2:55,3000000
8468510,Jeff,Taffe,1981-02-19,LW,L,2010-11,1,0,0,0,0.0,0,0,,0,245.0,4:5,2,3,5,40.0,0,0,0,0,0,0,0,0,0.0,0:0,0,0,0,0.0,0:0,-111
8468513,Nick,Schultz,1982-08-25,D,L,2010-11,74,3,14,17,0.23,-4,46,6.52,38,89779.0,20:13,1,0,1,100.0,78,132,9,25,-16,0,1,1,1285.0,0:17,0,1,1,12080.0,2:43,3500000
8468515,Brad,Winchester,1981-03-01,LW,L,2010-11,76,10,6,16,0.21,-18,90,11.11,114,47804.0,10:29,2,6,8,25.0,171,18,19,8,11,3,1,4,5364.0,1:10,0,0,0,156.0,0:2,700000
8468518,Tomas,Kopecky,1982-02-05,RW,L,2010-11,81,15,27,42,0.52,-13,178,8.43,60,74475.0,15:19,120,164,284,42.25,77,24,50,25,25,3,10,13,12386.0,2:32,0,0,0,1974.0,0:24,1200000
8468520,Kurtis,Foster,1981-11-24,D,R,2010-11,74,8,14,22,0.3,-12,182,4.4,45,78407.0,17:39,0,0,0,0.0,89,76,18,37,-19,5,9,14,17067.0,3:50,0,0,0,698.0,0:9,1800000
8468526,Jarret,Stoll,1982-06-24,C,R,2010-11,82,20,23,43,0.52,-6,187,10.7,42,84447.0,17:9,753,557,1310,57.48,164,41,31,26,5,4,8,12,12410.0,2:31,1,2,3,7320.0,1:29,3600000
8468534,Andreas,Lilja,1975-07-13,D,L,2010-11,52,1,6,7,0.13,-15,31,3.23,28,54391.0,17:25,0,0,0,0.0,92,113,6,20,-14,0,0,0,103.0,0:1,0,0,0,10943.0,3:30,600000
8468535,Antoine,Vermette,1982-07-20,C,L,2010-11,82,19,28,47,0.57,0,183,10.38,60,92566.0,18:48,856,684,1540,55.58,123,47,35,23,12,3,7,10,14326.0,2:54,1,0,1,7071.0,1:26,3750000
8468542,Paul,Martin,1981-03-05,D,L,2010-11,77,3,21,24,0.31,9,104,2.88,16,107948.0,23:21,0,0,0,0.0,45,129,36,27,9,2,8,10,14038.0,3:2,0,1,1,12683.0,2:44,5000000
8468575,Dominic,Moore,1980-08-03,C,L,2010-11,77,18,14,32,0.42,-12,175,10.29,52,72055.0,15:35,475,417,892,53.25,80,42,32,25,7,6,1,7,4196.0,0:54,0,0,0,9779.0,2:7,1100000
8468577,Niclas,Wallin,1975-02-20,D,L,2010-11,74,3,5,8,0.11,0,86,3.49,46,70313.0,15:50,0,0,0,0.0,99,84,21,40,-19,0,0,0,519.0,0:7,0,0,0,6650.0,1:29,2650000
8468598,Lubomir,Visnovsky,1976-08-11,D,L,2010-11,81,18,50,68,0.84,18,152,11.84,24,118063.0,24:17,0,0,0,0.0,52,116,30,45,-15,5,26,31,20160.0,4:8,0,0,0,2119.0,0:26,5600000
8468599,Brian,Fahey,1981-03-02,D,R,2010-11,7,0,1,1,0.14,-1,4,0.0,2,4964.0,11:49,0,0,0,0.0,9,6,0,1,-1,0,0,0,263.0,0:37,0,0,0,59.0,0:8,-111
8468611,Matt,Hendricks,1981-06-17,C,L,2010-11,77,9,16,25,0.32,-2,113,7.96,110,52945.0,11:27,52,46,98,53.06,169,38,18,10,8,1,1,2,1418.0,0:18,0,0,0,5749.0,1:14,575000
8468626,David,Koci,1981-05-12,LW,L,2010-11,35,1,0,1,0.03,-5,9,11.11,80,8583.0,4:5,0,0,0,0.0,28,5,1,1,0,0,0,0,10.0,0:0,0,0,0,15.0,0:0,-111
8468635,Travis,Moen,1982-04-06,LW,L,2010-11,79,6,10,16,0.2,-4,99,6.06,96,62516.0,13:11,8,14,22,36.36,129,42,15,7,8,0,0,0,283.0,0:3,1,0,1,11013.0,2:19,1500000
8468636,Greg,Zanon,1980-06-05,D,L,2010-11,82,0,7,7,0.09,-5,55,0.0,48,105993.0,21:32,0,0,0,0.0,169,212,21,28,-7,0,1,1,612.0,0:7,0,1,1,14928.0,3:2,1933333
8468639,John-Michael,Liles,1980-11-25,D,L,2010-11,76,6,40,46,0.61,-9,163,3.68,35,100360.0,22:0,0,0,0,0.0,59,153,32,36,-4,3,15,18,14706.0,3:13,0,0,0,4843.0,1:3,4200000
8468660,Darcy,Hordichuk,1980-08-10,LW,L,2010-11,64,1,4,5,0.08,-1,32,3.12,76,19464.0,5:4,0,0,0,0.0,116,4,5,6,-1,0,0,0,28.0,0:0,0,0,0,0.0,0:0,775000
8468674,Deryk,Engelland,1982-04-03,D,R,2010-11,63,3,7,10,0.16,-5,49,6.12,123,50426.0,13:20,0,0,0,0.0,122,54,15,14,1,0,0,0,50.0,0:0,0,0,0,1873.0,0:29,500000
8468695,Matthew,Lombardi,1982-03-18,C,L,2010-11,2,0,0,0,0.0,-1,6,0.0,0,1779.0,14:49,16,13,29,55.17,0,0,2,1,1,0,0,0,290.0,2:25,0,0,0,1.0,0:0,3500000
8468700,Paul,Gaustad,1982-02-03,C,L,2010-11,81,12,19,31,0.38,7,117,10.26,101,73551.0,15:8,692,466,1158,59.76,128,44,22,24,-2,1,1,2,3931.0,0:48,0,1,1,9836.0,2:1,2300000
8468704,Antti,Miettinen,1980-07-03,RW,R,2010-11,73,16,19,35,0.48,-3,168,9.52,38,74572.0,17:1,36,64,100,36.0,109,14,23,20,3,8,6,14,12245.0,2:47,0,0,0,5489.0,1:15,2333333
8468778,Colton,Orr,1982-03-03,RW,R,2010-11,46,2,0,2,0.04,-1,14,14.29,128,13999.0,5:4,0,1,1,0.0,46,9,1,5,-4,0,0,0,124.0,0:2,0,0,0,55.0,0:1,1000000
8468789,Jason,Williams,1980-08-11,C,R,2010-11,27,2,3,5,0.19,-2,18,11.11,6,13137.0,8:6,18,26,44,40.91,14,5,10,5,5,0,1,1,737.0,0:27,0,0,0,0.0,0:0,500000
8468846,Tyler,Sloan,1981-03-15,D,L,2010-11,33,1,5,6,0.18,-6,12,8.33,14,24750.0,12:30,0,0,0,0.0,30,32,8,21,-13,0,0,0,10.0,0:0,0,0,0,668.0,0:20,700000
8468887,Warren,Peters,1982-07-10,C,L,2010-11,11,1,0,1,0.09,-2,11,9.09,4,5750.0,8:42,49,30,79,62.03,24,7,1,1,0,0,0,0,27.0,0:2,0,0,0,36.0,0:3,-111
8468927,Steve,Montador,1979-12-21,D,R,2010-11,73,5,21,26,0.36,16,118,4.24,83,86385.0,19:43,0,1,1,0.0,86,138,21,61,-40,0,1,1,1637.0,0:22,0,0,0,9098.0,2:4,1550000
8469120,Raitis,Ivanans,1979-01-03,LW,L,2010-11,1,0,0,0,0.0,-1,0,,5,500.0,8:20,0,0,0,0.0,1,0,1,0,1,0,0,0,0.0,0:0,0,0,0,0.0,0:0,-111
8469454,Ilya,Kovalchuk,1983-04-15,RW,R,2010-11,81,31,29,60,0.74,-26,245,12.65,28,109655.0,22:33,9,22,31,29.03,28,12,43,104,-61,9,12,21,20250.0,4:10,0,0,0,756.0,0:9,6666666
8469455,Jason,Spezza,1983-06-13,C,R,2010-11,62,21,36,57,0.92,-7,188,11.17,28,75140.0,20:11,681,529,1210,56.28,14,24,52,62,-10,7,10,17,13418.0,3:36,0,1,1,6817.0,1:49,7000000
8469457,Stephen,Weiss,1983-04-03,C,L,2010-11,76,21,28,49,0.64,-9,172,12.21,49,91651.0,20:5,689,590,1279,53.87,52,44,44,28,16,3,16,19,16015.0,3:30,2,0,2,7633.0,1:40,3100000
8469459,Mikko,Koivu,1983-03-12,C,L,2010-11,71,17,45,62,0.87,4,191,8.9,50,83033.0,19:29,683,610,1293,52.82,63,29,64,51,13,7,15,22,13741.0,3:13,1,0,1,7804.0,1:49,3250000
8469460,Mike,Komisarek,1982-01-19,D,R,2010-11,75,1,9,10,0.13,-8,48,2.08,86,61340.0,13:37,0,0,0,0.0,146,117,14,51,-37,0,0,0,175.0,0:2,0,0,0,7027.0,1:33,4300000
8469462,Tuomo,Ruutu,1983-02-16,LW,L,2010-11,82,19,38,57,0.7,1,148,12.84,54,82788.0,16:49,265,378,643,41.21,309,38,42,38,4,7,9,16,15317.0,3:6,0,0,0,385.0,0:4,3800000
8469464,Fredrik,Sjostrom,1983-05-06,LW,L,2010-11,66,2,3,5,0.08,-5,62,3.23,14,44392.0,11:12,5,10,15,33.33,108,33,15,15,0,0,0,0,277.0,0:4,0,0,0,6529.0,1:38,750000
8469465,Dan,Hamhuis,1982-12-13,D,L,2010-11,64,6,17,23,0.36,29,109,5.5,34,87089.0,22:40,0,0,0,0.0,76,89,43,33,10,2,5,7,6034.0,1:34,0,0,0,12106.0,3:9,4500000
8469466,Ales,Hemsky,1983-08-13,RW,R,2010-11,47,14,28,42,0.89,3,100,14.0,18,51556.0,18:16,1,6,7,14.29,29,18,17,32,-15,1,8,9,9080.0,3:13,1,1,2,2237.0,0:47,4100000
8469467,Chuck,Kobasew,1982-04-17,RW,R,2010-11,63,9,7,16,0.25,-6,74,12.16,19,44750.0,11:50,6,7,13,46.15,31,20,17,13,4,0,0,0,1436.0,0:22,0,0,0,1319.0,0:20,2333333
8469469,R.J.,Umberger,1982-05-03,C,L,2010-11,82,25,32,57,0.7,3,220,11.36,38,94530.0,19:12,111,109,220,50.45,114,70,44,20,24,8,5,13,16200.0,3:17,3,0,3,9687.0,1:58,3750000
8469470,Carlo,Colaiacovo,1983-01-27,D,L,2010-11,65,6,20,26,0.4,-4,81,7.41,23,70728.0,18:8,0,0,0,0.0,75,79,16,21,-5,1,10,11,10732.0,2:45,0,0,0,1180.0,0:18,2125000
8469472,Shaone,Morrisonn,1982-12-23,D,L,2010-11,62,1,4,5,0.08,-2,44,2.27,32,60166.0,16:10,0,0,0,0.0,110,86,14,15,-1,0,0,0,366.0,0:5,0,0,0,6986.0,1:52,2075000
8469473,Marcel,Goc,1983-08-24,C,L,2010-11,51,9,15,24,0.47,10,111,8.11,6,49079.0,16:2,346,347,693,49.93,51,13,17,17,0,0,0,0,3144.0,1:1,1,0,1,2403.0,0:47,775000
8469474,Colby,Armstrong,1982-11-23,RW,R,2010-11,50,8,15,23,0.46,-1,69,11.59,38,48374.0,16:7,3,5,8,37.5,88,28,34,19,15,0,0,0,1827.0,0:36,0,0,0,5565.0,1:51,3000000
8469476,Tim,Gleason,1983-01-29,D,L,2010-11,82,2,14,16,0.2,-11,84,2.38,85,103149.0,20:57,0,0,0,0.0,215,141,16,43,-27,0,1,1,4977.0,1:0,0,1,1,13425.0,2:43,2750000
8469480,Jeff,Woywitka,1983-09-01,D,L,2010-11,63,2,9,11,0.17,5,72,2.78,24,67834.0,17:56,0,0,0,0.0,43,97,19,27,-8,1,1,2,2272.0,0:36,0,0,0,703.0,0:11,650000
8469483,David,Steckel,1982-03-15,C,L,2010-11,75,6,6,12,0.16,-6,79,7.59,26,53439.0,11:52,511,309,820,62.32,104,50,24,16,8,0,0,0,724.0,0:9,1,0,1,7362.0,1:38,1100000
8469485,Derek,Roy,1983-05-04,C,L,2010-11,35,10,25,35,1.0,-1,89,11.24,16,41026.0,19:32,245,283,528,46.4,16,16,37,25,12,2,12,14,7838.0,3:43,0,0,0,3058.0,1:27,4000000
8469490,Tim,Jackman,1981-11-14,RW,R,2010-11,82,10,13,23,0.28,4,131,7.63,86,48334.0,9:49,6,10,16,37.5,133,21,23,12,11,1,2,3,3765.0,0:45,0,0,0,610.0,0:7,550000
8469492,Fedor,Tyutin,1983-07-19,D,L,2010-11,80,7,20,27,0.34,-12,128,5.47,32,108934.0,22:41,1,1,2,50.0,120,93,29,29,0,1,11,12,14041.0,2:55,0,0,0,13050.0,2:43,2843750
8469500,Michael,Cammalleri,1982-06-08,LW,L,2010-11,67,19,28,47,0.7,2,193,9.84,33,74288.0,18:28,33,41,74,44.59,17,19,23,31,-8,7,14,21,12476.0,3:6,0,0,0,3049.0,0:45,6000000
8469501,Chris,Thorburn,1983-06-03,RW,R,2010-11,82,9,10,19,0.23,-4,114,7.89,77,67876.0,13:47,125,126,251,49.8,129,71,43,10,33,2,1,3,1880.0,0:22,0,0,0,9194.0,1:52,660000
8469505,Noah,Welch,1982-08-26,D,L,2010-11,2,0,0,0,0.0,-1,1,0.0,0,2106.0,17:33,0,0,0,0.0,10,3,0,0,0,0,0,0,0.0,0:0,0,0,0,0.0,0:0,525000
8469506,Jason,Pominville,1982-11-30,RW,R,2010-11,73,22,30,52,0.71,1,215,10.23,15,79509.0,18:9,67,88,155,43.23,35,50,43,27,16,5,9,14,12792.0,2:55,1,0,1,8577.0,1:57,5300000
8469508,Jay,McClement,1983-03-02,C,L,2010-11,80,7,13,20,0.25,-21,127,5.51,30,80120.0,16:41,595,557,1152,51.65,75,63,37,21,16,1,0,1,487.0,0:6,0,1,1,14428.0,3:0,1450000
8469521,Tomas,Plekanec,1982-10-31,C,L,2010-11,77,22,35,57,0.74,8,227,9.69,60,93549.0,20:14,788,789,1577,49.97,53,45,43,37,6,3,15,18,13539.0,2:55,1,1,2,13049.0,2:49,5000000
8469531,Jay,Harrison,1982-11-03,D,L,2010-11,72,3,7,10,0.14,5,49,6.12,72,65970.0,15:16,0,0,0,0.0,111,100,16,32,-16,0,0,0,560.0,0:7,0,0,0,9064.0,2:5,500000
8469544,Patrick,Sharp,1981-12-27,LW,R,2010-11,74,34,37,71,0.96,-1,268,12.69,38,86193.0,19:24,244,264,508,48.03,76,26,64,23,41,12,14,26,14964.0,3:22,2,1,3,5597.0,1:15,3900000
8469547,Jordin,Tootoo,1983-02-02,RW,R,2010-11,54,8,10,18,0.33,8,85,9.41,61,38482.0,11:52,2,1,3,66.67,95,17,25,35,-10,0,0,0,683.0,0:12,0,0,0,0.0,0:0,1250000
8469555,Christian,Ehrhoff,1982-07-06,D,L,2010-11,79,14,36,50,0.63,19,209,6.7,52,113720.0,23:59,0,0,0,0.0,54,108,19,47,-28,6,22,28,16888.0,3:33,0,1,1,10114.0,2:8,3100000
8469564,Richard,Petiot,1982-08-20,D,L,2010-11,2,0,0,0,0.0,1,1,0.0,2,1570.0,13:5,0,0,0,0.0,3,4,2,1,1,0,0,0,0.0,0:0,0,0,0,107.0,0:53,-111
8469581,Kyle,Wellwood,1983-05-16,C,R,2010-11,35,5,8,13,0.37,10,50,10.0,0,28731.0,13:40,65,67,132,49.24,8,7,26,20,6,0,1,1,859.0,0:24,0,0,0,21.0,0:0,650000
8469582,Colin,Stuart,1982-07-08,LW,L,2010-11,3,0,0,0,0.0,1,5,0.0,2,2368.0,13:9,1,1,2,50.0,3,4,2,0,2,0,0,0,2.0,0:0,0,0,0,104.0,0:34,550000
8469584,Joel,Perrault,1983-04-06,C,R,2010-11,7,0,0,0,0.0,-1,3,0.0,0,3021.0,7:11,13,18,31,41.94,11,2,1,2,-1,0,0,0,138.0,0:19,0,0,0,0.0,0:0,510000
8469591,Cody,McCormick,1983-04-18,C,R,2010-11,81,8,12,20,0.25,2,104,7.69,142,53237.0,10:57,132,184,316,41.77,108,60,20,19,1,0,1,1,538.0,0:6,0,0,0,765.0,0:9,500000
8469598,Kevin,Bieksa,1981-06-16,D,R,2010-11,66,6,16,22,0.33,32,105,5.71,73,88976.0,22:28,0,0,0,0.0,104,93,50,41,9,1,2,3,6807.0,1:43,0,0,0,10607.0,2:40,3750000
8469619,Dennis,Seidenberg,1981-07-18,D,L,2010-11,81,7,25,32,0.4,3,166,4.22,41,114427.0,23:32,0,0,0,0.0,161,174,12,27,-15,1,10,11,10655.0,2:11,0,0,0,10903.0,2:14,3250000
8469622,Ryane,Clowe,1982-09-30,LW,L,2010-11,75,24,38,62,0.83,13,185,12.97,100,80825.0,17:57,17,24,41,41.46,153,22,43,54,-11,5,8,13,10135.0,2:15,0,0,0,244.0,0:3,3625000
8469623,Marek,Zidlicky,1977-02-03,D,R,2010-11,46,7,17,24,0.52,-6,53,13.21,30,60092.0,21:46,0,0,0,0.0,66,63,14,33,-19,3,6,9,9076.0,3:17,0,0,0,6046.0,2:11,4000000
8469626,Andrew,Alberts,1981-06-30,D,L,2010-11,42,1,6,7,0.17,0,21,4.76,41,38200.0,15:9,0,0,0,0.0,113,49,7,19,-12,0,0,0,257.0,0:6,0,0,0,3936.0,1:33,1050000
8469638,Jussi,Jokinen,1983-04-01,LW,L,2010-11,70,19,33,52,0.74,3,136,13.97,24,72343.0,17:13,169,151,320,52.81,45,38,39,38,1,8,10,18,14629.0,3:28,0,0,0,3545.0,0:50,1700000
8469639,Brooks,Laich,1983-06-23,C,L,2010-11,82,16,32,48,0.59,14,207,7.73,46,90633.0,18:25,269,255,524,51.34,113,54,38,32,6,4,9,13,14739.0,2:59,1,2,3,11320.0,2:18,2066667
8469647,Derek,Boogaard,1982-06-23,LW,L,2010-11,22,1,1,2,0.09,0,4,25.0,45,6005.0,4:32,0,0,0,0.0,27,3,0,1,-1,0,0,0,20.0,0:0,0,0,0,0.0,0:0,1625000
8469664,David,Moss,1981-12-28,RW,R,2010-11,58,17,13,30,0.52,9,127,13.39,18,47628.0,13:41,157,207,364,43.13,92,32,32,27,5,5,2,7,5128.0,1:28,0,0,0,5578.0,1:36,1300000
8469665,Johnny,Oduya,1981-10-01,D,L,2010-11,82,2,15,17,0.21,-15,90,2.22,22,101957.0,20:43,0,0,0,0.0,64,149,45,46,-1,0,4,4,4118.0,0:50,0,0,0,15086.0,3:3,3500000
8469670,Marek,Svatos,1982-06-17,RW,R,2010-11,28,4,4,8,0.29,0,50,8.0,10,19695.0,11:43,0,0,0,0.0,12,10,9,5,4,0,0,0,1709.0,1:1,0,0,0,24.0,0:0,800000
8469672,Aaron,Voros,1981-07-02,LW,L,2010-11,12,0,0,0,0.0,-4,8,0.0,43,3993.0,5:32,2,1,3,66.67,12,1,1,0,1,0,0,0,0.0,0:0,0,0,0,0.0,0:0,-111
8469681,Ryan,Hollweg,1983-04-23,LW,L,2010-11,3,0,0,0,0.0,-1,0,,0,1180.0,6:33,0,0,0,0.0,8,0,0,1,-1,0,0,0,4.0,0:1,0,0,0,0.0,0:0,500000
8469684,Milan,Jurcina,1983-06-07,D,R,2010-11,46,4,13,17,0.37,-4,76,5.26,30,49867.0,18:4,0,1,1,0.0,125,93,25,22,3,1,4,5,3250.0,1:10,1,1,2,6423.0,2:19,1000000
8469685,Andrew,Murray,1981-11-06,C,L,2010-11,29,4,4,8,0.28,2,48,8.33,4,19803.0,11:22,19,22,41,46.34,77,14,10,1,9,0,0,0,93.0,0:3,0,1,1,2295.0,1:19,625000
8469707,PA,Parenteau,1983-03-24,RW,R,2010-11,81,20,33,53,0.65,-8,161,12.42,46,88560.0,18:13,11,19,30,36.67,118,28,45,54,-9,9,11,20,16986.0,3:29,0,0,0,217.0,0:2,600000
8469755,Brandon,Segal,1983-07-12,RW,R,2010-11,46,5,5,10,0.22,0,40,12.5,41,22876.0,8:17,2,2,4,50.0,91,8,8,11,-3,0,0,0,841.0,0:18,0,0,0,33.0,0:0,-111
8469759,Vernon,Fiddler,1980-05-09,C,L,2010-11,71,6,16,22,0.31,3,97,6.19,46,66218.0,15:32,660,564,1224,53.92,85,60,27,21,6,0,1,1,684.0,0:9,1,1,2,12336.0,2:53,1100000
8469760,Zbynek,Michalek,1982-12-23,D,R,2010-11,73,5,14,19,0.26,0,104,4.81,30,95653.0,21:50,0,0,0,0.0,56,149,13,38,-25,1,3,4,5228.0,1:11,0,0,0,16500.0,3:46,4000000
8469765,Marc-Andre,Bergeron,1980-10-13,D,L,2010-11,23,2,6,8,0.35,-10,37,5.41,8,19765.0,14:19,0,0,0,0.0,6,18,5,15,-10,0,3,3,4730.0,3:25,0,0,0,63.0,0:2,1000000
8469770,Dennis,Wideman,1983-03-20,D,R,2010-11,75,10,30,40,0.53,-19,160,6.25,39,107919.0,23:58,1,0,1,100.0,95,126,38,53,-15,9,13,22,18325.0,4:4,0,0,0,10902.0,2:25,3937500
8469779,Keith,Aucoin,1978-11-06,C,L,2010-11,1,0,0,0,0.0,0,0,,0,707.0,11:47,1,2,3,33.33,1,0,0,0,0,0,0,0,354.0,5:54,0,0,0,0.0,0:0,-111
8469812,Chad,LaRose,1982-03-27,RW,R,2010-11,82,16,15,31,0.38,-21,176,9.09,59,78765.0,16:0,11,22,33,33.33,196,23,39,18,21,2,1,3,2430.0,0:29,1,1,2,6992.0,1:25,1700000
8469820,Zenon,Konopka,1981-01-02,C,L,2010-11,82,2,7,9,0.11,-14,56,3.57,307,50134.0,10:11,620,455,1075,57.67,110,52,18,13,5,0,0,0,1006.0,0:12,0,0,0,7566.0,1:32,-111
8469992,Sheldon,Brookbank,1980-10-03,D,R,2010-11,40,0,0,0,0.0,-8,29,0.0,63,31983.0,13:19,0,0,0,0.0,54,37,3,9,-6,0,0,0,67.0,0:1,0,0,0,5057.0,2:6,-111
8470018,Matt,Ellis,1981-08-31,LW,L,2010-11,14,0,0,0,0.0,-4,20,0.0,0,8437.0,10:2,28,30,58,48.28,8,7,4,1,3,0,0,0,122.0,0:8,0,0,0,140.0,0:10,625000
8470039,Tomas,Fleischmann,1984-05-16,LW,L,2010-11,45,12,19,31,0.69,2,98,12.24,18,44171.0,16:21,99,137,236,41.95,15,14,26,21,5,3,3,6,6714.0,2:29,0,0,0,611.0,0:13,2600000
8470041,Rick,Nash,1984-06-16,LW,L,2010-11,75,32,34,66,0.88,2,305,10.49,34,85170.0,18:55,7,17,24,29.17,91,19,47,24,23,6,8,14,16438.0,3:39,0,0,0,1281.0,0:17,7800000
8470047,Valtteri,Filppula,1984-03-20,C,L,2010-11,71,16,23,39,0.55,-1,115,13.91,22,71220.0,16:43,478,450,928,51.51,30,25,50,42,8,4,4,8,8643.0,2:1,0,0,0,2833.0,0:39,3000000
8470054,Keith,Ballard,1982-11-26,D,L,2010-11,65,2,5,7,0.11,10,53,3.77,53,62035.0,15:54,0,0,0,0.0,99,111,9,28,-19,0,0,0,834.0,0:12,0,0,0,6417.0,1:38,3300000
8470063,Adam,Burish,1983-01-06,RW,R,2010-11,63,8,6,14,0.22,2,89,8.99,91,54242.0,14:20,255,222,477,53.46,77,70,14,13,1,0,0,0,619.0,0:9,0,0,0,7439.0,1:58,1150000
8470065,Ryan,Craig,1982-01-06,C,L,2010-11,6,0,0,0,0.0,-3,7,0.0,22,3536.0,9:49,3,2,5,60.0,6,1,0,0,0,0,0,0,255.0,0:42,0,0,0,248.0,0:41,500000
8470072,Petr,Prucha,1982-09-14,RW,R,2010-11,11,0,1,1,0.09,0,10,0.0,4,7563.0,11:27,3,2,5,60.0,13,3,4,1,3,0,0,0,70.0,0:6,0,0,0,281.0,0:25,1200000
8470086,Joe,Callahan,1982-12-20,D,R,2010-11,27,0,1,1,0.04,-1,21,0.0,12,25724.0,15:52,0,0,0,0.0,46,36,1,4,-3,0,0,0,631.0,0:23,0,0,0,616.0,0:22,-111
8470104,Tom,Gilbert,1983-01-10,D,R,2010-11,79,6,20,26,0.33,-14,106,5.66,32,116150.0,24:30,0,0,0,0.0,69,172,43,87,-44,3,7,10,14209.0,2:59,0,2,2,15900.0,3:21,4000000
8470105,Scottie,Upshall,1983-10-07,RW,L,2010-11,82,22,12,34,0.41,-7,191,11.52,52,69074.0,14:2,8,17,25,32.0,108,26,33,22,11,2,1,3,5593.0,1:8,0,0,0,1034.0,0:12,2250000
8470110,Trevor,Daley,1983-10-09,D,L,2010-11,82,8,19,27,0.33,7,131,6.11,34,110629.0,22:29,0,0,0,0.0,32,124,34,42,-8,2,3,5,9501.0,1:55,0,0,0,9136.0,1:51,2300000
8470113,John,Zeiler,1982-11-21,RW,R,2010-11,4,0,0,0,0.0,-1,1,0.0,0,1344.0,5:36,5,5,10,50.0,4,0,0,0,0,0,0,0,0.0,0:0,0,0,0,0.0,0:0,-111
8470120,Alexander,Semin,1984-03-03,RW,R,2010-11,65,28,26,54,0.83,22,196,14.29,71,70486.0,18:4,4,9,13,30.77,27,6,62,42,20,6,12,18,12525.0,3:12,1,0,1,3683.0,0:56,6000000
8470121,Matt,Greene,1983-05-13,D,R,2010-11,71,2,9,11,0.15,3,50,4.0,70,72319.0,16:58,0,0,0,0.0,243,105,8,38,-30,0,0,0,404.0,0:5,0,0,0,11051.0,2:35,2950000
8470123,Cam,Janssen,1984-04-15,RW,R,2010-11,54,1,3,4,0.07,-6,16,6.25,131,15807.0,4:52,0,0,0,0.0,95,7,3,2,1,0,0,0,66.0,0:1,0,0,0,0.0,0:0,600000
8470136,Nathan,Oystrick,1982-12-17,D,L,2010-11,9,1,2,3,0.33,1,11,9.09,9,6573.0,12:10,0,0,0,0.0,6,5,0,1,-1,1,0,1,692.0,1:16,0,0,0,0.0,0:0,563750
8470137,Joni,Pitkanen,1983-09-19,D,L,2010-11,72,5,30,35,0.49,-2,144,3.47,60,108104.0,25:1,0,0,0,0.0,66,130,32,32,0,1,11,12,17834.0,4:7,0,0,0,5010.0,1:9,4000000
8470144,Frans,Nielsen,1984-04-24,C,L,2010-11,71,13,31,44,0.62,13,156,8.33,38,75672.0,17:45,446,519,965,46.22,23,63,66,33,33,0,8,8,10719.0,2:30,7,1,8,12767.0,2:59,525000
8470151,Jay,Bouwmeester,1983-09-27,D,L,2010-11,82,4,20,24,0.29,-2,121,3.31,44,127856.0,25:59,0,0,0,0.0,72,134,23,57,-34,1,7,8,13658.0,2:46,0,0,0,16492.0,3:21,6680000
8470153,Pierre-Marc,Bouchard,1984-04-27,C,L,2010-11,59,12,26,38,0.64,-3,98,12.24,14,55626.0,15:42,17,26,43,39.53,15,10,26,20,6,0,10,10,9733.0,2:44,0,0,0,73.0,0:1,4080000
8470156,Joey,Crabb,1983-04-03,RW,R,2010-11,48,3,12,15,0.31,-1,51,5.88,24,37381.0,12:58,5,17,22,22.73,99,20,21,13,8,0,0,0,2405.0,0:50,1,0,1,2349.0,0:48,525000
8470159,Boyd,Gordon,1983-10-19,C,R,2010-11,60,3,6,9,0.15,-5,77,3.9,16,46970.0,13:2,417,302,719,58.0,33,50,14,10,4,0,0,0,266.0,0:4,1,0,1,8055.0,2:14,800000
8470162,Matt,Stajan,1983-12-19,C,L,2010-11,76,6,25,31,0.41,1,81,7.41,32,64877.0,14:13,436,409,845,51.6,66,24,52,39,13,0,1,1,4807.0,1:3,1,1,2,3283.0,0:43,3500000
8470169,Gregory,Campbell,1983-12-17,C,L,2010-11,80,13,16,29,0.36,11,98,13.27,93,64504.0,13:26,430,402,832,51.68,119,52,11,18,-7,1,1,2,1055.0,0:13,1,3,4,8299.0,1:43,1100000
8470171,Max,Talbot,1984-02-11,C,L,2010-11,82,8,13,21,0.26,-3,117,6.84,66,74134.0,15:4,425,449,874,48.63,154,40,26,17,9,0,0,0,562.0,0:6,2,1,3,14390.0,2:55,1050000
8470176,Sean,Bergenheim,1984-02-08,LW,L,2010-11,80,14,15,29,0.36,0,182,7.69,56,67097.0,13:58,25,26,51,49.02,109,37,45,24,21,2,2,4,5073.0,1:3,0,0,0,6755.0,1:24,700000
8470180,Eric,Nystrom,1983-02-14,LW,L,2010-11,82,4,8,12,0.15,-16,83,4.82,30,65478.0,13:18,45,86,131,34.35,169,31,19,17,2,1,0,1,1316.0,0:16,0,0,0,7474.0,1:31,1400000
8470187,Johnny,Boychuk,1984-01-19,D,R,2010-11,69,3,13,16,0.23,15,154,1.95,45,84884.0,20:30,0,0,0,0.0,117,115,14,21,-7,1,1,2,4220.0,1:1,0,0,0,9074.0,2:11,1875000
8470189,David,Van Der Gulik,1983-04-20,LW,L,2010-11,6,1,2,3,0.5,4,12,8.33,2,2431.0,6:45,0,1,1,0.0,10,3,2,2,0,0,0,0,37.0,0:6,0,0,0,230.0,0:38,500000
8470192,Steve,Eminger,1983-10-31,D,R,2010-11,65,2,4,6,0.09,-5,23,8.7,22,61821.0,15:51,0,0,0,0.0,143,103,18,16,2,0,1,1,1170.0,0:18,0,0,0,5218.0,1:20,1125000
8470201,Jiri,Hudler,1984-01-04,RW,L,2010-11,73,10,27,37,0.51,-7,105,9.52,28,59834.0,13:39,31,39,70,44.29,35,11,30,32,-2,3,9,12,9838.0,2:14,0,0,0,0.0,0:0,2875000
8470203,Greg,Mauldin,1982-06-10,LW,R,2010-11,29,5,5,10,0.34,5,46,10.87,8,18350.0,10:32,2,5,7,28.57,56,11,20,4,16,0,0,0,74.0,0:2,2,0,2,2183.0,1:15,-111
8470207,Joffrey,Lupul,1983-09-23,LW,R,2010-11,54,14,17,31,0.57,-11,129,10.85,33,50618.0,15:37,12,20,32,37.5,63,29,18,17,1,4,9,13,9305.0,2:52,0,0,0,10.0,0:0,4250000
8470222,James,Wisniewski,1984-02-21,D,R,2010-11,75,10,41,51,0.68,-14,158,6.33,38,103237.0,22:56,0,0,0,0.0,108,119,35,67,-32,7,22,29,20073.0,4:27,0,0,0,4525.0,1:0,3250000
8470230,Daniel,Paille,1984-04-15,LW,L,2010-11,43,6,7,13,0.3,3,48,12.5,28,29169.0,11:18,0,0,0,0.0,24,17,10,4,6,0,0,0,57.0,0:1,1,0,1,3254.0,1:15,1075000
8470232,Kris,Newbury,1982-02-19,C,L,2010-11,11,0,1,1,0.09,-1,6,0.0,35,5038.0,7:38,34,22,56,60.71,19,1,0,0,0,0,0,0,40.0,0:3,0,0,0,167.0,0:15,-111
8470257,Alexander,Steen,1984-03-01,LW,L,2010-11,72,20,31,51,0.71,-3,218,9.17,26,84462.0,19:33,41,65,106,38.68,39,28,29,25,4,1,9,10,13507.0,3:7,2,0,2,4124.0,0:57,3362500
8470265,Anton,Babchuk,1984-05-06,D,R,2010-11,82,11,24,35,0.43,14,132,8.33,32,80427.0,16:20,0,0,0,0.0,19,156,19,42,-23,6,7,13,12618.0,2:33,1,1,2,2526.0,0:30,1400000
8470273,Ian,White,1984-06-04,D,R,2010-11,78,4,22,26,0.33,3,138,2.9,26,93564.0,19:59,0,0,0,0.0,59,144,30,26,4,1,5,6,10151.0,2:10,0,0,0,5156.0,1:6,2999995
8470274,Chris,Higgins,1983-06-02,LW,L,2010-11,62,13,15,28,0.45,5,160,8.12,16,60632.0,16:17,41,44,85,48.24,80,36,40,12,28,1,0,1,5420.0,1:27,0,1,1,6540.0,1:45,1600000
8470280,Ben,Eager,1984-01-22,LW,L,2010-11,68,7,10,17,0.25,4,84,8.33,120,43409.0,10:38,0,2,2,0.0,87,28,21,26,-5,0,0,0,468.0,0:6,0,0,0,224.0,0:3,965000
8470281,Duncan,Keith,1983-07-16,D,L,2010-11,82,7,38,45,0.55,-1,173,4.05,22,132273.0,26:53,0,0,0,0.0,45,149,56,83,-27,3,19,22,14691.0,2:59,1,0,1,12965.0,2:38,5538462
8470283,Tim,Brent,1984-03-10,C,R,2010-11,79,8,12,20,0.25,-4,60,13.33,33,55227.0,11:39,410,378,788,52.03,104,58,23,20,3,0,4,4,3589.0,0:45,1,1,2,9331.0,1:58,575000
8470289,Jim,Slater,1982-12-09,C,L,2010-11,36,5,7,12,0.33,4,53,9.43,19,22859.0,10:34,185,116,301,61.46,59,16,16,5,11,0,0,0,294.0,0:8,0,0,0,1947.0,0:54,1000000
8470294,DJ,King,1984-06-27,LW,L,2010-11,16,0,2,2,0.12,-3,6,0.0,30,5457.0,5:41,0,0,0,0.0,20,0,4,2,2,0,0,0,54.0,0:3,0,0,0,0.0,0:0,-111
8470299,Erik,Christensen,1983-12-17,C,L,2010-11,63,11,16,27,0.43,3,86,12.79,18,48230.0,12:45,316,323,639,49.45,34,11,28,17,11,4,3,7,8031.0,2:7,0,0,0,32.0,0:0,925000
8470302,Patrick,Dwyer,1983-06-22,RW,R,2010-11,80,8,10,18,0.22,-6,104,7.69,12,60374.0,12:34,80,158,238,33.61,166,63,36,7,29,0,1,1,734.0,0:9,1,0,1,9841.0,2:3,500000
8470309,Ryan,Whitney,1983-02-19,D,L,2010-11,35,2,25,27,0.77,13,43,4.65,33,53210.0,25:20,0,0,0,0.0,29,67,20,41,-21,0,7,7,9069.0,4:19,0,2,2,5676.0,2:42,4000000
8470310,Aaron,Rome,1983-09-27,D,L,2010-11,56,1,4,5,0.09,1,50,2.0,53,58502.0,17:24,0,0,0,0.0,78,59,13,21,-8,0,2,2,1373.0,0:24,0,0,0,5996.0,1:47,750000
8470317,Nate,Guenin,1982-12-10,D,R,2010-11,3,0,0,0,0.0,-3,2,0.0,2,2663.0,14:47,0,0,0,0.0,11,7,1,0,1,0,0,0,83.0,0:27,0,0,0,122.0,0:40,575000
8470318,Jonathan,Ericsson,1984-03-02,D,L,2010-11,74,3,12,15,0.2,8,89,3.37,87,83653.0,18:50,0,0,0,0.0,107,37,16,56,-40,1,0,1,534.0,0:7,0,0,0,6330.0,1:25,900000
8470321,Patrick,Rissmiller,1978-10-26,LW,L,2010-11,10,0,1,1,0.1,-1,14,0.0,0,6219.0,10:21,2,2,4,50.0,17,2,2,0,2,0,0,0,85.0,0:8,0,0,0,75.0,0:7,1000000
8470324,Josh,Gorges,1984-08-14,D,L,2010-11,36,1,6,7,0.19,-3,20,5.0,18,45734.0,21:10,0,0,0,0.0,55,79,8,24,-16,1,0,1,1468.0,0:40,0,0,0,8140.0,3:46,1100000
8470329,Chris,Campoli,1984-07-09,D,L,2010-11,77,4,17,21,0.27,0,84,4.76,36,88412.0,19:8,0,0,0,0.0,99,91,19,32,-13,1,1,2,5834.0,1:15,0,0,0,7594.0,1:38,1400000
8470358,Alexandre,Burrows,1981-04-11,RW,L,2010-11,72,26,22,48,0.67,26,152,17.11,77,73577.0,17:1,6,8,14,42.86,84,24,39,15,24,1,0,1,4391.0,1:0,1,1,2,9767.0,2:15,2000000
8470378,Andre,Benoit,1984-01-06,D,L,2010-11,8,0,1,1,0.12,-1,17,0.0,6,8081.0,16:50,0,0,0,0.0,5,12,3,3,0,0,1,1,853.0,1:46,0,0,0,80.0,0:10,550000
8470543,Chris,Kunitz,1979-09-26,LW,L,2010-11,66,23,25,48,0.73,18,133,17.29,47,72388.0,18:16,4,4,8,50.0,155,14,18,22,-4,7,4,11,16561.0,4:10,1,1,2,2077.0,0:31,3725000
8470578,Freddy,Meyer,1981-01-04,D,L,2010-11,15,1,1,2,0.13,-7,11,9.09,8,13737.0,15:15,0,0,0,0.0,29,33,2,1,1,0,0,0,103.0,0:6,0,0,0,883.0,0:58,-111
8470580,Jed,Ortmeyer,1978-09-03,RW,R,2010-11,4,0,0,0,0.0,-1,5,0.0,2,2254.0,9:23,0,0,0,0.0,4,0,1,1,0,0,0,0,23.0,0:5,0,0,0,12.0,0:3,-111
8470595,Eric,Staal,1984-10-29,C,L,2010-11,81,33,43,76,0.94,-10,296,11.15,72,106626.0,21:56,840,911,1751,47.97,81,31,64,44,20,12,17,29,21679.0,4:27,3,0,3,6817.0,1:24,8250000
8470596,Nathan,Horton,1985-05-29,RW,R,2010-11,80,26,27,53,0.66,29,188,13.83,85,78175.0,16:17,8,11,19,42.11,74,14,26,25,1,6,2,8,11542.0,2:24,0,0,0,157.0,0:1,4000000
8470597,Nikolay,Zherdev,1984-11-05,RW,R,2010-11,56,16,6,22,0.39,5,135,11.85,22,43201.0,12:51,2,5,7,28.57,39,6,19,25,-6,1,2,3,3533.0,1:3,0,0,0,49.0,0:0,2000000
8470598,Thomas,Vanek,1984-01-19,LW,R,2010-11,80,32,41,73,0.91,2,238,13.45,24,83297.0,17:21,8,18,26,30.77,30,12,43,45,-2,11,17,28,15662.0,3:15,0,0,0,305.0,0:3,7142857
8470599,Milan,Michalek,1984-12-07,LW,L,2010-11,66,18,15,33,0.5,-12,167,10.78,49,71520.0,18:3,4,9,13,30.77,49,41,40,22,18,1,3,4,9516.0,2:24,4,0,4,7386.0,1:51,4333333
8470600,Ryan,Suter,1985-01-21,D,L,2010-11,70,4,35,39,0.56,20,115,3.48,54,105846.0,25:12,0,1,1,0.0,64,84,33,37,-4,1,16,17,14419.0,3:25,0,1,1,8495.0,2:1,3500000
8470601,Braydon,Coburn,1985-02-27,D,L,2010-11,82,2,14,16,0.2,15,114,1.75,53,103660.0,21:4,0,0,0,0.0,177,133,32,51,-19,0,0,0,1930.0,0:23,0,1,1,12014.0,2:26,3200000
8470602,Dion,Phaneuf,1985-04-10,D,L,2010-11,66,8,22,30,0.45,-2,190,4.21,88,100201.0,25:18,0,0,0,0.0,186,121,31,53,-22,3,9,12,15544.0,3:55,0,1,1,7759.0,1:57,6500000
8470603,Andrei,Kostitsyn,1985-02-03,LW,L,2010-11,81,20,25,45,0.56,3,196,10.2,36,77218.0,15:53,0,2,2,0.0,140,26,23,38,-15,5,6,11,11056.0,2:16,0,0,0,51.0,0:0,3250000
8470604,Jeff,Carter,1985-01-01,C,R,2010-11,80,36,30,66,0.82,27,335,10.75,39,87584.0,18:14,331,274,605,54.71,65,41,40,29,11,8,9,17,14089.0,2:56,0,0,0,3158.0,0:39,5000000
8470605,Hugh,Jessiman,1984-03-28,RW,R,2010-11,2,0,0,0,0.0,-1,2,0.0,5,882.0,7:21,0,0,0,0.0,4,0,0,0,0,0,0,0,0.0,0:0,0,0,0,0.0,0:0,500000
8470606,Dustin,Brown,1984-11-04,RW,R,2010-11,82,28,29,57,0.7,17,228,12.28,67,95287.0,19:22,18,19,37,48.65,300,29,35,67,-32,7,8,15,14588.0,2:57,0,0,0,6725.0,1:22,3175000
8470607,Brent,Seabrook,1985-04-20,D,R,2010-11,82,9,39,48,0.59,0,135,6.67,47,119986.0,24:23,0,0,0,0.0,227,154,27,69,-42,5,15,20,13102.0,2:39,0,2,2,13457.0,2:44,3500000
8470609,Steve,Bernier,1985-03-31,RW,R,2010-11,68,5,10,15,0.22,-14,97,5.15,21,53167.0,13:1,4,13,17,23.53,112,35,22,14,8,3,0,3,5349.0,1:18,0,0,0,3753.0,0:55,2000000
8470610,Zach,Parise,1984-07-28,LW,L,2010-11,13,3,3,6,0.46,-1,49,6.12,6,15489.0,19:51,4,7,11,36.36,13,6,6,4,2,0,1,1,2713.0,3:28,0,0,0,700.0,0:53,3125000
8470611,Eric,Fehr,1985-09-07,C,R,2010-11,52,10,10,20,0.38,0,120,8.33,16,39279.0,12:35,0,1,1,0.0,34,20,23,7,16,3,4,7,6096.0,1:57,0,0,0,0.0,0:0,2200000
8470612,Ryan,Getzlaf,1985-05-10,C,R,2010-11,67,19,57,76,1.13,14,117,16.24,35,87849.0,21:51,542,641,1183,45.82,189,57,35,81,-46,7,20,27,14408.0,3:35,0,0,0,1880.0,0:28,5325000
8470613,Brent,Burns,1985-03-09,D,R,2010-11,80,17,29,46,0.57,-10,170,10.0,98,120227.0,25:2,1,1,2,50.0,133,106,47,80,-33,8,6,14,14730.0,3:4,0,1,1,13025.0,2:42,3550000
8470614,Mark,Stuart,1984-04-27,D,L,2010-11,54,2,4,6,0.11,0,41,4.88,47,50726.0,15:39,1,0,1,100.0,107,96,12,23,-11,0,0,0,386.0,0:7,0,0,0,6561.0,2:1,1675000
8470615,,,,,,2010-11,3,0,0,0,0.0,-2,2,0.0,0,1938.0,10:46,5,8,13,38.46,2,0,0,2,-2,0,0,0,317.0,1:45,0,0,0,35.0,0:11,-111
8470616,Ryan,Kesler,1984-08-31,C,R,2010-11,82,41,32,73,0.89,24,260,15.77,66,100833.0,20:29,859,637,1496,57.42,124,80,65,21,44,15,15,30,17849.0,3:37,3,1,4,12600.0,2:33,5000000
8470617,Mike,Richards,1985-02-11,C,L,2010-11,81,23,43,66,0.81,11,184,12.5,62,91764.0,18:52,606,610,1216,49.84,104,73,62,46,16,5,16,21,14316.0,2:56,3,3,6,10411.0,2:8,5750000
8470618,Anthony,Stewart,1985-01-05,RW,R,2010-11,80,14,25,39,0.49,-10,141,9.93,55,71870.0,14:58,7,11,18,38.89,98,35,34,28,6,5,5,10,6233.0,1:17,0,0,0,2220.0,0:27,632500
8470619,Brian,Boyle,1984-12-18,C,L,2010-11,82,21,14,35,0.43,2,218,9.63,74,77436.0,15:44,534,567,1101,48.5,240,86,33,20,13,4,0,4,3031.0,0:36,1,3,4,9554.0,1:56,525000
8470620,Jeff,Tambellini,1984-04-13,LW,L,2010-11,62,9,8,17,0.27,10,114,7.89,18,43834.0,11:47,19,16,35,54.29,113,21,11,10,1,1,3,4,4434.0,1:11,0,0,0,316.0,0:5,500000
8470621,Corey,Perry,1985-05-16,RW,R,2010-11,82,50,48,98,1.2,9,290,17.24,104,109780.0,22:18,9,13,22,40.91,64,41,55,54,1,14,17,31,17260.0,3:30,4,1,5,8095.0,1:38,5325000
8470622,Patrick,Eaves,1984-05-01,RW,R,2010-11,63,13,7,20,0.32,-2,108,12.04,14,47995.0,12:41,3,7,10,30.0,106,27,20,14,6,2,0,2,878.0,0:13,1,0,1,10176.0,2:41,1400000
8470623,Shawn,Belle,1985-01-03,D,L,2010-11,9,0,0,0,0.0,-1,8,0.0,2,9259.0,17:8,0,0,0,0.0,9,4,2,8,-6,0,0,0,95.0,0:10,0,0,0,804.0,1:29,600000
8470626,Loui,Eriksson,1985-07-17,LW,L,2010-11,79,27,46,73,0.92,10,179,15.08,8,97497.0,20:34,1,3,4,25.0,26,46,72,34,38,10,15,25,16059.0,3:23,1,2,3,6443.0,1:21,4250000
8470630,Kevin,Klein,1984-12-13,D,R,2010-11,81,2,16,18,0.22,9,99,2.02,24,101048.0,20:47,0,0,0,0.0,128,173,31,61,-30,0,0,0,1129.0,0:13,0,1,1,15396.0,3:10,1350000
8470634,Matt,Smaby,1984-10-14,D,L,2010-11,32,0,0,0,0.0,2,9,0.0,17,13421.0,6:59,0,0,0,0.0,45,18,0,6,-6,0,0,0,58.0,0:1,0,0,0,731.0,0:22,525000
8470638,Patrice,Bergeron,1985-07-24,C,R,2010-11,80,22,35,57,0.71,20,211,10.43,26,85865.0,17:53,815,624,1439,56.64,45,56,49,24,25,3,8,11,13065.0,2:43,2,1,3,9915.0,2:3,4750000
8470640,Matt,Carle,1984-09-25,D,L,2010-11,82,1,39,40,0.49,30,117,0.85,23,108198.0,21:59,0,0,0,0.0,51,157,33,59,-26,0,2,2,11321.0,2:18,0,0,0,6019.0,1:13,3437500
8470642,Shea,Weber,1985-08-14,D,R,2010-11,82,16,32,48,0.59,7,254,6.3,56,124569.0,25:19,0,0,0,0.0,211,113,62,51,11,6,11,17,17957.0,3:38,1,0,1,10375.0,2:6,4500000
8470647,B.J.,Crombeen,1985-07-10,RW,R,2010-11,80,7,7,14,0.18,-18,113,6.19,154,61428.0,12:47,19,45,64,29.69,93,15,16,12,4,0,0,0,260.0,0:3,1,0,1,8100.0,1:41,872500
8470648,Stefan,Meyer,1985-07-20,LW,L,2010-11,16,0,2,2,0.12,0,12,0.0,17,7441.0,7:45,7,10,17,41.18,24,10,2,0,2,0,0,0,36.0,0:2,0,0,0,503.0,0:31,512500
8470649,Patrick,O'Sullivan,1985-02-01,C,L,2010-11,31,2,6,8,0.26,-2,50,4.0,4,22668.0,12:11,20,31,51,39.22,15,4,15,7,8,0,3,3,3202.0,1:43,0,0,0,0.0,0:0,2925000
8470651,Jeremy,Colliton,1985-01-13,C,R,2010-11,15,2,1,3,0.2,-7,7,28.57,10,10699.0,11:53,52,32,84,61.9,23,9,11,4,7,2,0,2,417.0,0:27,0,0,0,1120.0,1:14,500000
8470654,Maxim,Lapierre,1985-03-29,C,R,2010-11,78,6,6,12,0.15,-14,129,4.65,80,54413.0,11:37,173,167,340,50.88,194,23,20,8,12,0,0,0,332.0,0:4,0,0,0,3728.0,0:47,900000
8470655,David,Backes,1984-05-01,RW,R,2010-11,82,31,31,62,0.76,32,211,14.69,93,96953.0,19:42,506,632,1138,44.46,213,40,47,23,24,5,10,15,13260.0,2:41,0,1,1,8637.0,1:45,2500000
8470656,David,Liffiton,1984-10-18,D,L,2010-11,4,1,0,1,0.25,3,2,50.0,17,1790.0,7:27,0,0,0,0.0,3,3,1,0,1,0,0,0,0.0,0:0,0,0,0,0.0,0:0,500000
8470661,Jean-Francois,Jacques,1985-04-29,LW,L,2010-11,51,4,1,5,0.1,-6,28,14.29,63,21641.0,7:4,5,11,16,31.25,111,17,6,11,-5,0,0,0,185.0,0:3,0,0,0,136.0,0:2,615000
8470662,Colin,Fraser,1985-01-28,C,L,2010-11,67,3,2,5,0.07,-2,57,5.26,60,41309.0,10:16,246,306,552,44.57,79,54,27,20,7,0,0,0,318.0,0:4,1,0,1,10655.0,2:39,825000
8470666,Daniel,Carcillo,1985-01-28,LW,L,2010-11,57,4,2,6,0.11,-14,56,7.14,127,26553.0,7:45,1,1,2,50.0,80,14,7,6,1,0,0,0,172.0,0:3,0,0,0,49.0,0:0,1075000
8470667,Clarke,MacArthur,1985-04-06,LW,L,2010-11,82,21,41,62,0.76,-3,154,13.64,37,84204.0,17:6,9,7,16,56.25,115,20,24,49,-25,6,13,19,14357.0,2:55,0,0,0,73.0,0:0,1100000
8470672,Ryan,O'Byrne,1984-07-19,D,R,2010-11,67,0,10,10,0.15,-7,45,0.0,75,81031.0,20:9,0,0,0,0.0,179,131,21,25,-4,0,0,0,434.0,0:6,0,0,0,10676.0,2:39,941667
8470678,Alexandre,Picard,1985-07-05,D,L,2010-11,43,3,5,8,0.19,0,49,6.12,17,42381.0,16:25,0,0,0,0.0,55,59,9,28,-19,2,0,2,2652.0,1:1,0,0,0,1491.0,0:34,600000
8470680,Ryan,Potulny,1984-09-05,C,L,2010-11,10,0,0,0,0.0,-1,7,0.0,0,4739.0,7:53,10,16,26,38.46,5,1,3,0,3,0,0,0,246.0,0:24,0,0,0,32.0,0:3,-111
8470685,Alexander,Sulzer,1984-05-30,D,L,2010-11,40,1,4,5,0.12,-8,37,2.7,14,42116.0,17:32,1,0,1,100.0,38,52,8,10,-2,0,2,2,2656.0,1:6,0,0,0,2993.0,1:14,-111
8470687,Zack,Stortini,1985-09-11,RW,R,2010-11,32,0,4,4,0.12,-2,16,0.0,76,13619.0,7:5,14,19,33,42.42,46,8,4,5,-1,0,0,0,119.0,0:3,0,0,0,0.0,0:0,700000
8470697,Philippe,Dupuis,1985-04-24,C,R,2010-11,74,6,11,17,0.23,-4,101,5.94,40,40462.0,9:6,153,178,331,46.22,128,28,44,10,34,0,0,0,267.0,0:3,1,1,2,7050.0,1:35,-111
8470699,Jan,Hejda,1978-06-18,D,L,2010-11,77,5,15,20,0.26,-6,79,6.33,28,97584.0,21:7,1,0,1,100.0,152,158,21,30,-9,0,0,0,691.0,0:8,0,1,1,13143.0,2:50,2000000
8470705,Corey,Locke,1984-05-08,C,L,2010-11,5,0,1,1,0.2,-1,6,0.0,0,2752.0,9:10,7,25,32,21.88,1,0,0,1,-1,0,0,0,288.0,0:57,0,0,0,0.0,0:0,-111
8470708,Guillaume,Desbiens,1985-04-20,RW,R,2010-11,12,0,0,0,0.0,-3,4,0.0,10,5296.0,7:21,1,0,1,100.0,22,4,1,0,1,0,0,0,81.0,0:6,0,0,0,1.0,0:0,-111
8470713,Paul,Bissonnette,1985-03-11,LW,L,2010-11,48,1,0,1,0.02,6,18,5.56,71,15134.0,5:15,2,1,3,66.67,122,5,2,4,-2,0,0,0,55.0,0:1,0,0,0,10.0,0:0,612500
8470714,Corey,Potter,1984-01-05,D,R,2010-11,1,0,0,0,0.0,0,1,0.0,0,1003.0,16:43,0,0,0,0.0,1,2,0,0,0,0,0,0,0.0,0:0,0,0,0,38.0,0:38,500000
8470719,Alexandre,Bolduc,1985-06-26,C,L,2010-11,24,2,2,4,0.17,1,21,9.52,21,10705.0,7:26,44,53,97,45.36,29,14,4,2,2,0,0,0,211.0,0:8,0,0,0,671.0,0:27,500000
8470724,Kyle,Quincey,1985-08-12,D,L,2010-11,21,0,1,1,0.05,-5,39,0.0,18,24673.0,19:34,0,0,0,0.0,28,26,6,7,-1,0,0,0,2769.0,2:11,0,0,0,2457.0,1:57,3125000
8470729,Tyson,Strachan,1984-10-30,D,R,2010-11,29,0,1,1,0.03,-10,28,0.0,39,21124.0,12:8,0,0,0,0.0,23,30,3,8,-5,0,0,0,306.0,0:10,0,0,0,1398.0,0:48,600000
8470737,Brett,Sterling,1984-04-24,LW,L,2010-11,7,3,2,5,0.71,1,14,21.43,16,6350.0,15:7,2,1,3,66.67,7,0,2,2,0,1,1,2,1710.0,4:4,0,0,0,14.0,0:2,-111
8470740,Lee,Stempniak,1983-02-04,RW,R,2010-11,82,19,19,38,0.46,4,199,9.55,19,75047.0,15:15,18,27,45,40.0,124,21,46,26,20,2,4,6,8957.0,1:49,0,0,0,156.0,0:1,1900000
8470741,Nigel,Dawes,1985-02-09,LW,L,2010-11,13,0,1,1,0.08,-6,12,0.0,0,7657.0,9:49,0,0,0,0.0,19,3,6,3,3,0,0,0,215.0,0:16,0,0,0,17.0,0:1,650000
8470750,John,Mitchell,1985-01-22,C,L,2010-11,23,2,1,3,0.13,-7,28,7.14,12,17268.0,12:30,83,66,149,55.7,31,17,8,5,3,1,0,1,511.0,0:22,0,0,0,1287.0,0:55,725000
8470755,Brad,Richardson,1985-02-04,C,L,2010-11,68,7,12,19,0.28,-13,103,6.8,47,47978.0,11:45,92,89,181,50.83,84,11,28,18,10,0,0,0,237.0,0:3,1,0,1,3908.0,0:57,900000
8470760,Marc,Methot,1985-06-21,D,L,2010-11,74,0,15,15,0.2,2,58,0.0,58,88308.0,19:53,0,0,0,0.0,176,98,21,27,-6,0,0,0,1496.0,0:20,0,1,1,13081.0,2:56,1012500
8470774,Bruno,Gervais,1984-10-03,D,R,2010-11,53,0,6,6,0.11,-14,43,0.0,30,49848.0,15:40,0,0,0,0.0,40,79,28,19,9,0,0,0,812.0,0:15,0,0,0,4554.0,1:25,740833
8470775,Nate,Thompson,1984-10-05,C,L,2010-11,79,10,15,25,0.32,-6,123,8.13,29,71528.0,15:5,360,304,664,54.22,115,81,35,14,21,0,1,1,1002.0,0:12,1,0,1,12877.0,2:43,625000
8470777,Francis,Wathier,1984-12-07,LW,L,2010-11,3,0,0,0,0.0,-2,0,,0,706.0,3:55,0,0,0,0.0,3,0,0,1,-1,0,0,0,14.0,0:4,0,0,0,0.0,0:0,-111
8470778,Drew,Miller,1984-02-17,LW,L,2010-11,67,10,8,18,0.27,-2,85,11.76,13,47220.0,11:44,4,13,17,23.53,84,58,12,7,5,0,0,0,311.0,0:4,1,0,1,8952.0,2:13,650000
8470787,Drew,Bagnall,1983-10-26,D,L,2010-11,2,0,0,0,0.0,-2,1,0.0,4,1561.0,13:0,0,0,0,0.0,0,1,0,0,0,0,0,0,0.0,0:0,0,0,0,96.0,0:48,600000
8470794,Joe,Pavelski,1984-07-11,C,R,2010-11,74,20,46,66,0.89,10,282,7.09,24,87262.0,19:39,554,466,1020,54.31,61,67,51,49,2,11,17,28,14914.0,3:21,1,2,3,8665.0,1:57,4000000
8470798,Dylan,Reese,1984-08-29,D,R,2010-11,27,0,6,6,0.22,-12,23,0.0,15,24002.0,14:48,0,0,0,0.0,17,22,11,15,-4,0,0,0,503.0,0:18,0,0,0,2041.0,1:15,577500
8470803,Kyle,Brodziak,1984-05-25,C,R,2010-11,80,16,21,37,0.46,-4,126,12.7,56,75725.0,15:46,532,556,1088,48.9,52,55,48,30,18,2,2,4,6085.0,1:16,1,3,4,8184.0,1:42,1150000
8470804,Mathieu,Roy,1983-08-10,D,R,2010-11,4,0,0,0,0.0,-2,1,0.0,2,1132.0,4:43,0,0,0,0.0,4,1,0,3,-3,0,0,0,0.0,0:0,0,0,0,57.0,0:14,-111
8470809,Jeremy,Williams,1984-01-26,RW,R,2010-11,1,0,0,0,0.0,0,0,,0,223.0,3:43,0,0,0,0.0,0,1,0,0,0,0,0,0,0.0,0:0,0,0,0,0.0,0:0,-111
8470816,Jay,Rosehill,1985-07-16,LW,L,2010-11,26,1,2,3,0.12,-6,12,8.33,71,8123.0,5:12,0,0,0,0.0,36,4,3,4,-1,0,0,0,26.0,0:1,0,0,0,0.0,0:0,512500
8470828,Toby,Enstrom,1984-11-05,D,L,2010-11,72,10,41,51,0.71,-10,113,8.85,54,102322.0,23:41,0,0,0,0.0,30,137,26,29,-3,6,22,28,19649.0,4:32,0,1,1,3372.0,0:46,3750000
8470834,Dustin,Byfuglien,1985-03-27,D,R,2010-11,81,20,33,53,0.65,-2,347,5.76,93,113260.0,23:18,0,0,0,0.0,140,72,85,59,26,8,16,24,19611.0,4:2,0,0,0,469.0,0:5,3000000
8470839,Shane,O'Brien,1983-08-09,D,L,2010-11,80,2,7,9,0.11,1,50,4.0,83,82159.0,17:6,0,0,0,0.0,164,80,30,50,-20,0,0,0,367.0,0:4,0,0,0,13611.0,2:50,1600000
8470852,Matt,Moulson,1983-11-01,LW,L,2010-11,82,31,22,53,0.65,-10,237,13.08,24,92838.0,18:52,5,4,9,55.56,84,48,46,22,24,9,6,15,16562.0,3:21,0,0,0,2874.0,0:35,2450000
8470854,Tanner,Glass,1983-11-29,LW,L,2010-11,73,3,7,10,0.14,-5,45,6.67,72,39092.0,8:55,25,37,62,40.32,130,29,9,10,-1,0,0,0,378.0,0:5,0,0,0,4572.0,1:2,625000
8470867,Troy,Bodie,1985-01-25,RW,R,2010-11,59,1,3,4,0.07,-7,44,2.27,61,24186.0,6:49,0,1,1,0.0,86,13,12,5,7,0,0,0,53.0,0:0,0,0,0,1472.0,0:24,500000
8470871,Chris,Porter,1984-05-29,LW,L,2010-11,45,3,4,7,0.16,-4,55,5.45,16,28039.0,10:23,12,10,22,54.55,91,5,10,5,5,0,0,0,82.0,0:1,0,0,0,1122.0,0:24,562500
8470877,David,Jones,1984-08-10,RW,R,2010-11,77,27,18,45,0.58,-2,153,17.65,28,81664.0,17:40,10,11,21,47.62,93,38,24,28,-4,6,3,9,11063.0,2:23,0,1,1,6726.0,1:27,837500
8470886,Clayton,Stoner,1985-02-19,D,L,2010-11,57,2,7,9,0.16,5,40,5.0,96,57672.0,16:51,0,0,0,0.0,110,81,23,24,-1,0,0,0,157.0,0:2,0,0,0,7197.0,2:6,550000
8470896,Steve,MacIntyre,1980-08-08,LW,L,2010-11,34,0,1,1,0.03,-1,6,0.0,93,7212.0,3:32,0,0,0,0.0,23,4,1,7,-6,0,0,0,65.0,0:1,0,0,0,3.0,0:0,-111
8470905,Randy,Jones,1981-07-23,D,L,2010-11,61,1,12,13,0.21,-4,52,1.92,15,62432.0,17:3,0,0,0,0.0,42,104,20,35,-15,0,0,0,710.0,0:11,0,0,0,10642.0,2:54,-111
8470920,David,Clarkson,1984-03-31,RW,R,2010-11,82,12,6,18,0.22,-20,192,6.25,116,67018.0,13:37,19,26,45,42.22,170,19,24,23,1,1,1,2,8188.0,1:39,0,0,0,54.0,0:0,2666667
8470966,Mark,Giordano,1983-10-03,D,L,2010-11,82,8,35,43,0.52,-8,165,4.85,67,113853.0,23:8,0,0,0,0.0,140,193,25,42,-17,5,20,25,17401.0,3:32,0,0,0,10371.0,2:6,891667
8470986,Darryl,Boyce,1984-07-07,C,L,2010-11,46,5,8,13,0.28,8,27,18.52,33,31415.0,11:22,212,245,457,46.39,68,19,13,19,-6,0,0,0,929.0,0:20,0,0,0,991.0,0:21,-111
8470988,Bryan,Rodney,1984-04-22,D,R,2010-11,3,0,0,0,0.0,0,3,0.0,2,1572.0,8:44,0,0,0,0.0,0,4,0,1,-1,0,0,0,141.0,0:47,0,0,0,0.0,0:0,-111
8470996,Danny,Syvret,1985-06-13,D,L,2010-11,10,1,1,2,0.2,-3,11,9.09,6,9031.0,15:3,0,0,0,0.0,4,7,0,0,0,0,1,1,619.0,1:1,0,0,0,24.0,0:2,-111
8471011,Garrett,Stafford,1980-01-28,D,R,2010-11,2,0,0,0,0.0,0,2,0.0,0,1488.0,12:24,0,0,0,0.0,4,0,0,2,-2,0,0,0,0.0,0:0,0,0,0,0.0,0:0,-111
8471185,Curtis,Glencross,1982-12-28,LW,L,2010-11,79,24,19,43,0.54,6,149,16.11,59,77002.0,16:14,57,84,141,40.43,105,54,47,55,-8,3,2,5,5568.0,1:10,2,1,3,11349.0,2:23,1200000
8471187,Brett,Lebda,1982-01-15,D,L,2010-11,41,1,3,4,0.1,-14,34,2.94,14,32812.0,13:20,0,2,2,0.0,33,31,3,17,-14,0,1,1,4977.0,2:1,0,0,0,281.0,0:6,1450000
8471208,Dustin,Penner,1982-09-28,RW,L,2010-11,81,23,22,45,0.56,-12,173,13.29,47,88079.0,18:7,131,175,306,42.81,90,30,45,69,-24,6,2,8,14997.0,3:5,1,0,1,5557.0,1:8,4250000
8471214,Alex,Ovechkin,1985-09-17,LW,R,2010-11,79,32,53,85,1.08,24,367,8.72,41,101275.0,21:21,6,12,18,33.33,241,23,48,59,-11,7,17,24,21240.0,4:28,0,0,0,217.0,0:2,9538462
8471215,Evgeni,Malkin,1986-07-31,C,L,2010-11,43,15,22,37,0.86,-4,182,8.24,18,51148.0,19:49,77,123,200,38.5,32,11,29,40,-11,5,9,14,13766.0,5:20,0,0,0,161.0,0:3,8700000
8471216,Cam,Barker,1986-04-04,D,L,2010-11,52,1,4,5,0.1,-10,44,2.27,34,51175.0,16:24,0,0,0,0.0,68,61,6,5,1,0,2,2,4297.0,1:22,0,0,0,2632.0,0:50,3083333
8471217,Andrew,Ladd,1985-12-12,LW,L,2010-11,81,29,30,59,0.73,-10,195,14.87,39,97550.0,20:4,15,29,44,34.09,68,45,61,44,17,9,9,18,14802.0,3:2,2,1,3,9158.0,1:53,2350000
8471218,Blake,Wheeler,1986-08-31,RW,R,2010-11,81,18,26,44,0.54,10,179,10.06,46,78962.0,16:14,52,96,148,35.14,74,47,40,29,11,0,5,5,6464.0,1:19,0,0,0,6543.0,1:20,2200000
8471220,Rostislav,Olesz,1985-10-10,LW,L,2010-11,44,6,11,17,0.39,-1,71,8.45,8,36640.0,13:52,2,8,10,20.0,68,19,19,9,10,1,0,1,2960.0,1:7,0,0,0,2476.0,0:56,3125000
8471222,Ladislav,Smid,1986-02-01,D,L,2010-11,78,0,10,10,0.13,-10,48,0.0,85,94892.0,20:16,0,0,0,0.0,145,118,19,59,-40,0,1,1,3556.0,0:45,0,0,0,12505.0,2:40,1300000
8471226,Drew,Stafford,1985-10-30,RW,R,2010-11,62,31,21,52,0.84,13,179,17.32,34,61521.0,16:32,17,39,56,30.36,53,5,19,17,2,11,8,19,10996.0,2:57,0,0,0,1283.0,0:20,1900000
8471231,Kyle,Chipchura,1986-02-19,C,L,2010-11,40,0,2,2,0.05,1,23,0.0,32,19185.0,7:59,132,151,283,46.64,30,10,8,5,3,0,0,0,41.0,0:1,0,0,0,2048.0,0:51,650000
8471232,Lauri,Korpikoski,1986-07-28,LW,L,2010-11,79,19,21,40,0.51,17,103,18.45,20,73604.0,15:31,107,137,244,43.85,87,50,25,26,-1,0,1,1,3248.0,0:41,2,2,4,14361.0,3:1,700000
8471233,Travis,Zajac,1985-05-13,C,R,2010-11,82,13,31,44,0.54,-6,173,7.51,24,97332.0,19:46,707,571,1278,55.32,55,31,60,34,26,2,8,10,12660.0,2:34,1,1,2,10292.0,2:5,3887500
8471234,Wojtek,Wolski,1986-02-24,LW,L,2010-11,73,12,23,35,0.48,6,135,8.89,18,63863.0,14:34,15,16,31,48.39,47,12,21,26,-5,1,3,4,9166.0,2:5,0,0,0,24.0,0:0,3800000
8471236,Andrej,Meszaros,1985-10-13,D,L,2010-11,81,8,24,32,0.4,30,144,5.56,42,102647.0,21:7,0,0,0,0.0,189,139,34,40,-6,3,3,6,11840.0,2:26,0,0,0,9928.0,2:2,4000000
8471238,Rob,Schremp,1986-07-01,C,L,2010-11,63,13,13,26,0.41,-20,83,15.66,16,53075.0,14:2,224,262,486,46.09,34,21,42,41,1,4,3,7,6717.0,1:46,0,0,0,40.0,0:0,750750
8471240,Jeff,Schultz,1986-02-25,D,L,2010-11,72,1,9,10,0.14,6,34,2.94,12,85439.0,19:46,0,0,0,0.0,53,138,17,43,-26,0,0,0,285.0,0:3,0,2,2,10574.0,2:26,2750000
8471241,Mark,Fistric,1986-06-01,D,L,2010-11,57,2,3,5,0.09,-10,26,7.69,44,49191.0,14:23,0,0,0,0.0,173,78,11,14,-3,0,0,0,35.0,0:0,0,1,1,4592.0,1:20,1000000
8471242,Mike,Green,1985-10-12,D,R,2010-11,49,8,16,24,0.49,6,115,6.96,48,74067.0,25:11,0,0,0,0.0,100,109,25,54,-29,5,5,10,13076.0,4:26,0,1,1,6937.0,2:21,5250000
8471245,Dave,Bolland,1986-06-05,C,R,2010-11,61,15,22,37,0.61,11,102,14.71,34,64572.0,17:38,455,553,1008,45.14,41,35,55,22,33,4,8,12,7418.0,2:1,0,0,0,7947.0,2:10,3375000
8471254,Bryan,Bickell,1986-03-09,LW,L,2010-11,78,17,20,37,0.47,6,130,13.08,40,64762.0,13:50,3,9,12,25.0,178,13,34,7,27,2,1,3,4308.0,0:55,0,0,0,10.0,0:0,541667
8471260,Blake,Comeau,1986-02-18,LW,R,2010-11,77,24,22,46,0.6,-17,182,13.19,43,86354.0,18:41,35,77,112,31.25,120,32,55,55,0,5,7,12,11585.0,2:30,1,0,1,10459.0,2:15,650000
8471265,Raymond,Sawada,1985-02-19,RW,R,2010-11,1,0,0,0,0.0,-1,1,0.0,0,350.0,5:50,0,0,0,0.0,2,0,0,1,-1,0,0,0,0.0,0:0,0,0,0,0.0,0:0,575000
8471266,David,Booth,1984-11-24,LW,L,2010-11,82,23,17,40,0.49,-31,280,8.21,26,92985.0,18:53,24,24,48,50.0,129,25,28,24,4,8,2,10,14119.0,2:52,0,0,0,720.0,0:8,4250000
8471268,Victor,Oreskovich,1986-08-15,RW,R,2010-11,16,0,3,3,0.19,1,19,0.0,8,7586.0,7:54,1,1,2,50.0,28,7,3,3,0,0,0,0,51.0,0:3,0,0,0,0.0,0:0,575000
8471269,Nicklas,Grossmann,1985-01-22,D,L,2010-11,59,1,9,10,0.17,7,38,2.63,35,64420.0,18:11,0,0,0,0.0,161,78,8,26,-18,0,0,0,474.0,0:8,0,0,0,8243.0,2:19,1625000
8471273,Brandon,Dubinsky,1986-04-29,C,L,2010-11,77,24,30,54,0.7,-3,202,11.88,100,93448.0,20:13,459,416,875,52.46,141,31,48,18,30,4,7,11,14244.0,3:4,2,2,4,9695.0,2:5,1850000
8471274,Alex,Goligoski,1985-07-30,D,L,2010-11,83,14,32,46,0.55,20,162,8.64,40,110733.0,22:14,0,0,0,0.0,75,106,14,56,-42,7,17,24,19963.0,4:0,0,0,0,6662.0,1:20,1833333
8471276,David,Krejci,1986-04-28,C,R,2010-11,75,13,49,62,0.83,23,157,8.28,28,84854.0,18:51,560,589,1149,48.74,56,40,33,28,5,1,11,12,12138.0,2:41,0,0,0,5522.0,1:13,3750000
8471279,Sami,Lepisto,1984-10-17,D,L,2010-11,70,4,12,16,0.23,10,56,7.14,55,73733.0,17:33,1,0,1,100.0,72,90,20,24,-4,0,0,0,2227.0,0:31,0,0,0,6842.0,1:37,800000
8471280,Nick,Johnson,1985-12-24,RW,R,2010-11,4,1,2,3,0.75,1,10,10.0,5,4017.0,16:44,0,0,0,0.0,4,2,1,1,0,0,0,0,1075.0,4:28,0,0,0,74.0,0:18,-111
8471283,Brandon,Prust,1984-03-16,LW,L,2010-11,82,13,16,29,0.35,2,87,14.94,160,67965.0,13:48,4,5,9,44.44,161,36,26,29,-3,0,1,1,1440.0,0:17,5,2,7,8324.0,1:41,800000
8471284,Andrej,Sekera,1986-06-08,D,L,2010-11,76,3,26,29,0.38,11,88,3.41,34,96180.0,21:5,0,0,0,0.0,61,85,38,51,-13,0,6,6,9503.0,2:5,0,0,0,8315.0,1:49,1000000
8471299,Peter,Regin,1986-04-16,C,L,2010-11,55,3,14,17,0.31,-4,87,3.45,12,44170.0,13:23,132,184,316,41.77,30,20,40,15,25,0,2,2,3370.0,1:1,0,0,0,193.0,0:3,1000000
8471303,Alexander,Edler,1986-04-21,D,L,2010-11,51,8,25,33,0.65,13,121,6.61,24,74331.0,24:17,0,2,2,0.0,83,86,25,24,1,5,12,17,11576.0,3:46,0,0,0,6801.0,2:13,3250000
8471309,Johan,Franzen,1979-12-23,RW,L,2010-11,76,28,27,55,0.72,5,248,11.29,58,79498.0,17:26,74,73,147,50.34,143,29,36,35,1,10,7,17,12866.0,2:49,0,0,0,245.0,0:3,3954545
8471310,Dustin,Boyd,1986-07-16,C,L,2010-11,10,1,0,1,0.1,-6,8,12.5,2,5903.0,9:50,23,32,55,41.82,12,6,0,2,-2,0,0,0,0.0,0:0,0,0,0,657.0,1:5,650000
8471311,Tyler,Kennedy,1986-07-15,C,R,2010-11,80,21,24,45,0.56,1,234,8.97,37,69737.0,14:31,27,33,60,45.0,95,23,25,20,5,7,7,14,9015.0,1:52,0,0,0,180.0,0:2,725000
8471314,Mike,Lundin,1984-09-24,D,L,2010-11,69,1,11,12,0.17,-3,55,1.82,12,84472.0,20:24,0,0,0,0.0,25,108,17,18,-1,0,0,0,2000.0,0:28,0,0,0,10711.0,2:35,750000
8471321,Brett,Carson,1985-11-29,D,R,2010-11,19,0,0,0,0.0,9,12,0.0,4,13045.0,11:26,0,0,0,0.0,19,11,1,2,-1,0,0,0,298.0,0:15,0,0,0,692.0,0:36,500000
8471323,Ryan,Jones,1984-06-14,LW,L,2010-11,81,18,7,25,0.31,-5,126,14.29,34,67248.0,13:50,10,19,29,34.48,152,57,38,33,5,2,2,4,4072.0,0:50,1,0,1,10303.0,2:7,975000
8471324,Liam,Reddox,1986-01-27,LW,L,2010-11,44,1,9,10,0.23,-8,85,1.18,20,39590.0,14:59,41,83,124,33.06,76,24,23,12,11,0,0,0,958.0,0:21,0,1,1,7838.0,2:58,-111
8471331,Kevin,Porter,1986-03-12,C,L,2010-11,74,14,11,25,0.34,-11,102,13.73,27,61351.0,13:49,19,39,58,32.76,126,29,22,27,-5,1,1,2,7237.0,1:37,0,0,0,1314.0,0:17,660000
8471338,Torrey,Mitchell,1985-01-30,C,R,2010-11,66,9,14,23,0.35,10,116,7.76,46,52852.0,13:20,99,104,203,48.77,57,27,32,25,7,0,0,0,574.0,0:8,0,0,0,4249.0,1:4,1366667
8471339,Ryan,Callahan,1985-03-21,RW,R,2010-11,60,23,25,48,0.8,-7,179,12.85,46,71641.0,19:54,2,15,17,11.76,224,77,42,12,30,10,5,15,12202.0,3:23,0,2,2,8026.0,2:13,2300000
8471346,Kris,Versteeg,1986-05-13,RW,R,2010-11,80,21,25,46,0.57,-9,180,11.67,53,85104.0,17:43,63,67,130,48.46,45,56,53,35,18,6,8,14,13785.0,2:52,1,0,1,3435.0,0:42,3083333
8471348,Nikita,Nikitin,1986-06-16,D,L,2010-11,41,1,8,9,0.22,1,46,2.17,10,40325.0,16:23,0,0,0,0.0,40,52,4,12,-8,0,4,4,3160.0,1:17,0,0,0,3937.0,1:36,800000
8471352,Jake,Dowell,1985-03-04,C,L,2010-11,79,6,15,21,0.27,5,74,8.11,63,55990.0,11:48,319,333,652,48.93,107,43,32,18,14,0,0,0,546.0,0:6,0,3,3,6562.0,1:23,-111
8471362,Mikhail,Grabovski,1984-01-31,C,L,2010-11,81,29,29,58,0.72,14,239,12.13,60,94098.0,19:21,642,684,1326,48.42,44,25,49,45,4,10,5,15,15277.0,3:8,0,0,0,4868.0,1:0,2900000
8471368,Roman,Wick,1985-12-30,RW,L,2010-11,7,0,0,0,0.0,-4,4,0.0,0,3623.0,8:37,1,2,3,33.33,2,3,2,3,-1,0,0,0,0.0,0:0,0,0,0,7.0,0:1,-111
8471371,Mike,Brown,1985-06-24,RW,R,2010-11,50,3,5,8,0.16,1,59,5.08,69,30282.0,10:5,4,11,15,26.67,105,27,11,15,-4,1,0,1,320.0,0:6,0,1,1,4753.0,1:35,537500
8471385,Adam,Pardy,1984-03-29,D,L,2010-11,30,1,6,7,0.23,3,36,2.78,24,26437.0,14:41,0,0,0,0.0,42,44,8,16,-8,0,1,1,413.0,0:13,0,0,0,1105.0,0:36,700000
8471386,Scott,Parse,1984-09-05,LW,R,2010-11,5,1,3,4,0.8,5,6,16.67,0,4137.0,13:47,0,0,0,0.0,2,4,2,5,-3,0,0,0,544.0,1:48,0,0,0,0.0,0:0,-111
8471388,Patrick,Kaleta,1986-06-08,RW,R,2010-11,51,4,5,9,0.18,-4,65,6.15,78,31171.0,10:11,5,7,12,41.67,126,33,11,9,2,0,0,0,351.0,0:6,1,0,1,1943.0,0:38,907500
8471390,Mike,Santorelli,1985-12-14,C,R,2010-11,82,20,21,41,0.5,-17,193,10.36,20,82092.0,16:41,518,514,1032,50.19,60,22,32,16,16,5,7,12,13273.0,2:41,1,0,1,6787.0,1:22,600000
8471392,Roman,Polak,1986-04-28,D,R,2010-11,55,3,9,12,0.22,-4,54,5.56,33,65857.0,19:57,0,1,1,0.0,110,78,11,12,-1,0,0,0,308.0,0:5,0,0,0,7312.0,2:12,1100000
8471399,Robbie,Earl,1985-06-02,LW,L,2010-11,6,0,0,0,0.0,-3,6,0.0,0,3155.0,8:45,0,2,2,0.0,8,0,0,3,-3,0,0,0,0.0,0:0,0,0,0,0.0,0:0,-111
8471409,Andrew,Gordon,1985-12-13,RW,R,2010-11,9,1,1,2,0.22,-2,5,20.0,0,4682.0,8:40,0,0,0,0.0,5,4,0,2,-2,0,0,0,395.0,0:43,0,0,0,0.0,0:0,500000
8471411,Chad,Kolarik,1986-01-26,C,R,2010-11,4,0,1,1,0.25,-1,4,0.0,2,2191.0,9:7,0,0,0,0.0,3,2,1,0,1,0,0,0,178.0,0:44,0,0,0,2.0,0:0,-111
8471413,Mike,Vernace,1986-05-26,D,L,2010-11,10,0,1,1,0.1,-2,6,0.0,2,5220.0,8:42,0,0,0,0.0,8,3,4,1,3,0,0,0,13.0,0:1,0,0,0,157.0,0:15,-111
8471419,Mark,Mancari,1985-07-11,RW,R,2010-11,20,1,7,8,0.4,-1,43,2.33,12,14780.0,12:19,3,3,6,50.0,16,8,9,5,4,1,1,2,1603.0,1:20,0,0,0,0.0,0:0,-111
8471426,Troy,Brouwer,1985-08-17,RW,R,2010-11,79,17,19,36,0.46,-2,122,13.93,38,71606.0,15:6,12,13,25,48.0,262,36,24,20,4,7,6,13,10014.0,2:6,0,0,0,2890.0,0:36,1025000
8471428,Pierre-Luc,Letourneau-Leblond,1985-06-04,RW,L,2010-11,2,0,0,0,0.0,-2,0,,21,415.0,3:27,0,0,0,0.0,3,0,0,0,0,0,0,0,0.0,0:0,0,0,0,0.0,0:0,525000
8471429,Tyler,Eckford,1985-09-08,D,L,2010-11,4,0,0,0,0.0,-1,1,0.0,0,2092.0,8:43,0,0,0,0.0,3,2,0,1,-1,0,0,0,228.0,0:57,0,0,0,0.0,0:0,-111
8471436,Matt,Hunwick,1985-05-21,D,L,2010-11,73,1,12,13,0.18,-15,100,1.0,25,81084.0,18:30,0,0,0,0.0,65,71,26,36,-10,0,3,3,7715.0,1:45,0,0,0,7682.0,1:45,1450000
8471450,Brandon,Yip,1985-04-25,RW,R,2010-11,71,12,10,22,0.31,-22,127,9.45,54,58502.0,13:43,5,9,14,35.71,77,21,20,17,3,3,2,5,7490.0,1:45,1,0,1,2006.0,0:28,-111
8471451,Aaron,Gagnon,1986-04-24,C,R,2010-11,19,0,2,2,0.11,-3,9,0.0,0,9192.0,8:3,30,25,55,54.55,12,5,4,0,4,0,0,0,127.0,0:6,0,0,0,406.0,0:21,-111
8471474,Travis,Morin,1984-01-09,C,L,2010-11,3,0,0,0,0.0,0,2,0.0,0,1596.0,8:52,8,6,14,57.14,1,2,0,0,0,0,0,0,5.0,0:1,0,0,0,0.0,0:0,500000
8471476,Daniel,Winnik,1985-03-06,LW,L,2010-11,80,11,15,26,0.32,-2,167,6.59,35,79431.0,16:32,25,44,69,36.23,54,52,49,19,30,2,3,5,1630.0,0:20,2,1,3,13131.0,2:44,950000
8471482,Grant,Clitsome,1985-04-14,D,L,2010-11,31,4,15,19,0.61,2,50,8.0,16,39560.0,21:16,0,0,0,0.0,67,29,6,13,-7,2,8,10,6537.0,3:30,0,0,0,3054.0,1:38,550000
8471483,Kyle,Wilson,1984-12-15,C,R,2010-11,32,4,7,11,0.34,-3,38,10.53,12,20420.0,10:38,63,70,133,47.37,21,8,10,8,2,0,0,0,1358.0,0:42,0,0,0,1476.0,0:46,600000
8471490,Adam,Cracknell,1985-07-15,RW,R,2010-11,24,3,4,7,0.29,1,26,11.54,8,12850.0,8:55,46,72,118,38.98,29,7,8,1,7,0,0,0,49.0,0:2,0,0,0,325.0,0:13,500000
8471498,Jannik,Hansen,1986-03-15,RW,R,2010-11,82,9,20,29,0.35,13,113,7.96,32,72382.0,14:42,8,11,19,42.11,149,26,42,16,26,0,0,0,579.0,0:7,0,1,1,11852.0,2:24,825000
8471504,Rene,Bourque,1981-12-10,RW,L,2010-11,80,27,23,50,0.62,-17,218,12.39,42,85217.0,17:45,7,17,24,29.17,90,26,35,48,-13,6,9,15,14431.0,3:0,1,2,3,5150.0,1:4,3333333
8471508,Olivier,Magnan,1986-05-01,D,L,2010-11,18,0,0,0,0.0,-4,8,0.0,4,16969.0,15:42,0,1,1,0.0,29,15,4,7,-3,0,0,0,48.0,0:2,0,0,0,2346.0,2:10,-111
8471514,Rich,Peverley,1982-07-08,C,R,2010-11,82,18,23,41,0.5,-17,201,8.96,37,89817.0,18:15,657,519,1176,55.87,32,44,63,23,40,6,6,12,12643.0,2:34,2,1,3,8120.0,1:39,1325000
8471521,Brad,Staubitz,1984-07-28,RW,R,2010-11,71,4,5,9,0.13,-5,29,13.79,173,27757.0,6:30,0,4,4,0.0,133,18,6,7,-1,0,0,0,177.0,0:2,0,0,0,36.0,0:0,575000
8471628,Rick,Rypien,1984-05-16,C,R,2010-11,9,0,1,1,0.11,-5,6,0.0,31,2765.0,5:7,9,5,14,64.29,13,3,2,1,1,0,0,0,0.0,0:0,0,0,0,43.0,0:4,-111
8471634,Ryan,Shannon,1983-03-02,RW,R,2010-11,79,11,16,27,0.34,3,118,9.32,24,61283.0,12:55,87,120,207,42.03,34,35,41,21,20,5,4,9,5725.0,1:12,1,0,1,5792.0,1:13,-111
8471636,Tim,Sestito,1984-08-28,LW,L,2010-11,36,0,2,2,0.06,-5,22,0.0,9,23372.0,10:49,116,137,253,45.85,79,14,8,11,-3,0,0,0,375.0,0:10,0,0,0,1622.0,0:45,500000
8471657,Cody,McLeod,1984-06-26,LW,L,2010-11,71,5,3,8,0.11,-7,73,6.85,189,41663.0,9:46,3,5,8,37.5,147,20,7,3,4,2,0,2,739.0,0:10,0,0,0,2119.0,0:29,1033333
8471663,Mike,Blunden,1986-12-15,RW,R,2010-11,1,0,0,0,0.0,-1,2,0.0,0,631.0,10:31,5,5,10,50.0,6,0,0,0,0,0,0,0,0.0,0:0,0,0,0,0.0,0:0,590000
8471664,Mason,Raymond,1985-09-17,LW,L,2010-11,70,15,24,39,0.56,8,197,7.61,10,66356.0,15:47,26,39,65,40.0,38,14,35,14,21,2,4,6,5742.0,1:22,1,0,1,4497.0,1:4,2550000
8471668,Mattias,Ritola,1987-03-14,C,L,2010-11,31,4,4,8,0.26,-5,42,9.52,11,18717.0,10:3,19,25,44,43.18,24,7,6,8,-2,0,0,0,2359.0,1:16,0,0,0,34.0,0:1,-111
8471669,Paul,Stastny,1985-12-27,C,L,2010-11,74,22,35,57,0.77,-7,181,12.15,56,87629.0,19:44,810,714,1524,53.15,74,31,52,22,30,4,15,19,13579.0,3:3,1,0,1,4593.0,1:2,6600000
8471670,Guillaume,Latendresse,1987-05-24,LW,L,2010-11,11,3,3,6,0.55,2,18,16.67,8,8388.0,12:42,0,6,6,0.0,18,2,2,4,-2,1,1,2,1122.0,1:42,0,0,0,7.0,0:0,2500000
8471675,Sidney,Crosby,1987-08-07,C,L,2010-11,41,32,34,66,1.61,20,161,19.88,31,53917.0,21:55,546,435,981,55.66,31,23,15,29,-14,10,9,19,13348.0,5:25,1,0,1,1161.0,0:28,8700000
8471676,Bobby,Ryan,1987-03-17,RW,R,2010-11,82,34,37,71,0.87,15,270,12.59,61,99284.0,20:10,87,132,219,39.73,156,34,62,42,20,5,5,10,11815.0,2:24,1,0,1,5621.0,1:8,5100000
8471677,Jack,Johnson,1987-01-13,D,L,2010-11,82,5,37,42,0.51,-21,153,3.27,44,114135.0,23:11,0,0,0,0.0,84,133,16,59,-43,3,25,28,19111.0,3:53,0,1,1,4770.0,0:58,1425000
8471678,Benoit,Pouliot,1986-09-29,LW,L,2010-11,79,13,17,30,0.38,2,129,10.08,87,54679.0,11:32,10,12,22,45.45,110,20,26,14,12,1,0,1,3794.0,0:48,0,0,0,97.0,0:1,1350000
8471680,Gilbert,Brule,1987-01-01,C,R,2010-11,41,7,2,9,0.22,-7,72,9.72,41,33929.0,13:47,106,93,199,53.27,95,16,9,29,-20,1,0,1,3139.0,1:16,0,0,0,405.0,0:9,1850000
8471681,Jack,Skille,1987-05-19,RW,R,2010-11,62,8,11,19,0.31,-9,154,5.19,29,44358.0,11:55,3,7,10,30.0,134,20,23,7,16,1,0,1,2248.0,0:36,0,0,0,216.0,0:3,600000
8471682,Devin,Setoguchi,1987-01-01,RW,R,2010-11,72,22,19,41,0.57,-2,199,11.06,37,65690.0,15:12,5,6,11,45.45,138,25,29,45,-16,4,6,10,8437.0,1:57,0,0,0,103.0,0:1,1800000
8471683,Brian,Lee,1987-03-26,D,R,2010-11,50,0,3,3,0.06,-10,35,0.0,24,51874.0,17:17,0,0,0,0.0,88,77,5,20,-15,0,0,0,263.0,0:5,0,0,0,6374.0,2:7,875000
8471685,Anze,Kopitar,1987-08-24,C,L,2010-11,75,25,48,73,0.97,25,233,10.73,20,97143.0,21:35,579,581,1160,49.91,92,45,62,40,22,6,12,18,16335.0,3:37,1,0,1,9288.0,2:3,6800000
8471686,Marc,Staal,1987-01-13,D,L,2010-11,77,7,22,29,0.38,8,116,6.03,50,118915.0,25:44,0,0,0,0.0,140,109,54,37,17,4,7,11,12169.0,2:38,2,2,4,14499.0,3:8,3975000
8471689,Ryan,O'Marra,1987-06-09,C,R,2010-11,21,1,4,5,0.24,-2,13,7.69,13,13883.0,11:1,75,103,178,42.13,41,9,8,17,-9,0,1,1,178.0,0:8,0,0,0,642.0,0:30,700000
8471691,Martin,Hanzal,1987-02-20,C,L,2010-11,61,16,10,26,0.43,4,149,10.74,54,71379.0,19:30,518,511,1029,50.34,147,35,28,23,5,7,0,7,11000.0,3:0,0,0,0,7775.0,2:7,1800000
8471692,Ryan,Parent,1987-03-17,D,L,2010-11,4,0,0,0,0.0,-3,3,0.0,0,3334.0,13:53,0,0,0,0.0,4,7,0,2,-2,0,0,0,16.0,0:4,0,0,0,20.0,0:5,925000
8471693,Jakub,Kindl,1987-02-10,D,L,2010-11,48,2,2,4,0.08,-6,62,3.23,36,39196.0,13:36,0,0,0,0.0,44,36,11,20,-9,0,0,0,2036.0,0:42,0,0,0,478.0,0:9,883333
8471694,Kenndal,McArdle,1987-01-04,LW,L,2010-11,11,0,0,0,0.0,-3,6,0.0,16,6564.0,9:56,1,2,3,33.33,36,3,1,1,0,0,0,0,18.0,0:1,0,0,0,0.0,0:0,803250
8471696,Matt,Lashoff,1986-09-29,D,L,2010-11,11,0,1,1,0.09,1,8,0.0,6,9129.0,13:49,0,0,0,0.0,10,14,6,4,2,0,1,1,1345.0,2:2,0,0,0,198.0,0:18,550000
8471697,Niclas,Bergfors,1987-03-07,RW,R,2010-11,72,12,24,36,0.5,-9,152,7.89,8,63733.0,14:45,4,5,9,44.44,12,13,48,14,34,3,6,9,7374.0,1:42,0,0,0,60.0,0:0,900000
8471698,T.J.,Oshie,1986-12-23,RW,R,2010-11,49,12,22,34,0.69,10,103,11.65,15,56415.0,19:11,100,127,227,44.05,71,40,47,17,30,3,6,9,7605.0,2:35,1,0,1,5561.0,1:53,850000
8471699,Andrew,Cogliano,1987-06-14,LW,L,2010-11,82,11,24,35,0.43,-12,129,8.53,64,84902.0,17:15,461,647,1108,41.61,89,46,32,46,-14,0,5,5,4547.0,0:55,1,2,3,13381.0,2:43,1000000
8471702,Matt,Niskanen,1986-12-06,D,R,2010-11,63,1,9,10,0.16,-3,77,1.3,50,62476.0,16:31,0,0,0,0.0,122,66,7,16,-9,0,5,5,6811.0,1:48,0,0,0,1725.0,0:27,1500000
8471703,Steve,Downie,1987-04-03,RW,R,2010-11,57,10,22,32,0.56,8,83,12.05,171,49650.0,14:31,43,53,96,44.79,94,21,30,25,5,2,3,5,7736.0,2:15,0,0,0,63.0,0:1,1850000
8471705,Brendan,Mikkelson,1987-06-22,D,L,2010-11,24,0,2,2,0.08,-6,14,0.0,9,20489.0,14:13,0,0,0,0.0,21,18,2,9,-7,0,0,0,341.0,0:14,0,0,0,1833.0,1:16,687500
8471707,James,Neal,1987-09-03,LW,L,2010-11,79,22,23,45,0.57,7,212,10.38,66,82934.0,17:29,8,15,23,34.78,159,26,59,34,25,5,5,10,12241.0,2:34,0,0,0,475.0,0:6,2875000
8471708,Ryan,Stoa,1987-04-13,C,L,2010-11,25,2,2,4,0.16,-4,45,4.44,20,20013.0,13:20,2,3,5,40.0,30,6,4,3,1,0,2,2,2338.0,1:33,0,0,0,4.0,0:0,850000
8471709,Marc-Edouard,Vlasic,1987-03-30,D,L,2010-11,80,4,14,18,0.22,14,116,3.45,18,100141.0,20:51,0,0,0,0.0,50,147,30,45,-15,0,1,1,4151.0,0:51,0,0,0,10940.0,2:16,3100000
8471710,Taylor,Chorney,1987-04-27,D,L,2010-11,12,1,3,4,0.33,-5,13,7.69,4,11508.0,15:59,0,0,0,0.0,13,17,4,11,-7,1,2,3,1310.0,1:49,0,0,0,477.0,0:39,735000
8471714,Michael,Sauer,1987-08-07,D,R,2010-11,76,3,12,15,0.2,20,54,5.56,75,79876.0,17:31,0,0,0,0.0,78,96,25,13,12,1,0,1,639.0,0:8,0,0,0,6632.0,1:27,500000
8471716,Justin,Abdelkader,1987-02-25,LW,L,2010-11,74,7,12,19,0.26,15,129,5.43,61,54613.0,12:18,227,203,430,52.79,188,39,17,20,-3,0,0,0,726.0,0:9,0,1,1,7580.0,1:42,787500
8471717,Adam,McQuaid,1986-10-12,D,R,2010-11,67,3,12,15,0.22,30,46,6.52,96,59760.0,14:51,0,0,0,0.0,102,131,5,15,-10,0,0,0,252.0,0:3,0,0,0,5794.0,1:26,575000
8471719,Matt,Kassian,1986-10-28,LW,L,2010-11,4,0,0,0,0.0,-1,1,0.0,12,1316.0,5:29,0,0,0,0.0,6,3,0,1,-1,0,0,0,0.0,0:0,0,0,0,0.0,0:0,512500
8471724,Kris,Letang,1987-04-24,D,R,2010-11,82,8,42,50,0.61,15,236,3.39,101,118245.0,24:2,1,0,1,100.0,167,109,39,52,-13,4,20,24,21992.0,4:28,0,1,1,10377.0,2:6,3500000
8471728,Brodie,Dupont,1987-02-17,LW,L,2010-11,1,0,0,0,0.0,0,1,0.0,0,334.0,5:34,0,0,0,0.0,2,0,0,0,0,0,0,0,0.0,0:0,0,0,0,0.0,0:0,-111
8471729,Kris,Russell,1987-05-02,D,L,2010-11,73,5,18,23,0.32,-9,88,5.68,37,76724.0,17:31,0,0,0,0.0,63,128,25,19,6,1,5,6,12113.0,2:45,0,1,1,1508.0,0:20,1300000
8471730,Evan,Brophey,1986-12-03,C,L,2010-11,1,0,0,0,0.0,0,1,0.0,0,429.0,7:9,4,1,5,80.0,3,1,0,1,-1,0,0,0,0.0,0:0,0,0,0,0.0,0:0,-111
8471735,Keith,Yandle,1986-09-09,D,L,2010-11,82,11,48,59,0.72,12,199,5.53,68,119944.0,24:22,0,0,0,0.0,30,103,31,61,-30,3,23,26,20154.0,4:5,0,1,1,3588.0,0:43,1200000
8471741,Teemu,Laakso,1987-08-27,D,R,2010-11,1,0,0,0,0.0,0,0,,0,163.0,2:43,0,0,0,0.0,1,0,0,0,0,0,0,0,0.0,0:0,0,0,0,0.0,0:0,-111
8471742,Cody,Franson,1987-08-08,D,R,2010-11,80,8,21,29,0.36,10,156,5.13,30,72840.0,15:10,0,0,0,0.0,81,52,29,39,-10,2,4,6,9068.0,1:53,0,0,0,558.0,0:6,800000
8471743,Vladimir,Sobotka,1987-07-02,LW,L,2010-11,65,7,22,29,0.45,-4,75,9.33,69,63093.0,16:10,216,203,419,51.55,137,37,19,14,5,1,4,5,3283.0,0:50,1,0,1,7905.0,2:1,750000
8471748,Mark,Fraser,1986-09-29,D,L,2010-11,26,0,2,2,0.08,2,16,0.0,29,21804.0,13:58,0,0,0,0.0,58,19,3,8,-5,0,0,0,104.0,0:4,0,0,0,2026.0,1:17,500000
8471752,Marc-Andre,Gragnani,1987-03-11,D,L,2010-11,9,1,2,3,0.33,0,11,9.09,2,8255.0,15:17,0,0,0,0.0,6,6,6,3,3,0,2,2,1086.0,2:0,0,0,0,89.0,0:9,500000
8471753,T.J.,Hensick,1985-12-10,C,R,2010-11,13,1,2,3,0.23,-5,12,8.33,2,7085.0,9:5,11,18,29,37.93,1,1,2,0,2,0,1,1,259.0,0:19,0,0,0,5.0,0:0,600000
8471756,Oskars,Bartulis,1987-01-21,D,L,2010-11,13,0,0,0,0.0,-4,7,0.0,4,10159.0,13:1,0,0,0,0.0,8,13,3,2,1,0,0,0,5.0,0:0,0,0,0,108.0,0:8,600000
8471760,Cody,Bass,1987-01-07,C,R,2010-11,1,0,0,0,0.0,0,0,,0,429.0,7:9,0,0,0,0.0,3,1,0,0,0,0,0,0,0.0,0:0,0,0,0,0.0,0:0,500000
8471761,Chris,Butler,1986-10-27,D,L,2010-11,49,2,7,9,0.18,8,52,3.85,26,53412.0,18:10,0,0,0,0.0,38,56,18,21,-3,0,1,1,3541.0,1:12,0,0,0,3075.0,1:2,576667
8471762,Chris,VandeVelde,1987-03-15,C,L,2010-11,12,0,2,2,0.17,-6,16,0.0,12,12439.0,17:16,84,75,159,52.83,19,12,6,4,2,0,0,0,1135.0,1:34,0,0,0,1027.0,1:25,745000
8471766,Jared,Boll,1986-05-13,RW,R,2010-11,73,7,5,12,0.16,-2,66,10.61,182,33613.0,7:40,0,6,6,0.0,144,18,14,8,6,0,0,0,328.0,0:4,0,0,0,24.0,0:0,725000
8471767,Blair,Jones,1986-09-27,C,R,2010-11,18,1,2,3,0.17,-2,20,5.0,2,8655.0,8:0,46,40,86,53.49,12,6,5,5,0,0,0,0,23.0,0:1,0,0,0,0.0,0:0,550000
8471768,Tom,Pyatt,1987-02-14,LW,L,2010-11,61,2,5,7,0.11,-1,65,3.08,9,38941.0,10:38,55,55,110,50.0,39,34,17,6,11,0,0,0,155.0,0:2,0,2,2,8020.0,2:11,500000
8471769,Niklas,Hjalmarsson,1987-06-06,D,L,2010-11,80,3,7,10,0.12,13,64,4.69,39,88688.0,18:28,0,0,0,0.0,46,166,32,55,-23,0,0,0,477.0,0:5,0,0,0,10329.0,2:9,3500000
8471786,Ray,Macias,1986-09-18,D,R,2010-11,2,0,0,0,0.0,-1,0,,2,1812.0,15:6,0,0,0,0.0,1,1,1,0,1,0,0,0,71.0,0:35,0,0,0,94.0,0:47,-111
8471794,Darren,Helm,1987-01-21,LW,L,2010-11,82,12,20,32,0.39,9,177,6.78,16,65468.0,13:18,493,445,938,52.56,128,30,46,20,26,0,0,0,265.0,0:3,2,1,3,15071.0,3:3,912500
8471804,Nathan,Gerbe,1987-07-24,C,L,2010-11,64,16,15,31,0.48,11,171,9.36,34,51199.0,13:19,4,13,17,23.53,53,23,24,19,5,2,2,4,4919.0,1:16,0,0,0,143.0,0:2,850000
8471807,Tom,Wandell,1987-01-29,C,L,2010-11,75,7,2,9,0.12,-5,94,7.45,14,52900.0,11:45,190,245,435,43.68,65,49,40,34,6,0,0,0,813.0,0:10,0,0,0,4423.0,0:58,775000
8471810,Derek,Joslin,1987-03-17,D,L,2010-11,34,2,7,9,0.26,5,34,5.88,10,31139.0,15:15,0,0,0,0.0,40,28,7,17,-10,1,0,1,2338.0,1:8,0,0,0,2276.0,1:6,500000
8471811,Cal,O'Reilly,1986-09-30,C,L,2010-11,38,6,12,18,0.47,4,44,13.64,2,38537.0,16:54,231,266,497,46.48,5,13,29,14,15,1,3,4,5289.0,2:19,0,0,0,633.0,0:16,562500
8471816,Mark,Fayne,1987-05-15,D,R,2010-11,57,4,10,14,0.25,10,77,5.19,27,60999.0,17:50,0,0,0,0.0,51,39,13,24,-11,0,4,4,2579.0,0:45,0,0,0,1828.0,0:32,542500
8471817,Ryan,Reaves,1987-01-20,RW,R,2010-11,28,2,2,4,0.14,-1,16,12.5,78,11433.0,6:48,0,2,2,0.0,86,9,2,3,-1,0,0,0,135.0,0:4,0,0,0,23.0,0:0,525000
8471832,Nick,Drazenovic,1987-01-14,C,L,2010-11,3,0,0,0,0.0,-3,2,0.0,0,1616.0,8:58,6,5,11,54.55,7,1,0,1,-1,0,0,0,187.0,1:2,0,0,0,0.0,0:0,500000
8471840,Brett,Sutter,1987-06-02,LW,L,2010-11,5,0,1,1,0.2,-1,3,0.0,5,2677.0,8:55,13,13,26,50.0,3,1,0,2,-2,0,0,0,42.0,0:8,0,1,1,648.0,2:9,500000
8471842,Tim,Kennedy,1986-04-30,LW,L,2010-11,6,0,1,1,0.17,0,2,0.0,0,3737.0,10:22,12,18,30,40.0,16,6,4,0,4,0,0,0,64.0,0:10,0,0,0,0.0,0:0,1000000
8471848,Andrey,Zubarev,1987-03-03,D,L,2010-11,4,0,1,1,0.25,-4,2,0.0,4,4818.0,20:4,0,0,0,0.0,15,8,2,0,2,0,0,0,35.0,0:8,0,0,0,450.0,1:52,-111
8471851,Matt,D'Agostini,1986-10-23,RW,R,2010-11,82,21,25,46,0.56,8,163,12.88,40,72615.0,14:45,21,34,55,38.18,70,36,24,12,12,6,8,14,8139.0,1:39,0,0,0,369.0,0:4,550000
8471856,Joe,Vitale,1985-08-20,C,R,2010-11,9,1,1,2,0.22,-1,13,7.69,13,5709.0,10:34,36,28,64,56.25,18,2,5,2,3,0,1,1,75.0,0:8,0,0,0,229.0,0:25,512500
8471859,Sergei,Kostitsyn,1987-03-20,LW,L,2010-11,77,23,27,50,0.65,10,93,24.73,20,70182.0,15:11,1,5,6,16.67,41,15,28,44,-16,4,9,13,8727.0,1:53,1,0,1,1585.0,0:20,550000
8471862,Colin,Greening,1986-03-09,C,L,2010-11,24,6,7,13,0.54,2,57,10.53,10,21725.0,15:5,11,13,24,45.83,56,9,11,8,3,0,0,0,676.0,0:28,0,0,0,1298.0,0:54,735000
8471863,Mario,Bliznak,1987-03-06,C,L,2010-11,4,1,0,1,0.25,1,1,100.0,0,1587.0,6:36,7,14,21,33.33,2,1,2,0,2,0,0,0,0.0,0:0,0,0,0,176.0,0:44,-111
8471873,Anton,Stralman,1986-08-01,D,R,2010-11,51,1,17,18,0.35,-11,80,1.25,22,60387.0,19:44,0,0,0,0.0,39,46,15,11,4,1,9,10,9060.0,2:57,0,0,0,990.0,0:19,1950000
8471879,Kyle,Cumiskey,1986-12-02,D,L,2010-11,18,1,7,8,0.44,-3,21,4.76,10,21238.0,19:39,0,0,0,0.0,9,27,14,7,7,0,1,1,2292.0,2:7,0,0,0,3162.0,2:55,600000
8471887,Patric,Hornqvist,1987-01-01,RW,R,2010-11,79,21,27,48,0.61,11,265,7.92,47,74539.0,15:43,22,23,45,48.89,86,36,40,21,19,6,8,14,13050.0,2:45,0,0,0,49.0,0:0,3083333
8471941,Mike,Duco,1987-07-08,RW,L,2010-11,2,0,0,0,0.0,-1,0,,10,1026.0,8:33,0,0,0,0.0,6,0,0,1,-1,0,0,0,0.0,0:0,0,0,0,0.0,0:0,-111
8471956,Andrew,Desjardins,1986-07-27,LW,L,2010-11,17,1,2,3,0.18,-1,12,8.33,4,7283.0,7:8,31,25,56,55.36,34,5,6,1,5,0,0,0,52.0,0:3,0,0,0,266.0,0:15,500000
8471958,Dan,Girardi,1984-04-29,D,R,2010-11,80,4,27,31,0.39,7,110,3.64,37,117971.0,24:34,0,0,0,0.0,195,236,30,51,-21,2,5,7,9705.0,2:1,0,2,2,15421.0,3:12,3325000
8471976,David,Desharnais,1986-09-14,C,L,2010-11,43,8,14,22,0.51,-3,55,14.55,12,33206.0,12:52,221,224,445,49.66,16,19,10,6,4,4,4,8,4861.0,1:53,0,0,0,2351.0,0:54,550000
8471978,Brett,Festerling,1986-03-03,D,L,2010-11,1,0,0,0,0.0,-2,0,,0,893.0,14:53,0,0,0,0.0,2,4,0,0,0,0,0,0,21.0,0:21,0,0,0,383.0,6:23,525000
8472262,Clay,Wilson,1983-04-05,D,L,2010-11,15,3,2,5,0.33,4,22,13.64,6,13359.0,14:50,0,0,0,0.0,16,11,2,3,-1,0,1,1,2451.0,2:43,0,0,0,0.0,0:0,-111
8472355,Rod,Pelley,1984-09-01,C,L,2010-11,74,3,7,10,0.14,-9,88,3.41,27,52428.0,11:48,169,151,320,52.81,113,36,20,12,8,1,0,1,609.0,0:8,0,0,0,6161.0,1:23,-111
8472361,Bill,Thomas,1983-06-20,RW,R,2010-11,24,4,3,7,0.29,1,33,12.12,6,12250.0,8:30,13,9,22,59.09,19,10,8,3,5,0,0,0,78.0,0:3,0,0,0,309.0,0:12,-111
8472368,Chris,Conner,1983-12-23,RW,L,2010-11,60,7,9,16,0.27,5,91,7.69,10,42544.0,11:49,1,3,4,25.0,50,20,15,7,8,0,0,0,2181.0,0:36,0,0,0,79.0,0:1,550000
8472370,Jordan,Hendry,1984-02-23,D,L,2010-11,37,1,0,1,0.03,-2,35,2.86,4,23736.0,10:41,0,1,1,0.0,47,29,7,4,3,0,0,0,274.0,0:7,0,0,0,63.0,0:1,-111
8472379,Tim,Stapleton,1982-07-19,C,R,2010-11,45,5,2,7,0.16,-10,44,11.36,12,30013.0,11:6,109,116,225,48.44,18,19,15,11,4,1,0,1,787.0,0:17,0,0,0,452.0,0:10,-111
8472382,Andy,Greene,1982-10-30,D,L,2010-11,82,4,19,23,0.28,-23,91,4.4,22,110015.0,22:21,0,0,0,0.0,49,157,34,34,0,1,5,6,6305.0,1:16,0,0,0,11425.0,2:19,737500
8472394,Peter,Harrold,1983-06-08,D,R,2010-11,19,1,3,4,0.21,3,12,8.33,4,13973.0,12:15,0,0,0,0.0,5,6,5,6,-1,0,0,0,752.0,0:39,0,0,0,56.0,0:2,583333
8472410,Stephen,Gionta,1983-10-09,RW,R,2010-11,12,0,0,0,0.0,-3,13,0.0,6,6484.0,9:0,0,0,0,0.0,16,5,5,2,3,0,0,0,26.0,0:2,0,0,0,1138.0,1:34,512500
8473412,Bryan,Little,1987-11-12,C,R,2010-11,76,18,30,48,0.63,11,158,11.39,33,84159.0,18:27,616,715,1331,46.28,41,31,80,22,58,2,8,10,11272.0,2:28,2,1,3,7789.0,1:42,2383333
8473419,Brad,Marchand,1988-05-11,LW,L,2010-11,77,21,20,41,0.53,25,149,14.09,51,64607.0,13:59,8,17,25,32.0,89,30,36,39,-3,2,1,3,2495.0,0:32,5,1,6,7260.0,1:34,590000
8473422,Nick,Foligno,1987-10-31,LW,L,2010-11,82,14,20,34,0.41,-19,149,9.4,43,76639.0,15:34,65,73,138,47.1,119,41,31,25,6,5,5,10,8639.0,1:45,0,0,0,195.0,0:2,1200000
8473426,Mike,Weber,1987-12-16,D,L,2010-11,58,4,13,17,0.29,13,53,7.55,69,58789.0,16:53,0,0,0,0.0,158,99,14,34,-20,0,0,0,309.0,0:5,0,0,0,5531.0,1:35,550000
8473432,Derek,Dorsett,1986-12-20,RW,R,2010-11,76,4,13,17,0.22,-15,112,3.57,184,60230.0,13:12,19,32,51,37.25,195,37,25,7,18,0,0,0,471.0,0:6,0,3,3,7078.0,1:33,562500
8473444,Jon,Matsumoto,1986-10-13,C,L,2010-11,13,2,0,2,0.15,-4,11,18.18,4,5514.0,7:4,30,53,83,36.14,13,4,4,3,1,0,0,0,91.0,0:7,0,0,0,64.0,0:4,-111
8473446,Erik,Johnson,1988-03-21,D,R,2010-11,77,8,21,29,0.38,-13,161,4.97,56,105438.0,22:49,0,0,0,0.0,99,133,28,43,-15,3,7,10,12590.0,2:43,1,1,2,11288.0,2:26,2600000
8473449,Kyle,Okposo,1988-04-16,RW,R,2010-11,38,5,15,20,0.53,3,72,6.94,40,37809.0,16:34,36,51,87,41.38,31,16,26,22,4,0,5,5,5798.0,2:32,0,0,0,1133.0,0:29,821667
8473453,Trevor,Lewis,1987-01-08,C,R,2010-11,72,3,10,13,0.18,-11,105,2.86,6,49629.0,11:29,151,234,385,39.22,102,25,27,16,11,0,0,0,229.0,0:3,0,0,0,7646.0,1:46,803250
8473456,Rhett,Rakhshani,1988-03-06,RW,R,2010-11,2,0,0,0,0.0,-1,2,0.0,0,1405.0,11:42,0,0,0,0.0,0,0,2,1,1,0,0,0,77.0,0:38,0,0,0,0.0,0:0,-111
8473459,Arturs,Kulda,1988-07-25,D,L,2010-11,2,0,0,0,0.0,-2,3,0.0,2,1333.0,11:6,0,0,0,0.0,4,1,0,1,-1,0,0,0,5.0,0:2,0,0,0,2.0,0:1,-111
8473465,Jamie,McGinn,1988-08-05,LW,L,2010-11,49,1,5,6,0.12,-6,63,1.59,33,34056.0,11:35,8,3,11,72.73,101,17,18,6,12,0,0,0,269.0,0:5,0,0,0,611.0,0:12,681667
8473466,Ryan,White,1988-03-17,C,R,2010-11,27,2,3,5,0.19,5,30,6.67,38,14453.0,8:55,13,19,32,40.62,70,8,8,5,3,0,0,0,190.0,0:7,0,0,0,203.0,0:7,610000
8473473,Milan,Lucic,1988-06-07,LW,L,2010-11,79,30,32,62,0.78,28,173,17.34,121,78589.0,16:34,21,33,54,38.89,167,22,27,43,-16,5,9,14,11919.0,2:30,0,0,0,123.0,0:1,4083333
8473482,Jiri,Tlusty,1988-03-16,LW,L,2010-11,57,6,6,12,0.21,1,53,11.32,14,33727.0,9:51,2,13,15,13.33,36,19,21,7,14,0,0,0,525.0,0:9,0,0,0,163.0,0:2,500000
8473485,Chris,Stewart,1987-10-30,RW,R,2010-11,62,28,25,53,0.85,-6,162,17.28,53,65052.0,17:29,13,19,32,40.62,56,18,14,22,-8,12,4,16,10695.0,2:52,0,0,0,207.0,0:3,2875000
8473488,Sergei,Shirokov,1986-03-10,LW,R,2010-11,2,1,0,1,0.5,1,6,16.67,0,1235.0,10:17,0,0,0,0.0,1,0,0,0,0,0,0,0,43.0,0:21,0,0,0,0.0,0:0,-111
8473492,Matt,Beleskey,1988-06-07,LW,L,2010-11,35,3,7,10,0.29,-10,58,5.17,36,27264.0,12:58,3,5,8,37.5,64,20,7,10,-3,0,0,0,766.0,0:21,0,1,1,1034.0,0:29,583333
8473493,Ben,Maxwell,1988-03-30,C,L,2010-11,12,1,1,2,0.17,-7,13,7.69,9,8636.0,11:59,16,20,36,44.44,1,2,5,3,2,0,0,0,153.0,0:12,0,0,0,512.0,0:42,710000
8473501,Ty,Wishart,1988-05-19,D,L,2010-11,20,1,4,5,0.25,5,23,4.35,10,20181.0,16:49,0,0,0,0.0,26,29,9,10,-1,1,0,1,600.0,0:30,0,1,1,1723.0,1:26,788333
8473504,Cal,Clutterbuck,1987-11-18,RW,R,2010-11,76,19,15,34,0.45,-5,191,9.95,79,72265.0,15:50,3,8,11,27.27,336,32,24,25,-1,4,1,5,9552.0,2:5,0,1,1,6608.0,1:26,1400000
8473507,Jeff,Petry,1987-12-09,D,R,2010-11,35,1,4,5,0.14,-12,41,2.44,10,42785.0,20:22,0,0,0,0.0,48,49,16,32,-16,0,3,3,4588.0,2:11,0,0,0,2689.0,1:16,850000
8473512,Claude,Giroux,1988-01-12,C,R,2010-11,82,25,51,76,0.93,20,169,14.79,47,95437.0,19:23,548,547,1095,50.05,117,44,48,44,4,8,11,19,15092.0,3:4,3,4,7,10363.0,2:6,821667
8473514,Jesse,Joensuu,1987-10-05,LW,L,2010-11,42,6,3,9,0.21,-6,41,14.63,33,29171.0,11:34,5,4,9,55.56,59,13,11,10,1,0,0,0,319.0,0:7,0,0,0,24.0,0:0,618333
8473525,Theo,Peckham,1987-11-10,D,L,2010-11,71,3,10,13,0.18,-5,41,7.32,198,79215.0,18:35,0,0,0,0.0,196,123,30,67,-37,0,0,0,444.0,0:6,0,0,0,10726.0,2:31,-111
8473533,Jordan,Staal,1988-09-10,C,L,2010-11,42,11,19,30,0.71,7,91,12.09,24,53810.0,21:21,376,425,801,46.94,70,13,20,10,10,3,4,7,7946.0,3:9,0,2,2,6313.0,2:30,4000000
8473534,Patrik,Berglund,1988-06-02,C,L,2010-11,81,22,30,52,0.64,-3,175,12.57,26,83546.0,17:11,450,524,974,46.2,116,33,28,19,9,8,9,17,14090.0,2:53,0,1,1,2400.0,0:29,821667
8473537,Viktor,Stalberg,1986-01-17,LW,L,2010-11,77,12,12,24,0.31,2,135,8.89,43,49426.0,10:41,5,4,9,55.56,102,25,36,14,22,0,1,1,950.0,0:12,0,0,0,68.0,0:0,750000
8473542,Tom,Sestito,1987-09-28,LW,L,2010-11,9,2,2,4,0.44,-4,7,28.57,40,5145.0,9:31,1,0,1,100.0,31,3,1,2,-1,1,1,2,726.0,1:20,0,0,0,0.0,0:0,577500
8473544,Derick,Brassard,1987-09-22,C,L,2010-11,74,17,30,47,0.64,-11,183,9.29,55,75607.0,17:1,414,474,888,46.62,121,14,26,23,3,6,10,16,13244.0,2:58,0,0,0,259.0,0:3,3200000
8473546,Michael,Grabner,1987-10-05,RW,L,2010-11,76,34,18,52,0.68,13,228,14.91,10,68779.0,15:4,2,4,6,33.33,22,26,69,30,39,2,2,4,4174.0,0:54,6,1,7,6980.0,1:31,793333
8473548,Phil,Kessel,1987-10-02,RW,R,2010-11,82,32,32,64,0.78,-20,325,9.85,24,96660.0,19:38,24,35,59,40.68,11,22,45,45,0,12,11,23,18456.0,3:45,1,0,1,575.0,0:7,5400000
8473558,Cory,Emmerton,1988-06-01,C,L,2010-11,2,1,0,1,0.5,1,3,33.33,0,1001.0,8:20,0,1,1,0.0,0,0,0,0,0,0,0,0,0.0,0:0,0,0,0,0.0,0:0,623333
8473560,Korbinian,Holzer,1988-02-16,D,R,2010-11,2,0,0,0,0.0,-1,1,0.0,2,1562.0,13:1,0,0,0,0.0,1,3,1,2,-1,0,0,0,59.0,0:29,0,0,0,68.0,0:34,595000
8473562,John,McCarthy,1986-08-09,C,L,2010-11,37,2,2,4,0.11,-8,41,4.88,8,19409.0,8:44,13,23,36,36.11,28,9,7,5,2,0,0,0,16.0,0:0,0,0,0,1040.0,0:28,550000
8473563,Nicklas,Backstrom,1987-11-23,C,L,2010-11,77,18,47,65,0.84,24,202,8.91,40,95160.0,20:35,690,625,1315,52.47,69,64,73,42,31,4,18,22,15358.0,3:19,1,0,1,6671.0,1:26,6700000
8473564,Michael,Frolik,1988-02-17,RW,L,2010-11,80,11,27,38,0.48,2,251,4.38,30,74844.0,15:35,48,71,119,40.34,52,37,49,16,33,1,5,6,8087.0,1:41,0,0,0,346.0,0:4,850000
8473565,Brian,Strait,1988-01-04,D,L,2010-11,3,0,0,0,0.0,-1,0,,0,2437.0,13:32,0,0,0,0.0,2,2,1,1,0,0,0,0,0.0,0:0,0,0,0,32.0,0:10,601667
8473568,Andreas,Nodl,1987-02-28,RW,L,2010-11,67,11,11,22,0.33,14,100,11.0,16,53360.0,13:16,11,8,19,57.89,111,25,21,29,-8,1,0,1,1026.0,0:15,1,0,1,2348.0,0:35,-111
8473569,Jan,Mursak,1988-01-20,LW,R,2010-11,19,1,0,1,0.05,-3,20,5.0,4,9340.0,8:11,3,3,6,50.0,14,3,5,4,1,0,0,0,74.0,0:3,0,0,0,1.0,0:0,-111
8473571,Jamie,McBain,1988-02-25,D,R,2010-11,76,7,23,30,0.39,-8,95,7.37,32,87105.0,19:6,0,0,0,0.0,41,117,22,36,-14,1,7,8,12497.0,2:44,0,0,0,2896.0,0:38,685000
8473573,Artem,Anisimov,1988-05-24,C,L,2010-11,82,18,26,44,0.54,3,190,9.47,20,79742.0,16:12,306,382,688,44.48,74,45,46,16,30,3,5,8,8848.0,1:47,0,0,0,5084.0,1:2,821667
8473574,Shawn,Matthias,1988-02-19,LW,L,2010-11,51,6,10,16,0.31,0,90,6.67,16,36232.0,11:50,188,182,370,50.81,60,20,22,7,15,0,2,2,2029.0,0:39,0,0,0,430.0,0:8,773333
8473579,Nikolay,Kulemin,1986-07-14,LW,L,2010-11,82,30,27,57,0.7,7,173,17.34,26,85235.0,17:19,60,51,111,54.05,101,48,37,28,9,5,8,13,13075.0,2:39,1,0,1,4564.0,0:55,2350000
8473580,Matthew,Corrente,1988-03-17,D,R,2010-11,22,0,6,6,0.27,-5,21,0.0,44,17951.0,13:35,0,0,0,0.0,30,15,0,10,-10,0,0,0,59.0,0:2,0,0,0,455.0,0:20,590000
8473584,Andrew,MacDonald,1986-09-07,D,L,2010-11,60,4,23,27,0.45,9,72,5.56,37,84291.0,23:24,0,0,0,0.0,38,160,49,35,14,1,11,12,10986.0,3:3,0,0,0,8614.0,2:23,550000
8473588,Erik,Condra,1986-08-06,RW,R,2010-11,26,6,5,11,0.42,-1,48,12.5,12,24755.0,15:52,2,2,4,50.0,4,21,9,11,-2,1,0,1,1137.0,0:43,0,1,1,3113.0,1:59,605000
8473589,Chris,Summers,1988-02-05,D,L,2010-11,2,0,0,0,0.0,-3,0,,4,1664.0,13:52,0,0,0,0.0,4,2,0,1,-1,0,0,0,0.0,0:0,0,0,0,260.0,2:10,850000
8473592,Vladimir,Zharkov,1988-01-10,RW,L,2010-11,38,2,2,4,0.11,3,40,5.0,2,25835.0,11:19,2,4,6,33.33,14,10,19,15,4,0,0,0,1024.0,0:26,0,0,0,1323.0,0:34,-111
8473600,Benn,Ferriero,1987-04-29,RW,R,2010-11,33,5,4,9,0.27,8,56,8.93,9,25914.0,13:5,2,9,11,18.18,46,8,11,11,0,1,0,1,1871.0,0:56,0,0,0,10.0,0:0,635000
8473604,Jonathan,Toews,1988-04-29,C,L,2010-11,80,32,44,76,0.95,25,233,13.73,26,99668.0,20:45,937,716,1653,56.68,74,28,93,30,63,10,15,25,14823.0,3:5,1,1,2,9404.0,1:57,6300000
8473605,Alexander,Vasyunov,1988-04-22,LW,R,2010-11,18,1,4,5,0.28,0,18,5.56,0,12394.0,11:28,0,0,0,0.0,6,2,5,5,0,0,0,0,78.0,0:4,0,0,0,10.0,0:0,618333
8473608,Blake,Geoffrion,1988-02-03,C,L,2010-11,20,6,2,8,0.4,3,24,25.0,7,9929.0,8:16,46,53,99,46.46,8,4,11,6,5,0,0,0,23.0,0:1,0,0,0,28.0,0:1,850000
8473611,Shane,Sims,1988-04-30,D,R,2010-11,1,0,0,0,0.0,0,0,,0,394.0,6:34,0,0,0,0.0,1,0,1,0,1,0,0,0,0.0,0:0,0,0,0,0.0,0:0,-111
8473618,Mathieu,Perreault,1988-01-05,C,L,2010-11,35,7,7,14,0.4,-3,41,17.07,20,24952.0,11:52,139,166,305,45.57,13,9,21,12,9,1,2,3,3164.0,1:30,0,0,0,18.0,0:0,675000
8473646,Ryan,Carter,1983-08-03,LW,L,2010-11,62,3,6,9,0.15,-1,63,4.76,66,37272.0,10:1,242,236,478,50.63,133,22,23,7,16,0,0,0,205.0,0:3,0,1,1,5244.0,1:24,625000
8473673,David,Schlemko,1987-05-07,D,L,2010-11,43,4,10,14,0.33,8,47,8.51,24,41376.0,16:2,0,0,0,0.0,56,57,3,21,-18,0,5,5,4165.0,1:36,0,0,0,1071.0,0:24,550000
8473682,Andrew,Ebbett,1983-01-02,C,L,2010-11,33,2,3,5,0.15,-1,23,8.7,4,19830.0,10:0,104,125,229,45.41,13,12,8,5,3,0,0,0,25.0,0:0,1,0,1,1924.0,0:58,500000
8473700,Ryan,Wilson,1987-02-03,D,L,2010-11,67,3,13,16,0.24,-8,62,4.84,68,79620.0,19:48,0,0,0,0.0,135,110,28,31,-3,1,1,2,3173.0,0:47,0,0,0,9759.0,2:25,525000
8473712,Frazer,McLaren,1987-10-29,LW,L,2010-11,9,0,0,0,0.0,-1,1,0.0,22,2296.0,4:15,0,0,0,0.0,6,0,0,2,-2,0,0,0,0.0,0:0,0,0,0,0.0,0:0,543333
8473722,John,Scott,1982-09-26,LW,L,2010-11,40,0,1,1,0.02,0,15,0.0,72,15008.0,6:15,0,3,3,0.0,60,10,3,3,0,0,0,0,59.0,0:1,0,0,0,349.0,0:8,512500
8473734,Tim,Wallace,1984-08-06,RW,R,2010-11,7,0,0,0,0.0,-3,1,0.0,5,3381.0,8:3,3,0,3,100.0,21,2,1,1,0,0,0,0,3.0,0:0,0,0,0,0.0,0:0,-111
8473908,Kevin,Westgarth,1984-02-07,RW,R,2010-11,56,0,3,3,0.05,-6,20,0.0,105,18266.0,5:26,2,2,4,50.0,59,5,5,11,-6,0,0,0,18.0,0:0,0,0,0,37.0,0:0,525000
8473913,Sean,Collins,1983-10-30,D,R,2010-11,4,1,0,1,0.25,2,4,25.0,0,3538.0,14:44,0,0,0,0.0,2,4,0,1,-1,0,0,0,0.0,0:0,0,0,0,144.0,0:36,-111
8473914,Mark,Letestu,1985-02-04,C,R,2010-11,64,14,13,27,0.42,4,128,10.94,13,54730.0,14:15,407,327,734,55.45,51,15,26,14,12,4,2,6,8338.0,2:10,0,0,0,220.0,0:3,500000
8473927,Brad,Mills,1983-05-03,C,R,2010-11,4,1,0,1,0.25,1,6,16.67,5,1986.0,8:16,7,10,17,41.18,7,2,0,0,0,0,0,0,0.0,0:0,0,0,0,177.0,0:44,505000
8473931,Lee,Sweatt,1985-08-13,D,R,2010-11,3,1,1,2,0.67,4,4,25.0,2,2410.0,13:23,0,0,0,0.0,4,6,0,0,0,0,0,0,0.0,0:0,0,0,0,3.0,0:1,-111
8473932,Darroll,Powe,1985-06-22,C,L,2010-11,81,7,10,17,0.21,-6,87,8.05,41,59712.0,12:17,66,68,134,49.25,196,60,20,12,8,0,0,0,258.0,0:3,2,1,3,15436.0,3:10,725000
8473933,Ben,Lovejoy,1984-02-20,D,R,2010-11,47,3,14,17,0.36,11,60,5.0,48,42305.0,15:0,0,0,0,0.0,44,60,7,8,-1,0,1,1,224.0,0:4,0,1,1,2512.0,0:53,525000
8473953,Derek,Smith,1984-10-13,D,L,2010-11,9,0,1,1,0.11,3,13,0.0,0,8271.0,15:19,0,0,0,0.0,5,11,3,2,1,0,0,0,318.0,0:35,0,0,0,7.0,0:0,550000
8473962,Teddy,Purcell,1985-09-08,LW,R,2010-11,81,17,34,51,0.63,5,196,8.67,10,68535.0,14:6,12,25,37,32.43,21,16,35,19,16,3,18,21,13369.0,2:45,0,0,0,110.0,0:1,750000
8473970,Rob,Klinkhammer,1986-08-12,LW,L,2010-11,1,0,0,0,0.0,1,1,0.0,0,696.0,11:36,0,0,0,0.0,3,1,0,0,0,0,0,0,18.0,0:18,0,0,0,0.0,0:0,500000
8473991,Karl,Alzner,1988-09-24,D,L,2010-11,82,2,10,12,0.15,14,64,3.12,24,98481.0,20:0,0,0,0,0.0,98,132,24,40,-16,0,0,0,1838.0,0:22,0,0,0,10452.0,2:7,875000
8473992,Justin,Falk,1988-10-11,D,L,2010-11,22,0,3,3,0.14,-4,7,0.0,6,18687.0,14:9,0,0,0,0.0,22,17,3,7,-4,0,0,0,100.0,0:4,0,0,0,1673.0,1:16,591667
8473994,Jamie,Benn,1989-07-18,LW,L,2010-11,69,22,34,56,0.81,-5,177,12.43,52,74579.0,18:0,84,111,195,43.08,124,41,66,33,33,6,5,11,9494.0,2:17,4,2,6,6744.0,1:37,630000
8473997,Luca,Caputi,1988-10-01,LW,L,2010-11,7,0,0,0,0.0,-2,8,0.0,4,4649.0,11:4,2,4,6,33.33,7,0,1,2,-1,0,0,0,603.0,1:26,0,0,0,0.0,0:0,-111
8473999,Nick,Palmieri,1989-07-12,RW,R,2010-11,43,9,8,17,0.4,9,66,13.64,6,36960.0,14:19,2,0,2,100.0,36,8,16,16,0,1,1,2,1427.0,0:33,0,0,0,0.0,0:0,536667
8474000,Steven,Kampfer,1988-09-24,D,R,2010-11,38,5,5,10,0.26,9,57,8.77,12,40430.0,17:43,0,0,0,0.0,41,56,5,10,-5,0,3,3,4259.0,1:52,0,0,0,393.0,0:10,635000
8474001,TJ,Galiardi,1988-04-22,LW,L,2010-11,35,7,8,15,0.43,-6,62,11.29,12,34009.0,16:11,62,72,134,46.27,41,19,26,15,11,0,2,2,1540.0,0:44,0,0,0,4011.0,1:54,595833
8474002,Colby,Cohen,1989-04-25,D,R,2010-11,3,0,0,0,0.0,-1,2,0.0,4,3192.0,17:44,0,0,0,0.0,4,3,2,0,2,0,0,0,444.0,2:28,0,0,0,308.0,1:42,845500
8474009,Nick,Bonino,1988-04-20,C,L,2010-11,26,0,0,0,0.0,-3,23,0.0,4,15299.0,9:48,78,88,166,46.99,18,10,10,4,6,0,0,0,457.0,0:17,0,0,0,104.0,0:4,796250
8474013,Ian,Cole,1989-02-21,D,L,2010-11,26,1,3,4,0.15,6,22,4.55,35,27468.0,17:36,0,0,0,0.0,36,37,5,14,-9,0,0,0,690.0,0:26,0,0,0,1567.0,1:0,875000
8474024,Jim,O'Brien,1989-01-29,C,R,2010-11,6,0,0,0,0.0,-3,11,0.0,2,3482.0,9:40,8,8,16,50.0,5,0,2,4,-2,0,0,0,114.0,0:19,0,0,0,65.0,0:10,620833
8474025,Eric,Tangradi,1989-02-10,LW,L,2010-11,15,1,2,3,0.2,-4,18,5.56,10,10080.0,11:12,1,2,3,33.33,25,5,2,5,-3,0,0,0,1497.0,1:39,0,0,0,41.0,0:2,708333
8474027,Justin,Braun,1987-02-10,D,R,2010-11,28,2,9,11,0.39,-1,44,4.55,2,27720.0,16:30,0,0,0,0.0,27,21,14,14,0,2,0,2,1724.0,1:1,0,0,0,1773.0,1:3,662500
8474030,Aaron,Palushaj,1989-09-07,RW,R,2010-11,3,0,0,0,0.0,1,3,0.0,2,1533.0,8:31,0,1,1,0.0,3,1,0,2,-2,0,0,0,96.0,0:32,0,0,0,0.0,0:0,737500
8474031,Kevin,Shattenkirk,1989-01-29,D,R,2010-11,72,9,34,43,0.6,-4,108,8.33,36,85712.0,19:50,0,0,0,0.0,66,96,41,23,18,3,12,15,12785.0,2:57,0,0,0,1738.0,0:24,875000
8474037,James,van Riemsdyk,1989-05-04,LW,L,2010-11,75,21,19,40,0.53,15,173,12.14,35,65399.0,14:31,0,3,3,0.0,107,25,27,16,11,3,1,4,5929.0,1:19,0,0,0,252.0,0:3,875000
8474038,Paul,Byron,1989-04-27,LW,L,2010-11,8,1,1,2,0.25,0,5,20.0,2,5258.0,10:57,29,42,71,40.85,18,2,8,2,6,0,0,0,40.0,0:5,0,0,0,97.0,0:12,555000
8474040,Sam,Gagner,1989-08-10,C,R,2010-11,68,15,27,42,0.62,-17,138,10.87,37,72419.0,17:44,410,525,935,43.85,24,29,33,38,-5,3,6,9,12018.0,2:56,1,0,1,1536.0,0:22,2275000
8474042,Cody,Almond,1989-07-24,C,L,2010-11,8,0,0,0,0.0,0,3,0.0,2,3373.0,7:1,13,19,32,40.62,11,3,1,1,0,0,0,0,11.0,0:1,0,0,0,49.0,0:6,585000
8474045,Zach,Hamill,1988-09-23,C,R,2010-11,3,0,1,1,0.33,1,1,0.0,0,1885.0,10:28,5,11,16,31.25,0,3,1,2,-1,0,0,0,0.0,0:0,0,0,0,14.0,0:4,816667
8474046,Alex,Plante,1989-05-09,D,R,2010-11,3,0,0,0,0.0,-2,5,0.0,11,2709.0,15:3,0,0,0,0.0,4,3,0,1,-1,0,0,0,8.0,0:2,0,0,0,151.0,0:50,875000
8474048,Keith,Aulie,1989-06-11,D,L,2010-11,40,2,0,2,0.05,-1,32,6.25,32,45902.0,19:7,0,0,0,0.0,98,74,5,46,-41,0,0,0,560.0,0:14,0,0,0,4962.0,2:4,558333
8474050,Brett,MacLean,1988-12-24,LW,R,2010-11,13,2,1,3,0.23,0,16,12.5,2,6835.0,8:45,1,1,2,50.0,8,0,1,1,0,1,0,1,1342.0,1:43,0,0,0,0.0,0:0,737500
8474053,Logan,Couture,1989-03-28,C,L,2010-11,79,32,24,56,0.71,18,253,12.65,41,84482.0,17:49,474,414,888,53.38,60,66,49,25,24,10,4,14,10419.0,2:11,0,0,0,5117.0,1:4,816667
8474056,P.K.,Subban,1989-05-13,D,R,2010-11,77,14,24,38,0.49,-8,197,7.11,124,102881.0,22:16,0,0,0,0.0,110,106,37,56,-19,9,9,18,14235.0,3:4,0,0,0,11727.0,2:32,875000
8474059,Linus,Omark,1987-02-05,LW,L,2010-11,51,5,22,27,0.53,-16,76,6.58,26,46988.0,15:21,3,5,8,37.5,13,19,33,35,-2,1,7,8,8069.0,2:38,0,0,0,17.0,0:0,-111
8474063,Mark,Katic,1989-05-09,D,L,2010-11,11,0,1,1,0.09,-9,8,0.0,4,10842.0,16:25,0,0,0,0.0,8,21,13,4,9,0,0,0,680.0,1:1,0,0,0,863.0,1:18,-111
8474068,Kyle,Turris,1989-08-14,C,R,2010-11,65,11,14,25,0.38,0,116,9.48,16,43965.0,11:16,270,270,540,50.0,30,15,14,19,-5,0,1,1,5642.0,1:26,0,0,0,313.0,0:4,845833
8474074,Paul,Postma,1989-02-22,D,R,2010-11,1,0,0,0,0.0,0,1,0.0,0,595.0,9:55,0,0,0,0.0,1,2,0,0,0,0,0,0,43.0,0:43,0,0,0,0.0,0:0,670833
8474077,Carson,McMillan,1988-09-10,RW,R,2010-11,4,1,1,2,0.5,1,5,20.0,0,2241.0,9:20,9,14,23,39.13,6,1,0,1,-1,0,0,0,18.0,0:4,0,0,0,0.0,0:0,-111
8474085,Johan,Harju,1986-05-15,LW,L,2010-11,10,1,2,3,0.3,-2,14,7.14,2,5084.0,8:28,2,3,5,40.0,9,2,0,1,-1,0,0,0,805.0,1:20,0,0,0,0.0,0:0,-111
8474091,Brandon,Sutter,1989-02-14,C,R,2010-11,82,14,15,29,0.35,13,145,9.66,25,82891.0,16:50,598,751,1349,44.33,69,73,48,25,23,1,2,3,3812.0,0:46,0,1,1,11576.0,2:21,875000
8474094,Matt,Halischuk,1988-06-01,RW,R,2010-11,27,4,8,12,0.44,5,29,13.79,2,16406.0,10:7,0,4,4,0.0,6,9,16,4,12,0,0,0,134.0,0:4,0,0,0,291.0,0:10,587500
8474095,Dana,Tyrell,1989-04-23,C,L,2010-11,78,6,9,15,0.19,-5,73,8.22,12,56423.0,12:3,5,6,11,45.45,47,33,21,14,7,0,0,0,468.0,0:6,0,0,0,7896.0,1:41,683333
8474096,Nick,Spaling,1988-09-19,C,L,2010-11,74,8,6,14,0.19,-10,75,10.67,20,61849.0,13:55,253,244,497,50.91,37,33,44,15,29,1,0,1,589.0,0:7,0,0,0,11905.0,2:40,737500
8474098,Colton,Sceviour,1989-04-20,C,R,2010-11,1,0,0,0,0.0,-1,0,,0,309.0,5:9,0,0,0,0.0,0,0,0,0,0,0,0,0,10.0,0:10,0,0,0,0.0,0:0,585833
8474100,Dwight,King,1989-07-05,LW,L,2010-11,6,0,0,0,0.0,-2,3,0.0,2,4220.0,11:43,0,0,0,0.0,7,1,1,1,0,0,0,0,27.0,0:4,0,0,0,0.0,0:0,566667
8474102,David,Perron,1988-05-28,LW,R,2010-11,10,5,2,7,0.7,7,29,17.24,12,11051.0,18:25,0,0,0,0.0,6,1,9,3,6,0,0,0,2701.0,4:30,0,1,1,272.0,0:27,2150000
8474114,Oscar,Moller,1989-01-22,RW,R,2010-11,13,1,3,4,0.31,-1,27,3.7,2,11383.0,14:35,4,1,5,80.0,10,5,3,5,-2,0,0,0,1822.0,2:20,0,0,0,45.0,0:3,654167
8474121,Colton,Gillies,1989-02-12,C,L,2010-11,7,1,0,1,0.14,-2,3,33.33,2,4354.0,10:22,1,1,2,50.0,16,2,0,1,-1,0,0,0,264.0,0:37,0,0,0,0.0,0:0,875000
8474125,Carl,Gunnarsson,1986-11-09,D,L,2010-11,68,4,16,20,0.29,-2,69,5.8,14,74429.0,18:14,0,0,0,0.0,63,120,24,44,-20,1,3,4,5476.0,1:20,0,0,0,10626.0,2:36,630000
8474134,Yannick,Weber,1988-09-23,D,R,2010-11,41,1,10,11,0.27,0,63,1.59,14,40734.0,16:33,0,0,0,0.0,44,33,8,32,-24,0,5,5,4592.0,1:52,0,0,0,2669.0,1:5,612500
8474137,Drayson,Bowman,1989-03-08,LW,L,2010-11,23,0,1,1,0.04,0,28,0.0,12,13537.0,9:48,0,0,0,0.0,24,9,8,4,4,0,0,0,641.0,0:27,0,0,0,20.0,0:0,658333
8474138,Dustin,Jeffrey,1988-02-27,LW,L,2010-11,25,7,5,12,0.48,5,39,17.95,4,19462.0,12:58,109,138,247,44.13,14,10,9,8,1,1,0,1,2864.0,1:54,0,0,0,566.0,0:22,508333
8474141,Patrick,Kane,1988-11-19,RW,L,2010-11,73,27,46,73,1.0,7,216,12.5,28,84467.0,19:17,2,12,14,14.29,17,17,55,40,15,5,19,24,14208.0,3:14,0,0,0,229.0,0:3,6300000
8474146,Spencer,Machacek,1988-10-14,RW,R,2010-11,10,0,0,0,0.0,-2,7,0.0,0,4608.0,7:40,0,0,0,0.0,22,2,0,0,0,0,0,0,3.0,0:0,0,0,0,14.0,0:1,-111
8474149,Evgenii,Dadonov,1989-03-12,RW,L,2010-11,36,8,9,17,0.47,0,60,13.33,14,30789.0,14:15,1,4,5,20.0,45,11,10,12,-2,1,0,1,1968.0,0:54,0,0,0,6.0,0:0,654167
8474150,Mikael,Backlund,1989-03-17,C,L,2010-11,73,10,15,25,0.34,4,144,6.94,18,52907.0,12:4,319,345,664,48.04,35,19,37,26,11,2,2,4,2691.0,0:36,0,1,1,4085.0,0:55,845833
8474151,Ryan,McDonagh,1989-06-13,D,L,2010-11,40,1,8,9,0.22,16,27,3.7,14,44975.0,18:44,0,0,0,0.0,56,69,18,11,7,0,0,0,278.0,0:6,0,2,2,3630.0,1:30,875000
8474153,Michal,Repik,1988-12-31,RW,R,2010-11,31,2,6,8,0.26,-6,54,3.7,22,23781.0,12:47,3,4,7,42.86,47,8,3,8,-5,0,1,1,1678.0,0:54,0,0,0,51.0,0:1,629167
8474154,Andreas,Thuresson,1987-11-18,RW,R,2010-11,3,0,0,0,0.0,-1,2,0.0,2,1826.0,10:8,0,2,2,0.0,8,0,3,2,1,0,0,0,0.0,0:0,0,0,0,0.0,0:0,-111
8474157,Max,Pacioretty,1988-11-20,LW,L,2010-11,37,14,10,24,0.65,-1,112,12.5,39,35289.0,15:53,0,1,1,0.0,67,13,20,10,10,7,1,8,5408.0,2:26,0,0,0,29.0,0:0,875000
8474161,Jakub,Voracek,1989-08-15,RW,L,2010-11,80,14,32,46,0.57,-3,183,7.65,26,81460.0,16:58,24,41,65,36.92,55,22,38,27,11,2,6,8,14200.0,2:57,0,0,0,129.0,0:1,845833
8474162,Jake,Muzzin,1989-02-21,D,L,2010-11,11,0,1,1,0.09,-2,8,0.0,0,9051.0,13:42,0,0,0,0.0,22,2,2,7,-5,0,0,0,919.0,1:23,0,0,0,3.0,0:0,606667
8474164,Jonathon,Blum,1989-01-30,D,R,2010-11,23,3,5,8,0.35,8,18,16.67,8,24502.0,17:45,0,0,0,0.0,20,36,14,11,3,1,0,1,1920.0,1:23,0,0,0,657.0,0:28,816667
8474166,Alec,Martinez,1987-07-26,D,L,2010-11,60,5,11,16,0.27,11,74,6.76,18,55003.0,15:16,0,0,0,0.0,69,73,4,22,-18,1,4,5,6337.0,1:45,0,0,0,276.0,0:4,637500
8474184,Keaton,Ellerby,1988-11-05,D,L,2010-11,54,2,10,12,0.22,-15,56,3.57,22,52143.0,16:5,0,0,0,0.0,74,68,14,14,0,0,1,1,1277.0,0:23,0,0,0,1820.0,0:33,875000
8474189,Lars,Eller,1989-05-08,C,L,2010-11,77,7,10,17,0.22,-4,79,8.86,48,51452.0,11:8,183,248,431,42.46,85,22,24,25,-1,0,0,0,1324.0,0:17,0,0,0,413.0,0:5,845833
8474190,Wayne,Simmonds,1988-08-26,RW,R,2010-11,80,14,16,30,0.38,-2,117,11.97,75,64584.0,13:27,7,12,19,36.84,125,23,30,44,-14,1,0,1,4055.0,0:50,0,0,0,400.0,0:5,556667
8474192,Matt,Frattin,1988-01-03,RW,R,2010-11,1,0,0,0,0.0,-1,5,0.0,0,934.0,15:34,0,0,0,0.0,1,0,1,1,0,0,0,0,129.0,2:9,0,0,0,0.0,0:0,875000
8474195,Maksim,Mayorov,1989-03-26,LW,L,2010-11,5,1,0,1,0.2,0,3,33.33,0,2610.0,8:42,0,0,0,0.0,4,0,0,0,0,0,0,0,0.0,0:0,0,0,0,28.0,0:5,-111
8474207,Nick,Holden,1987-05-15,D,L,2010-11,5,0,0,0,0.0,0,6,0.0,0,5157.0,17:11,0,0,0,0.0,4,9,0,0,0,0,0,0,1105.0,3:41,0,0,0,159.0,0:31,775000
8474218,Jason,Demers,1988-06-09,D,R,2010-11,75,2,22,24,0.32,19,105,1.9,28,87739.0,19:29,0,0,0,0.0,87,72,30,49,-19,0,6,6,9885.0,2:11,0,0,0,7168.0,1:35,543333
8474220,Jerome,Samson,1987-09-04,RW,R,2010-11,23,0,2,2,0.09,0,28,0.0,0,9454.0,6:51,2,1,3,66.67,13,3,9,1,8,0,0,0,105.0,0:4,0,0,0,0.0,0:0,-111
8474222,Maxim,Noreau,1987-05-24,D,R,2010-11,5,0,0,0,0.0,-1,8,0.0,0,4286.0,14:17,0,0,0,0.0,2,4,3,2,1,0,0,0,958.0,3:11,0,0,0,16.0,0:3,575000
8474230,Micheal,Haley,1986-03-30,C,L,2010-11,27,2,1,3,0.11,-4,13,15.38,85,13004.0,8:1,7,13,20,35.0,55,3,7,4,3,0,0,0,315.0,0:11,0,0,0,236.0,0:8,500000
8474250,Zack,Smith,1988-04-05,LW,L,2010-11,55,4,5,9,0.16,-11,78,5.13,120,41601.0,12:36,209,179,388,53.87,129,27,21,13,8,0,0,0,1432.0,0:26,0,0,0,3436.0,1:2,558333
8474291,Jay,Beagle,1985-10-16,C,R,2010-11,31,2,1,3,0.1,-2,27,7.41,8,19538.0,10:30,58,47,105,55.24,45,8,10,1,9,0,0,0,192.0,0:6,0,0,0,2143.0,1:9,512500
8474498,Jesse,Winchester,1983-10-04,C,R,2010-11,72,4,9,13,0.18,-9,118,3.39,42,46807.0,10:50,303,242,545,55.6,101,27,24,9,15,0,0,0,745.0,0:10,0,0,0,3788.0,0:52,750000
8474518,Davis,Drewiske,1984-11-22,D,L,2010-11,38,0,5,5,0.13,-1,27,0.0,19,32723.0,14:21,0,0,0,0.0,23,61,6,12,-6,0,0,0,685.0,0:18,0,0,0,3867.0,1:41,616667
8474519,Jack,Hillen,1986-01-24,D,L,2010-11,64,4,18,22,0.34,-5,81,4.94,45,72261.0,18:49,0,0,0,0.0,54,137,39,26,13,0,1,1,3022.0,0:47,0,1,1,7376.0,1:55,525000
8474520,Jason,Garrison,1984-11-13,D,L,2010-11,73,5,13,18,0.25,-2,116,4.31,26,97648.0,22:17,0,0,0,0.0,136,127,19,41,-22,0,3,3,6801.0,1:33,0,0,0,13774.0,3:8,675000
8474531,Mike,Moore,1984-12-12,D,L,2010-11,6,1,0,1,0.17,-1,5,20.0,7,3640.0,10:6,0,0,0,0.0,4,2,0,3,-3,0,0,0,15.0,0:2,0,0,0,76.0,0:12,512500
8474535,Chris,Mueller,1986-03-06,C,R,2010-11,15,0,3,3,0.2,0,7,0.0,2,7773.0,8:38,43,46,89,48.31,19,0,6,1,5,0,0,0,89.0,0:5,0,0,0,47.0,0:3,500000
8474551,Ville,Leino,1983-10-06,LW,L,2010-11,81,19,34,53,0.65,14,117,16.24,22,77838.0,16:0,78,58,136,57.35,35,40,39,37,2,5,6,11,11190.0,2:18,0,0,0,44.0,0:0,800000
8474557,Anssi,Salmela,1984-08-13,D,L,2010-11,48,1,6,7,0.15,-11,57,1.75,14,50103.0,17:23,0,0,0,0.0,48,36,14,16,-2,0,0,0,944.0,0:19,0,0,0,642.0,0:13,612500
8474563,Drew,Doughty,1989-12-08,D,R,2010-11,76,11,29,40,0.53,13,139,7.91,68,116932.0,25:38,0,0,0,0.0,137,101,22,77,-55,5,10,15,19040.0,4:10,0,0,0,9304.0,2:2,875000
8474564,Steven,Stamkos,1990-02-07,C,R,2010-11,82,45,46,91,1.11,3,272,16.54,74,99356.0,20:11,431,496,927,46.49,84,37,40,60,-20,17,19,36,22373.0,4:32,0,0,0,1594.0,0:19,875000
8474565,Alex,Pietrangelo,1990-01-18,D,R,2010-11,79,11,32,43,0.54,18,161,6.83,19,104285.0,22:0,0,0,0,0.0,57,121,40,36,4,4,10,14,14241.0,3:0,0,1,1,9397.0,1:58,816667
8474566,Nikita,Filatov,1990-05-25,LW,R,2010-11,23,0,7,7,0.3,3,31,0.0,8,16998.0,12:19,0,0,0,0.0,10,4,4,1,3,0,3,3,3564.0,2:34,0,0,0,0.0,0:0,845833
8474567,Zach,Bogosian,1990-07-15,D,R,2010-11,71,5,12,17,0.24,-27,155,3.23,29,95440.0,22:24,0,0,0,0.0,111,91,33,53,-20,0,4,4,8443.0,1:58,0,0,0,8609.0,2:1,875000
8474568,Luke,Schenn,1989-11-02,D,R,2010-11,82,5,17,22,0.27,-7,128,3.91,34,110057.0,22:22,0,0,0,0.0,251,168,38,95,-57,0,0,0,4839.0,0:59,0,1,1,13469.0,2:44,875000
8474569,Colin,Wilson,1989-10-20,C,L,2010-11,82,16,18,34,0.41,9,101,15.84,17,65407.0,13:17,108,120,228,47.37,38,24,24,41,-17,2,4,6,8270.0,1:40,0,0,0,37.0,0:0,875000
8474570,Cody,Hodgson,1990-02-18,C,R,2010-11,8,1,1,2,0.25,1,9,11.11,0,3716.0,7:44,16,26,42,38.1,4,2,2,1,1,0,0,0,375.0,0:46,0,0,0,0.0,0:0,816667
8474571,Mikkel,Boedker,1989-12-16,LW,L,2010-11,34,4,10,14,0.41,11,39,10.26,8,22239.0,10:54,3,2,5,60.0,42,6,7,3,4,0,2,2,2626.0,1:17,0,0,0,0.0,0:0,875000
8474573,Josh,Bailey,1989-10-02,RW,L,2010-11,70,11,17,28,0.4,-13,102,10.78,37,74904.0,17:50,273,342,615,44.39,47,41,72,44,28,5,4,9,10059.0,2:23,0,3,3,9914.0,2:21,875000
8474574,Tyler,Myers,1990-02-01,D,R,2010-11,80,10,27,37,0.46,0,122,8.2,40,107798.0,22:27,0,0,0,0.0,107,98,41,67,-26,3,11,14,13423.0,2:47,0,0,0,12942.0,2:41,875000
8474576,Zach,Boychuk,1989-10-04,LW,L,2010-11,23,4,3,7,0.3,-2,44,9.09,4,14797.0,10:43,1,4,5,20.0,50,6,5,7,-2,1,0,1,1081.0,0:47,0,0,0,5.0,0:0,845833
8474577,Joe,Colborne,1990-01-30,C,L,2010-11,1,0,1,1,1.0,1,1,0.0,0,1121.0,18:41,3,6,9,33.33,0,1,1,3,-2,0,0,0,263.0,4:23,0,0,0,4.0,0:4,875000
8474578,Erik,Karlsson,1990-05-31,D,R,2010-11,75,13,32,45,0.6,-30,182,7.14,50,105822.0,23:30,0,0,0,0.0,32,74,56,79,-23,4,17,21,16494.0,3:39,0,1,1,6606.0,1:28,875000
8474579,Luca,Sbisa,1990-01-30,D,L,2010-11,68,2,9,11,0.16,-11,76,2.63,43,68523.0,16:47,0,0,0,0.0,170,85,15,28,-13,1,0,1,5304.0,1:18,0,2,2,6245.0,1:31,875000
8474582,Mattias,Tedenby,1990-02-21,RW,L,2010-11,58,8,14,22,0.38,3,87,9.2,14,43652.0,12:32,0,0,0,0.0,24,2,13,31,-18,2,3,5,6500.0,1:52,0,0,0,43.0,0:0,875000
8474584,Michael,Del Zotto,1990-06-24,D,L,2010-11,47,2,9,11,0.23,-5,58,3.45,20,54949.0,19:29,0,0,0,0.0,92,72,16,24,-8,2,5,7,10600.0,3:45,0,0,0,1486.0,0:31,875000
8474586,Jordan,Eberle,1990-05-15,C,R,2010-11,69,18,25,43,0.62,-12,158,11.39,22,73208.0,17:40,11,15,26,42.31,32,17,56,41,15,4,7,11,10555.0,2:32,2,0,2,2801.0,0:40,875000
8474587,Greg,Nemisz,1990-06-05,RW,R,2010-11,6,0,1,1,0.17,-1,5,0.0,0,1834.0,5:5,1,2,3,33.33,1,2,1,1,0,0,0,0,0.0,0:0,0,0,0,0.0,0:0,845833
8474589,Tyler,Ennis,1989-10-06,LW,L,2010-11,82,20,29,49,0.6,0,210,9.52,30,77110.0,15:40,2,7,9,22.22,42,27,45,25,20,5,9,14,11190.0,2:16,0,0,0,192.0,0:2,875000
8474590,John,Carlson,1990-01-10,D,R,2010-11,82,7,30,37,0.45,21,144,4.86,44,111406.0,22:38,0,0,0,0.0,70,160,60,80,-20,1,5,6,10873.0,2:12,0,0,0,11448.0,2:19,845833
8474592,Philip,McRae,1990-03-15,C,L,2010-11,15,1,2,3,0.2,-10,13,7.69,2,8133.0,9:2,34,30,64,53.12,8,5,0,3,-3,0,0,0,205.0,0:13,0,0,0,0.0,0:0,875000
8474601,Yann,Sauve,1990-02-18,D,L,2010-11,5,0,0,0,0.0,-2,6,0.0,0,3900.0,13:0,0,0,0,0.0,9,4,0,4,-4,0,0,0,11.0,0:2,0,0,0,102.0,0:20,670833
8474605,Patrick,Wiercioch,1990-09-12,D,L,2010-11,8,0,2,2,0.25,0,3,0.0,4,6673.0,13:54,0,0,0,0.0,4,2,0,2,-2,0,1,1,490.0,1:1,0,0,0,6.0,0:0,875000
8474609,Luke,Adam,1990-06-18,C,L,2010-11,19,3,1,4,0.21,-6,31,9.68,12,12780.0,11:12,41,78,119,34.45,17,5,2,7,-5,0,1,1,1839.0,1:36,0,0,0,9.0,0:0,737500
8474610,Zac,Dalpe,1989-11-01,C,R,2010-11,15,3,1,4,0.27,0,16,18.75,0,7145.0,7:56,7,19,26,26.92,10,5,5,1,4,0,0,0,82.0,0:5,0,0,0,40.0,0:2,704167
8474611,Cameron,Gaunce,1990-03-19,D,L,2010-11,11,1,0,1,0.09,-3,4,25.0,16,8403.0,12:43,0,0,0,0.0,10,7,1,5,-4,0,0,0,67.0,0:6,0,0,0,971.0,1:28,687500
8474612,Travis,Hamonic,1990-08-16,D,R,2010-11,62,5,21,26,0.42,4,118,4.24,103,80250.0,21:34,0,0,0,0.0,118,118,45,50,-5,1,3,4,7438.0,1:59,0,1,1,8071.0,2:10,875000
8474613,Derek,Stepan,1990-06-18,C,R,2010-11,82,21,24,45,0.55,8,166,12.65,20,80904.0,16:26,277,442,719,38.53,83,26,39,25,14,3,7,10,11644.0,2:22,0,0,0,2213.0,0:26,820833
8474616,Patrice,Cormier,1990-06-14,C,L,2010-11,21,1,1,2,0.1,-5,27,3.7,4,12152.0,9:38,39,28,67,58.21,31,15,6,1,5,0,0,0,277.0,0:13,0,0,0,57.0,0:2,575000
8474618,Marco,Scandella,1990-02-23,D,L,2010-11,20,0,2,2,0.1,-9,13,0.0,2,17963.0,14:58,0,0,0,0.0,20,22,5,10,-5,0,0,0,216.0,0:10,0,0,0,818.0,0:40,643333
8474634,Evgeny,Grachev,1990-02-21,C,R,2010-11,8,0,0,0,0.0,-3,3,0.0,0,3697.0,7:42,0,1,1,0.0,8,0,4,0,4,0,0,0,52.0,0:6,0,0,0,0.0,0:0,675000
8474641,Adam,Henrique,1990-02-06,C,L,2010-11,1,0,0,0,0.0,1,3,0.0,0,801.0,13:21,0,1,1,0.0,0,2,0,0,0,0,0,0,45.0,0:45,0,0,0,0.0,0:0,575000
8474642,Lance,Bouma,1990-03-25,LW,L,2010-11,16,0,1,1,0.06,-1,9,0.0,2,5638.0,5:52,0,3,3,0.0,15,6,2,3,-1,0,0,0,0.0,0:0,0,0,0,0.0,0:0,563333
8474646,Brandon,McMillan,1990-03-22,LW,L,2010-11,60,11,10,21,0.35,-5,77,14.29,18,50662.0,14:4,114,179,293,38.91,53,24,11,19,-8,2,1,3,1433.0,0:23,2,2,4,7322.0,2:2,687500
8474657,Jamie,Arniel,1989-11-16,C,R,2010-11,1,0,0,0,0.0,-1,3,0.0,0,746.0,12:26,0,0,0,0.0,0,0,0,0,0,0,0,0,31.0,0:31,0,0,0,0.0,0:0,-111
8474668,Dale,Weise,1988-08-05,RW,R,2010-11,10,0,0,0,0.0,-1,9,0.0,19,3903.0,6:30,0,0,0,0.0,20,3,2,0,2,0,0,0,70.0,0:7,0,0,0,0.0,0:0,578333
8474673,TJ,Brodie,1990-06-07,D,L,2010-11,3,0,0,0,0.0,-3,1,0.0,2,2881.0,16:0,0,0,0,0.0,2,4,1,2,-1,0,0,0,592.0,3:17,0,0,0,53.0,0:17,566667
8474674,James,Wright,1990-03-24,C,L,2010-11,1,0,0,0,0.0,-2,0,,0,276.0,4:36,0,2,2,0.0,1,0,0,0,0,0,0,0,0.0,0:0,0,0,0,0.0,0:0,646667
8474681,Andrei,Loktionov,1990-05-30,C,L,2010-11,19,4,3,7,0.37,2,26,15.38,2,16827.0,14:45,23,32,55,41.82,6,8,10,9,1,0,1,1,2931.0,2:34,0,0,0,0.0,0:0,604167
8474685,Matt,Calvert,1989-12-24,LW,L,2010-11,42,11,9,20,0.48,3,50,22.0,12,27956.0,11:5,3,6,9,33.33,51,8,7,8,-1,3,1,4,2454.0,0:58,0,0,0,41.0,0:0,712500
8474693,Tomas,Kubalik,1990-05-01,RW,R,2010-11,4,0,2,2,0.5,-3,5,0.0,0,3540.0,14:45,1,0,1,100.0,14,0,2,1,1,0,0,0,562.0,2:20,0,0,0,0.0,0:0,613333
8474705,Mark,Olver,1988-01-01,C,L,2010-11,18,2,7,9,0.5,-2,25,8.0,18,12837.0,11:53,12,13,25,48.0,27,8,9,4,5,0,0,0,1190.0,1:6,0,0,0,9.0,0:0,-111
8474707,Philip,Larsen,1989-12-07,D,R,2010-11,6,0,2,2,0.33,1,11,0.0,0,4836.0,13:26,0,0,0,0.0,1,3,1,1,0,0,0,0,1145.0,3:10,0,0,0,0.0,0:0,635000
8474709,Matt,Martin,1989-05-08,LW,L,2010-11,68,5,9,14,0.21,-13,60,8.33,147,44707.0,10:57,10,17,27,37.04,299,49,25,11,14,0,0,0,894.0,0:13,0,1,1,3231.0,0:47,631667
8474716,Jared,Spurgeon,1989-11-29,D,R,2010-11,53,4,8,12,0.23,-1,38,10.53,2,47929.0,15:4,0,0,0,0.0,37,45,11,15,-4,2,4,6,4689.0,1:28,0,0,0,881.0,0:16,526667
8474719,Teemu,Hartikainen,1990-05-03,C,L,2010-11,12,3,2,5,0.42,-3,21,14.29,4,12535.0,17:24,6,12,18,33.33,19,6,4,5,-1,1,1,2,1860.0,2:35,0,0,0,11.0,0:0,875000
8474727,Ben,Smith,1988-07-11,RW,R,2010-11,6,1,0,1,0.17,1,6,16.67,0,4961.0,13:46,6,2,8,75.0,7,5,3,0,3,0,0,0,126.0,0:21,0,0,0,37.0,0:6,592500
8474730,Jonas,Holos,1987-08-27,D,R,2010-11,39,0,6,6,0.15,-3,36,0.0,10,42242.0,18:3,0,0,0,0.0,19,32,9,17,-8,0,1,1,3836.0,1:38,0,1,1,3530.0,1:30,-111
8474731,Justin,DiBenedetto,1988-08-25,C,L,2010-11,8,0,1,1,0.12,-2,6,0.0,2,4351.0,9:3,0,0,0,0.0,13,3,0,1,-1,0,0,0,161.0,0:20,0,0,0,5.0,0:0,-111
8474739,Tommy,Wingels,1988-04-12,C,R,2010-11,5,0,0,0,0.0,-1,1,0.0,0,1533.0,5:6,1,2,3,33.33,6,1,0,0,0,0,0,0,3.0,0:0,0,0,0,0.0,0:0,687500
8474749,Matt,Bartkowski,1988-06-04,D,L,2010-11,6,0,0,0,0.0,-1,2,0.0,4,3302.0,9:10,0,0,0,0.0,4,2,0,1,-1,0,0,0,65.0,0:10,0,0,0,94.0,0:15,660000
8474762,Stefan,Della Rovere,1990-02-25,LW,L,2010-11,7,0,0,0,0.0,0,4,0.0,11,2557.0,6:5,3,1,4,75.0,10,2,0,1,-1,0,0,0,0.0,0:0,0,0,0,0.0,0:0,-111
8474850,Brandon,Mashinter,1988-09-20,LW,L,2010-11,13,0,0,0,0.0,-2,5,0.0,17,4974.0,6:22,0,0,0,0.0,16,1,2,2,0,0,0,0,152.0,0:11,0,0,0,0.0,0:0,569167
8474892,Eric,Wellwood,1990-03-06,LW,L,2010-11,3,0,1,1,0.33,1,8,0.0,2,2415.0,13:25,0,0,0,0.0,4,1,4,1,3,0,0,0,18.0,0:6,0,0,0,14.0,0:4,-111
8475060,Matt,Taormina,1986-10-20,D,L,2010-11,17,3,2,5,0.29,-2,38,7.89,2,21083.0,20:40,0,0,0,0.0,12,22,7,13,-6,1,0,1,3120.0,3:3,0,0,0,436.0,0:25,510000
8475087,Christian,Hanson,1986-03-10,C,R,2010-11,6,0,0,0,0.0,0,2,0.0,4,3037.0,8:26,7,10,17,41.18,11,0,2,1,1,0,0,0,38.0,0:6,0,0,0,219.0,0:36,-111
8475098,Tyler,Bozak,1986-03-19,C,R,2010-11,82,15,17,32,0.39,-29,120,12.5,14,94861.0,19:16,787,654,1441,54.61,85,48,46,51,-5,6,5,11,14560.0,2:57,1,0,1,8893.0,1:48,875000
8475104,Evan,Oberg,1988-02-16,D,L,2010-11,2,0,0,0,0.0,0,1,0.0,0,1179.0,9:49,0,0,0,0.0,2,1,0,0,0,0,0,0,0.0,0:0,0,0,0,0.0,0:0,-111
8475105,Dan,Sexton,1987-04-29,RW,R,2010-11,47,4,9,13,0.28,-6,78,5.13,4,32687.0,11:35,1,3,4,25.0,29,20,8,12,-4,1,0,1,1091.0,0:23,0,0,0,39.0,0:0,575000
8475118,Matt,Gilroy,1984-07-20,D,R,2010-11,58,3,8,11,0.19,5,75,4.0,14,49335.0,14:10,0,0,0,0.0,39,62,15,15,0,0,1,1,4324.0,1:14,0,0,0,1164.0,0:20,-111
8475149,Marcus,Johansson,1990-10-06,LW,L,2010-11,69,13,14,27,0.39,2,102,12.75,10,60954.0,14:43,271,398,669,40.51,47,22,47,29,18,2,1,3,3953.0,0:57,1,0,1,4891.0,1:10,900000
8475150,Jordan,Caron,1990-11-02,RW,L,2010-11,23,3,4,7,0.3,3,27,11.11,6,17487.0,12:40,1,6,7,14.29,19,11,3,5,-2,0,0,0,111.0,0:4,0,0,0,3081.0,2:13,886667
8475151,Kyle,Palmieri,1991-02-01,RW,R,2010-11,10,1,0,1,0.1,-1,10,10.0,0,5212.0,8:41,0,0,0,0.0,5,1,0,1,-1,0,0,0,7.0,0:0,0,0,0,0.0,0:0,900000
8475158,Ryan,O'Reilly,1991-02-07,C,L,2010-11,74,13,13,26,0.35,-7,119,10.92,16,71294.0,16:3,531,494,1025,51.8,53,31,72,23,49,2,2,4,2782.0,0:37,1,1,2,10688.0,2:24,880000
8475159,Carl,Klingberg,1991-01-28,LW,R,2010-11,1,0,0,0,0.0,0,0,,0,622.0,10:22,0,0,0,0.0,1,0,0,0,0,0,0,0,0.0,0:0,0,0,0,0.0,0:0,790000
8475160,Kyle,Clifford,1991-01-13,LW,L,2010-11,76,7,7,14,0.18,-10,69,10.14,141,43341.0,9:30,8,7,15,53.33,138,17,10,22,-12,0,0,0,127.0,0:1,0,0,0,15.0,0:0,710000
8475166,John,Tavares,1990-09-20,C,L,2010-11,79,29,38,67,0.85,-16,243,11.93,53,91245.0,19:15,693,626,1319,52.54,22,23,75,51,24,9,15,24,16595.0,3:30,0,0,0,797.0,0:10,900000
8475167,Victor,Hedman,1990-12-18,D,L,2010-11,79,3,23,26,0.33,3,101,2.97,70,99582.0,21:0,0,0,0,0.0,54,85,48,64,-16,0,3,3,7784.0,1:38,0,0,0,9640.0,2:2,900000
8475168,Matt,Duchene,1991-01-16,C,L,2010-11,80,27,40,67,0.84,-8,202,13.37,33,90935.0,18:56,628,618,1246,50.4,57,48,65,52,13,3,12,15,13677.0,2:50,0,0,0,349.0,0:4,900000
8475169,Evander,Kane,1991-08-02,LW,L,2010-11,73,19,24,43,0.59,-12,234,8.12,68,78237.0,17:51,26,38,64,40.62,154,32,53,39,14,4,4,8,10133.0,2:18,0,0,0,3661.0,0:50,900000
8475170,Brayden,Schenn,1991-08-22,C,L,2010-11,8,0,2,2,0.25,-1,11,0.0,0,5399.0,11:14,17,34,51,33.33,12,1,0,2,-2,0,0,0,759.0,1:34,0,0,0,63.0,0:7,900000
8475171,Oliver,Ekman-Larsson,1991-07-17,D,L,2010-11,48,1,10,11,0.23,3,50,2.0,24,43302.0,15:2,0,0,0,0.0,41,31,3,13,-10,0,2,2,2857.0,0:59,0,0,0,2666.0,0:55,900000
8475172,Nazem,Kadri,1990-10-06,C,L,2010-11,29,3,9,12,0.41,-3,51,5.88,8,27449.0,15:46,49,72,121,40.5,16,6,15,26,-11,0,2,2,4498.0,2:35,0,0,0,9.0,0:0,870000
8475175,Magnus,Paajarvi,1991-04-12,LW,L,2010-11,80,15,19,34,0.42,-13,180,8.33,16,73865.0,15:23,1,4,5,20.0,22,25,25,35,-10,3,6,9,8838.0,1:50,0,0,0,127.0,0:1,900000
8475179,Dmitry,Kulikov,1990-10-29,D,L,2010-11,72,6,20,26,0.36,-5,83,7.23,45,86186.0,19:57,0,0,0,0.0,107,79,18,38,-20,1,4,5,11279.0,2:36,0,0,0,3771.0,0:52,900000
8475181,Nick,Leddy,1991-03-20,D,L,2010-11,46,4,3,7,0.15,-3,37,10.81,4,39502.0,14:18,0,0,0,0.0,26,46,10,15,-5,0,1,1,564.0,0:12,0,0,0,872.0,0:18,900000
8475185,Jacob,Josefson,1991-03-02,C,L,2010-11,28,3,7,10,0.36,5,31,9.68,6,22238.0,13:14,95,107,202,47.03,8,8,8,7,1,0,3,3,2946.0,1:45,0,0,0,34.0,0:1,900000
8475186,John,Moore,1990-11-19,D,L,2010-11,2,0,0,0,0.0,0,0,,0,1377.0,11:28,0,0,0,0.0,1,2,0,0,0,0,0,0,71.0,0:35,0,0,0,0.0,0:0,870000
8475193,Tomas,Tatar,1990-12-01,LW,L,2010-11,9,1,0,1,0.11,0,6,16.67,0,5185.0,9:36,0,0,0,0.0,7,0,2,2,0,0,0,0,61.0,0:6,0,0,0,0.0,0:0,660000
8475204,Brandon,Pirri,1991-04-10,RW,L,2010-11,1,0,0,0,0.0,-1,1,0.0,0,536.0,8:56,2,4,6,33.33,0,1,0,0,0,0,0,0,0.0,0:0,0,0,0,0.0,0:0,648333
8475214,Jeremy,Morin,1991-04-16,LW,R,2010-11,9,2,1,3,0.33,2,13,15.38,9,6532.0,12:5,0,0,0,0.0,12,2,3,3,0,0,1,1,1058.0,1:57,0,0,0,0.0,0:0,765000
8475248,Alexander,Urbom,1990-12-20,D,L,2010-11,8,1,0,1,0.12,-2,5,20.0,0,6038.0,12:34,0,0,0,0.0,5,6,1,5,-4,0,0,0,89.0,0:11,0,0,0,138.0,0:17,576667
8475266,Tomas,Vincour,1990-11-19,C,R,2010-11,24,1,1,2,0.08,-5,26,3.85,4,13575.0,9:25,3,1,4,75.0,36,11,4,3,1,0,0,0,206.0,0:8,0,0,0,10.0,0:0,621667
8475304,Scott,Timmins,1989-09-11,C,L,2010-11,19,1,0,1,0.05,-8,13,7.69,8,12332.0,10:49,61,69,130,46.92,18,11,7,4,3,0,0,0,20.0,0:1,0,0,0,2201.0,1:55,581667
8475323,Marcus,Kruger,1990-05-27,C,L,2010-11,7,0,0,0,0.0,-4,7,0.0,4,5023.0,11:57,14,25,39,35.9,4,2,3,3,0,0,0,0,39.0,0:5,0,0,0,364.0,0:52,735000
8475372,Andreas,Engqvist,1987-12-23,C,R,2010-11,3,0,0,0,0.0,0,1,0.0,0,1577.0,8:45,7,12,19,36.84,2,3,1,0,1,0,0,0,0.0,0:0,0,0,0,246.0,1:22,-111
8475602,Casey,Wellman,1987-10-18,C,R,2010-11,15,1,1,2,0.13,-1,20,5.0,4,9579.0,10:38,8,8,16,50.0,5,3,3,3,0,0,0,0,871.0,0:58,0,0,0,75.0,0:5,900000
8475603,Ben,Holmstrom,1987-04-09,C,R,2010-11,2,0,0,0,0.0,-1,0,,5,1089.0,9:4,5,11,16,31.25,8,0,1,0,1,0,0,0,12.0,0:6,0,0,0,314.0,2:37,600000
8475613,Nate,Prosser,1986-05-07,D,R,2010-11,2,0,0,0,0.0,0,1,0.0,0,1776.0,14:48,0,0,0,0.0,0,2,0,0,0,0,0,0,8.0,0:4,0,0,0,0.0,0:0,650000
8475619,Aaron,Volpatti,1985-05-30,LW,L,2010-11,15,1,1,2,0.13,-1,6,16.67,16,6148.0,6:49,0,0,0,0.0,36,3,0,0,0,0,0,0,286.0,0:19,0,0,0,1.0,0:0,612500
8475637,Bobby,Butler,1987-04-26,RW,R,2010-11,36,10,11,21,0.58,-16,73,13.7,10,33327.0,15:25,0,2,2,0.0,28,15,9,13,-4,1,4,5,4775.0,2:12,0,0,0,33.0,0:0,900000
8475640,Erik,Gustafsson,1988-12-15,D,L,2010-11,3,0,0,0,0.0,-1,2,0.0,4,1972.0,10:57,0,0,0,0.0,0,1,1,1,0,0,0,0,41.0,0:13,0,0,0,0.0,0:0,-111
8475641,Brendon,Nash,1987-03-31,D,L,2010-11,2,0,0,0,0.0,-1,2,0.0,0,1223.0,10:11,0,0,0,0.0,1,6,0,1,-1,0,0,0,0.0,0:0,0,0,0,0.0,0:0,-111
8475677,Linus,Klasen,1986-02-19,LW,L,2010-11,4,0,0,0,0.0,-3,4,0.0,0,3093.0,12:53,0,0,0,0.0,1,1,0,1,-1,0,0,0,284.0,1:11,0,0,0,0.0,0:0,-111
8475690,Christopher,Tanev,1989-12-20,D,R,2010-11,29,0,1,1,0.03,0,15,0.0,0,23996.0,13:47,0,0,0,0.0,10,32,10,8,2,0,1,1,116.0,0:4,0,0,0,990.0,0:34,900000
8475692,Mats,Zuccarello,1987-09-01,RW,L,2010-11,42,6,17,23,0.55,3,74,8.11,4,35714.0,14:10,8,7,15,53.33,56,19,16,6,10,0,9,9,6402.0,2:32,0,0,0,2.0,0:0,900000
8475764,Cam,Fowler,1991-12-05,D,L,2010-11,76,10,30,40,0.53,-25,123,8.13,20,100913.0,22:7,0,0,0,0.0,45,93,23,41,-18,6,17,23,16553.0,3:37,0,0,0,1689.0,0:22,900000
8475784,Jeff,Skinner,1992-05-16,LW,L,2010-11,82,31,32,63,0.77,3,215,14.42,46,82319.0,16:43,58,99,157,36.94,70,28,63,31,32,6,12,18,15615.0,3:10,0,0,0,152.0,0:1,900000
8475788,Alexander,Burmistrov,1991-10-21,C,L,2010-11,74,6,14,20,0.27,-12,92,6.52,27,58684.0,13:13,289,407,696,41.52,62,22,48,34,14,0,0,0,1366.0,0:18,0,1,1,5081.0,1:8,900000
8475791,Taylor,Hall,1991-11-14,LW,L,2010-11,65,22,20,42,0.65,-9,186,11.83,27,71018.0,18:12,42,63,105,40.0,48,37,45,45,0,8,3,11,10648.0,2:43,0,0,0,126.0,0:1,900000
8475794,Tyler,Seguin,1992-01-31,C,R,2010-11,74,11,11,22,0.3,-4,131,8.4,18,54212.0,12:12,150,153,303,49.5,20,21,22,24,-2,1,2,3,6049.0,1:21,0,0,0,118.0,0:1,900000
8475799,Nino,Niederreiter,1992-09-08,RW,L,2010-11,9,1,1,2,0.22,-1,12,8.33,8,7340.0,13:35,0,0,0,0.0,16,1,5,5,0,0,0,0,498.0,0:55,0,0,0,11.0,0:1,900000
8475950,Marcel,Mueller,1988-07-10,C,L,2010-11,3,0,0,0,0.0,0,5,0.0,2,1822.0,10:7,0,1,1,0.0,7,0,0,0,0,0,0,0,19.0,0:6,0,0,0,0.0,0:0,-111
8475990,Jamie,Doornbosch,1990-02-01,D,L,2010-11,1,0,0,0,0.0,-1,1,0.0,0,321.0,5:21,0,0,0,0.0,1,0,2,0,2,0,0,0,0.0,0:0,0,0,0,48.0,0:48,-111
8476205,Stephane,Da Costa,1989-07-11,C,R,2010-11,4,0,0,0,0.0,-1,9,0.0,0,2739.0,11:24,6,15,21,28.57,3,0,7,1,6,0,0,0,260.0,1:5,0,0,0,0.0,0:0,900000
8476208,Matt,Campanale,1988-02-14,D,L,2010-11,1,0,0,0,0.0,0,0,,2,501.0,8:21,0,0,0,0.0,0,0,0,0,0,0,0,0,0.0,0:0,0,0,0,0.0,0:0,-111
