player_id,firstName,lastName,birthDate,primaryPosition,shootsCatches,season,gamesPlayed,goals,assists,points,pointsPerGame,plusMinus,shots,shootingPercentage,penaltyMinutes,timeOnIce,avgTimeOnIce,faceOffWins,faceOffLosses,faceOffTaken,faceOffPercentage,hits,blocks,takeaways,giveaways,turnoverDifferential,powerPlayGoals,powerPlayAssists,powerPlayPoints,powerPlayTimeOnIce,avgPowerPlayTimeOnIce,shortHandedGoals,shortHandedAssists,shortHandedPoints,shortHandedTimeOnIce,avgShortHandedTimeOnIce,salary
8448208,Jaromir,Jagr,1972-02-15,RW,L,2011-12,73,19,35,54,0.74,5,170,11.18,30,71569.0,16:20,0,1,1,0.0,14,12,22,43,-21,8,12,20,14260.0,3:15,0,0,0,70.0,0:0,3300000
8457063,Nicklas,Lidstrom,1970-04-28,D,L,2011-12,70,11,23,34,0.49,21,148,7.43,28,99837.0,23:46,0,0,0,0.0,41,79,27,23,4,4,13,17,15513.0,3:41,0,0,0,7127.0,1:41,6200000
8457981,Teemu,Selanne,1970-07-03,RW,R,2011-12,82,26,40,66,0.8,-1,210,12.38,50,87980.0,17:52,145,155,300,48.33,23,20,29,46,-17,12,16,28,17584.0,3:34,0,0,0,276.0,0:3,4000000
8458525,Brian,Rolston,1973-02-21,RW,L,2011-12,70,7,17,24,0.34,-5,151,4.64,14,59978.0,14:16,37,40,77,48.05,86,21,18,23,-5,1,3,4,7917.0,1:53,0,0,0,2254.0,0:32,5062500
8458537,Ray,Whitney,1972-05-08,LW,R,2011-12,82,24,53,77,0.94,26,185,12.97,28,91738.0,18:38,4,11,15,26.67,28,10,34,39,-5,8,12,20,18581.0,3:46,0,0,0,120.0,0:1,3000000
8458541,Steve,Staios,1973-07-28,D,R,2011-12,65,0,8,8,0.12,-19,67,0.0,53,66603.0,17:4,1,0,1,100.0,55,140,28,32,-4,0,0,0,219.0,0:3,0,0,0,6602.0,1:41,-111
8458590,Mike,Knuble,1972-07-04,RW,R,2011-12,72,6,12,18,0.25,-15,91,6.59,32,60231.0,13:56,14,13,27,51.85,86,45,25,15,10,0,4,4,4936.0,1:8,0,0,0,4972.0,1:9,-111
8458637,Sean,O'Donnell,1971-10-13,D,L,2011-12,51,0,7,7,0.14,-6,30,0.0,23,41346.0,13:30,0,0,0,0.0,46,44,11,32,-21,0,0,0,46.0,0:0,0,0,0,4336.0,1:25,-111
8458938,Roman,Hamrlik,1974-04-12,D,L,2011-12,68,2,11,13,0.19,11,58,3.45,34,78410.0,19:13,0,0,0,0.0,69,149,26,43,-17,0,0,0,1785.0,0:26,0,0,0,7026.0,1:43,-111
8458951,Sergei,Gonchar,1974-04-13,D,L,2011-12,74,5,32,37,0.5,-4,131,3.82,55,98803.0,22:15,0,0,0,0.0,48,115,22,51,-29,2,12,14,13782.0,3:6,0,1,1,8124.0,1:49,5500000
8459053,Adrian,Aucoin,1973-07-03,D,R,2011-12,64,2,7,9,0.14,14,92,2.17,42,77752.0,20:14,0,0,0,0.0,97,67,26,17,9,1,0,1,1907.0,0:29,0,0,0,8098.0,2:6,-111
8459424,Chris,Pronger,1974-10-10,D,L,2011-12,13,1,11,12,0.92,1,23,4.35,10,17531.0,22:28,0,0,0,0.0,15,27,7,7,0,1,7,8,3115.0,3:59,0,0,0,3712.0,4:45,4935714
8459429,Jason,Arnott,1974-10-11,C,R,2011-12,72,17,17,34,0.47,13,142,11.97,26,60867.0,14:5,387,382,769,50.33,24,13,17,11,6,6,8,14,10213.0,2:21,0,0,0,44.0,0:0,2500000
8459442,Saku,Koivu,1974-11-23,C,L,2011-12,74,11,27,38,0.51,7,107,10.28,50,80478.0,18:7,646,587,1233,52.39,56,24,35,40,-5,0,6,6,9356.0,2:6,0,0,0,7433.0,1:40,-111
8459444,Todd,Bertuzzi,1975-02-02,RW,L,2011-12,71,14,24,38,0.54,23,118,11.86,64,66253.0,15:33,5,8,13,38.46,96,23,21,40,-19,0,4,4,7223.0,1:41,0,0,0,34.0,0:0,1937500
8459454,Jay,Pandolfo,1974-12-27,LW,L,2011-12,62,1,2,3,0.05,-14,44,2.27,8,40632.0,10:55,61,75,136,44.85,48,69,14,10,4,0,0,0,172.0,0:2,0,1,1,6590.0,1:46,600000
8459457,Jamie,Langenbrunner,1975-07-24,RW,R,2011-12,70,6,18,24,0.34,7,127,4.72,32,61384.0,14:36,10,17,27,37.04,70,19,15,10,5,0,0,0,3690.0,0:52,0,0,0,4569.0,1:5,2500000
8459461,Brendan,Morrison,1975-08-15,C,L,2011-12,39,4,7,11,0.28,-5,43,9.3,12,31246.0,13:21,195,199,394,49.49,8,21,24,18,6,0,2,2,2768.0,1:10,0,0,0,610.0,0:15,-111
8459492,Vinny,Prospal,1975-02-17,LW,L,2011-12,82,16,39,55,0.67,-11,165,9.7,36,88003.0,17:53,9,13,22,40.91,59,39,53,17,36,3,12,15,16187.0,3:17,0,0,0,226.0,0:2,-111
8459514,Jamal,Mayers,1974-10-24,RW,R,2011-12,81,6,9,15,0.19,-4,70,8.57,91,47635.0,9:48,313,245,558,56.09,102,25,23,17,6,0,1,1,1410.0,0:17,0,0,0,6481.0,1:20,550000
8459596,Andrew,Brunette,1973-08-24,LW,L,2011-12,78,12,15,27,0.35,-13,75,16.0,4,63412.0,13:32,7,7,14,50.0,21,15,16,15,1,4,3,7,10412.0,2:13,0,0,0,56.0,0:0,-111
8459628,Hal,Gill,1975-04-06,D,L,2011-12,76,1,12,13,0.17,-3,49,2.04,37,78141.0,17:8,0,0,0,0.0,75,161,20,62,-42,0,0,0,85.0,0:1,0,2,2,15827.0,3:28,2250000
8459670,Kimmo,Timonen,1975-03-18,D,L,2011-12,76,4,39,43,0.57,8,130,3.08,46,96846.0,21:14,1,0,1,100.0,68,129,14,35,-21,4,17,21,17275.0,3:47,0,0,0,15872.0,3:28,6333333
8459687,Scott,Nichol,1974-12-31,C,R,2011-12,80,3,5,8,0.1,-5,67,4.48,83,44690.0,9:18,259,191,450,57.56,92,29,14,5,9,0,0,0,146.0,0:1,0,1,1,8138.0,1:41,-111
8460465,Petr,Sykora,1976-11-19,RW,L,2011-12,82,21,23,44,0.54,4,170,12.35,40,78260.0,15:54,10,8,18,55.56,19,16,27,36,-9,4,2,6,9707.0,1:58,0,0,0,54.0,0:0,-111
8460492,Ed,Jovanovski,1976-06-26,D,L,2011-12,66,3,10,13,0.2,-11,58,5.17,31,66111.0,16:41,0,0,0,0.0,71,73,15,38,-23,1,3,4,6718.0,1:41,0,0,0,6106.0,1:32,4125000
8460496,Ryan,Smyth,1976-02-21,LW,L,2011-12,82,19,27,46,0.56,-5,194,9.79,82,93885.0,19:4,66,84,150,44.0,53,31,54,51,3,4,4,8,12188.0,2:28,0,0,0,10617.0,2:9,6250000
8460504,Ethan,Moreau,1975-09-22,LW,L,2011-12,28,1,3,4,0.14,-3,29,3.45,20,17686.0,10:31,2,3,5,40.0,53,6,2,5,-3,0,0,0,539.0,0:19,0,0,0,830.0,0:29,-111
8460541,Richard,Park,1976-05-27,RW,R,2011-12,54,7,7,14,0.26,-1,44,15.91,12,35361.0,10:54,221,176,397,55.67,28,18,9,6,3,0,2,2,997.0,0:18,1,0,1,2192.0,0:40,-111
8460542,Patrik,Elias,1976-04-13,C,L,2011-12,81,26,52,78,0.96,-8,164,15.85,16,96486.0,19:51,604,765,1369,44.12,61,26,32,50,-18,8,21,29,16894.0,3:28,2,2,4,8620.0,1:46,6000000
8460561,Sheldon,Souray,1976-07-13,D,L,2011-12,64,6,15,21,0.33,11,179,3.35,73,78577.0,20:27,0,0,0,0.0,55,90,23,33,-10,2,4,6,6970.0,1:48,1,0,1,9235.0,2:24,5400000
8460577,Milan,Hejduk,1976-02-14,RW,R,2011-12,81,14,23,37,0.46,-12,170,8.24,14,82683.0,17:0,2,6,8,25.0,35,29,30,24,6,6,8,14,11397.0,2:20,0,0,0,299.0,0:3,-111
8460621,Daniel,Alfredsson,1972-12-11,RW,R,2011-12,75,27,32,59,0.79,16,191,14.14,18,85249.0,18:56,20,26,46,43.48,52,31,50,58,-8,7,7,14,13367.0,2:58,3,1,4,5826.0,1:17,4875000
8460626,Bryce,Salvador,1976-02-11,D,L,2011-12,82,0,9,9,0.11,18,52,0.0,66,99440.0,20:12,0,0,0,0.0,106,107,20,44,-24,0,0,0,188.0,0:2,0,1,1,15168.0,3:4,2900000
8460719,Steve,Sullivan,1974-07-06,LW,R,2011-12,79,17,31,48,0.61,-3,140,12.14,20,72802.0,15:21,4,5,9,44.44,38,16,17,22,-5,5,16,21,17279.0,3:38,0,0,0,3.0,0:0,1500000
8460720,Eric,Boulton,1976-08-17,LW,L,2011-12,51,0,0,0,0.0,-12,25,0.0,115,20150.0,6:35,1,2,3,33.33,89,10,1,6,-5,0,0,0,61.0,0:1,0,0,0,61.0,0:1,662500
8460743,Tomas,Holmstrom,1973-01-23,LW,L,2011-12,74,11,13,24,0.32,-9,97,11.34,40,52717.0,11:52,1,0,1,100.0,56,6,16,28,-12,10,5,15,13580.0,3:3,0,0,0,35.0,0:0,-111
8462036,Daymond,Langkow,1976-09-27,C,L,2011-12,73,11,19,30,0.41,-4,112,9.82,14,68989.0,15:45,440,551,991,44.4,87,50,34,21,13,1,2,3,6434.0,1:28,0,1,1,4224.0,0:57,-111
8462038,Shane,Doan,1976-10-10,RW,R,2011-12,79,22,28,50,0.63,-8,226,9.73,48,92907.0,19:36,33,26,59,55.93,205,27,48,30,18,5,9,14,15140.0,3:11,0,1,1,4178.0,0:52,4550000
8462041,Radek,Dvorak,1977-03-09,RW,R,2011-12,73,4,17,21,0.29,-16,83,4.82,12,62530.0,14:16,10,15,25,40.0,51,56,42,22,20,0,0,0,415.0,0:5,1,0,1,7971.0,1:49,-111
8462042,Jarome,Iginla,1977-07-01,RW,R,2011-12,82,32,35,67,0.82,-10,251,12.75,43,101390.0,20:36,214,212,426,50.23,124,43,52,58,-6,8,11,19,16408.0,3:20,0,0,0,97.0,0:1,7000000
8462077,Jochen,Hecht,1977-06-21,C,L,2011-12,22,4,4,8,0.36,1,40,10.0,6,22216.0,16:49,136,164,300,45.33,14,9,11,14,-3,0,0,0,757.0,0:34,1,0,1,2419.0,1:49,-111
8462129,Michal,Handzus,1977-03-11,C,L,2011-12,67,7,17,24,0.36,-6,81,8.64,18,58097.0,14:27,413,402,815,50.67,52,59,28,24,4,2,3,5,4394.0,1:5,0,0,0,5490.0,1:21,2500000
8462196,Stephane,Robidas,1977-03-03,D,R,2011-12,75,5,17,22,0.29,-5,75,6.67,48,102429.0,22:45,0,0,0,0.0,191,110,23,25,-2,2,7,9,11659.0,2:35,0,0,0,13248.0,2:56,3300000
8462225,Filip,Kuba,1976-12-29,D,L,2011-12,73,6,26,32,0.44,26,78,7.69,26,103428.0,23:36,0,0,0,0.0,53,149,23,66,-43,3,8,11,8666.0,1:58,0,2,2,14839.0,3:23,3700000
8462535,Jody,Shelley,1976-02-07,LW,L,2011-12,30,0,1,1,0.03,-6,19,0.0,64,10178.0,5:39,0,2,2,0.0,49,6,4,2,2,0,0,0,222.0,0:7,0,0,0,1.0,0:0,1100000
8464956,Chris,Phillips,1978-03-09,D,L,2011-12,80,5,14,19,0.24,12,85,5.88,16,91721.0,19:6,0,0,0,0.0,134,137,18,50,-32,4,0,4,2911.0,0:36,0,2,2,14623.0,3:2,3083333
8464966,Derek,Morris,1978-08-24,D,R,2011-12,59,2,9,11,0.19,-12,72,2.78,38,67221.0,18:59,0,0,0,0.0,95,78,12,20,-8,0,1,1,1639.0,0:27,0,0,0,9345.0,2:38,2750000
8464967,Marty,Reasoner,1977-02-26,C,L,2011-12,61,1,5,6,0.1,-25,69,1.45,34,42491.0,11:36,303,269,572,52.97,43,31,25,15,10,0,0,0,277.0,0:4,0,0,0,4805.0,1:18,1350000
8464975,Daniel,Briere,1977-10-06,C,R,2011-12,70,16,33,49,0.7,5,174,9.2,69,72911.0,17:21,406,425,831,48.86,48,16,18,32,-14,4,13,17,13507.0,3:12,0,0,0,240.0,0:3,6500000
8464977,Dainius,Zubrus,1978-06-16,C,L,2011-12,82,17,27,44,0.54,7,109,15.6,34,91947.0,18:41,191,250,441,43.31,102,41,34,23,11,4,2,6,8860.0,1:48,3,2,5,9912.0,2:0,3400000
8464979,Marco,Sturm,1978-09-08,LW,L,2011-12,48,3,2,5,0.1,-13,65,4.62,25,35466.0,12:18,9,4,13,69.23,49,14,12,12,0,0,0,0,2516.0,0:52,0,0,0,3009.0,1:2,-111
8464981,Cory,Sarich,1978-08-16,D,R,2011-12,62,1,6,7,0.11,1,36,2.78,66,59924.0,16:6,0,0,0,0.0,144,60,9,33,-24,0,0,0,243.0,0:3,0,0,0,3297.0,0:53,-111
8464984,Josh,Green,1977-11-16,C,L,2011-12,7,1,1,2,0.29,-6,14,7.14,7,4964.0,11:49,16,21,37,43.24,4,2,3,1,2,1,0,1,441.0,1:3,0,0,0,174.0,0:24,-111
8464989,Matt,Cullen,1976-11-02,C,L,2011-12,73,14,21,35,0.48,-10,164,8.54,24,82929.0,18:56,627,551,1178,53.23,46,39,37,31,6,4,5,9,11747.0,2:40,0,0,0,7833.0,1:47,3500000
8465005,Colin,White,1977-12-12,D,L,2011-12,54,1,3,4,0.07,-5,33,3.03,21,48430.0,14:56,0,0,0,0.0,65,94,10,25,-15,0,0,0,168.0,0:3,0,0,0,5258.0,1:37,-111
8465009,Zdeno,Chara,1977-03-18,D,L,2011-12,79,12,40,52,0.66,33,224,5.36,86,118524.0,25:0,0,1,1,0.0,166,87,28,68,-40,8,10,18,12604.0,2:39,0,1,1,12888.0,2:43,6916667
8465025,Arron,Asham,1978-04-13,RW,R,2011-12,64,5,11,16,0.25,-5,49,10.2,76,35465.0,9:14,6,5,11,54.55,95,8,13,3,10,0,0,0,225.0,0:3,0,0,0,0.0,0:0,-111
8465042,Toni,Lydman,1977-09-25,D,L,2011-12,74,0,13,13,0.18,0,46,0.0,46,83921.0,18:54,0,0,0,0.0,134,153,13,35,-22,0,0,0,177.0,0:2,0,1,1,13869.0,3:7,3000000
8465050,Eric,Belanger,1977-12-16,C,L,2011-12,78,4,12,16,0.21,-13,118,3.39,32,68954.0,14:44,557,450,1007,55.31,36,41,50,38,12,1,4,5,5019.0,1:4,1,0,1,11546.0,2:28,1750000
8465056,Trent,Whitfield,1977-06-17,C,L,2011-12,1,0,0,0,0.0,0,1,0.0,0,839.0,13:59,0,0,0,0.0,2,3,0,0,0,0,0,0,0.0,0:0,0,0,0,127.0,2:7,-111
8465058,Michal,Rozsival,1978-09-03,D,R,2011-12,54,1,12,13,0.24,8,49,2.04,34,62627.0,19:19,0,0,0,0.0,62,91,13,16,-3,0,0,0,243.0,0:4,0,0,0,6116.0,1:53,5000000
8465059,Matt,Bradley,1978-06-13,RW,R,2011-12,45,3,5,8,0.18,-3,35,8.57,31,29359.0,10:52,12,16,28,42.86,134,11,7,2,5,0,0,0,371.0,0:8,0,0,0,1098.0,0:24,950000
8465122,Brett,Clark,1976-12-23,D,L,2011-12,82,2,13,15,0.18,-26,61,3.28,20,90408.0,18:22,0,0,0,0.0,118,199,26,43,-17,0,2,2,7042.0,1:25,0,0,0,10184.0,2:4,-111
8465166,Craig,Adams,1977-04-26,RW,R,2011-12,82,5,13,18,0.22,-6,76,6.58,34,55521.0,11:17,132,160,292,45.21,162,45,13,7,6,0,0,0,68.0,0:0,0,3,3,14093.0,2:51,675000
8465185,Willie,Mitchell,1977-04-23,D,L,2011-12,76,5,19,24,0.32,20,104,4.81,44,101366.0,22:13,0,1,1,0.0,74,139,21,55,-34,0,5,5,3256.0,0:42,0,3,3,16353.0,3:35,3500000
8465192,Samuel,Pahlsson,1977-12-17,C,L,2011-12,80,4,13,17,0.21,-2,93,4.3,34,70913.0,14:46,540,486,1026,52.63,123,37,44,14,30,0,0,0,502.0,0:6,1,1,2,10385.0,2:9,2650000
8465200,Tomas,Kaberle,1978-03-02,D,L,2011-12,72,3,28,31,0.43,-18,87,3.45,12,76550.0,17:43,0,0,0,0.0,21,80,18,38,-20,1,15,16,16371.0,3:47,0,0,0,456.0,0:6,4250000
8465202,Sami,Salo,1974-09-02,D,R,2011-12,69,9,16,25,0.36,7,136,6.62,10,84654.0,20:26,0,0,0,0.0,29,77,23,35,-12,7,7,14,11403.0,2:45,0,0,0,9627.0,2:19,2000000
8465210,Pavel,Kubina,1977-04-15,D,R,2011-12,69,3,12,15,0.22,-2,75,4.0,74,79783.0,19:16,0,0,0,0.0,130,119,18,26,-8,0,0,0,4643.0,1:7,0,0,0,7126.0,1:43,3850000
8465914,Francis,Bouillon,1975-10-17,D,L,2011-12,66,4,7,11,0.17,-4,38,10.53,33,69482.0,17:32,0,0,0,0.0,103,65,23,29,-6,0,0,0,1273.0,0:19,0,0,0,3016.0,0:45,1350000
8465951,Matt,Cooke,1978-09-07,LW,L,2011-12,82,19,19,38,0.46,5,147,12.93,44,77145.0,15:40,18,15,33,54.55,160,41,37,23,14,1,5,6,5833.0,1:11,2,2,4,12509.0,2:32,1800000
8465978,Shawn,Thornton,1977-07-23,LW,R,2011-12,81,5,8,13,0.16,-7,114,4.39,154,44629.0,9:10,16,22,38,42.11,91,12,19,6,13,0,0,0,290.0,0:3,1,0,1,100.0,0:1,812500
8466138,Joe,Thornton,1979-07-02,C,L,2011-12,82,18,59,77,0.94,17,156,11.54,31,100709.0,20:28,557,436,993,56.09,42,26,96,95,1,4,19,23,16645.0,3:22,0,1,1,5192.0,1:3,7000000
8466139,Patrick,Marleau,1979-09-15,C,L,2011-12,82,30,34,64,0.78,10,251,11.95,26,100766.0,20:28,243,224,467,52.03,84,33,38,45,-7,10,15,25,15678.0,3:11,0,0,0,7271.0,1:28,6900000
8466140,Olli,Jokinen,1978-12-05,C,L,2011-12,82,23,38,61,0.74,-12,223,10.31,54,93284.0,18:57,620,713,1333,46.51,53,31,55,60,-5,9,15,24,15260.0,3:6,0,0,0,2012.0,0:24,3000000
8466142,Eric,Brewer,1979-04-17,D,L,2011-12,82,1,20,21,0.26,-5,83,1.2,49,114479.0,23:16,0,0,0,0.0,197,176,26,37,-11,0,3,3,5473.0,1:6,0,1,1,15919.0,3:14,3875000
8466148,Marian,Hossa,1979-01-12,RW,L,2011-12,81,29,48,77,0.95,18,248,11.69,20,97028.0,19:57,3,6,9,33.33,73,40,94,29,65,9,11,20,15368.0,3:9,2,1,3,8733.0,1:47,5275000
8466149,Daniel,Cleary,1978-12-18,RW,L,2011-12,75,12,21,33,0.44,2,199,6.03,30,71918.0,15:58,21,30,51,41.18,90,33,27,27,0,2,1,3,5990.0,1:19,0,0,0,7727.0,1:43,2800000
8466158,Scott,Hannan,1979-01-23,D,L,2011-12,78,2,10,12,0.15,-10,49,4.08,38,95264.0,20:21,1,0,1,100.0,60,126,13,39,-26,0,0,0,352.0,0:4,0,1,1,13329.0,2:50,1000000
8466160,Brenden,Morrow,1979-01-16,LW,L,2011-12,57,11,15,26,0.46,1,88,12.5,97,58272.0,17:2,11,16,27,40.74,130,33,18,41,-23,5,2,7,8502.0,2:29,0,0,0,1366.0,0:23,4100000
8466181,Kristian,Huselius,1978-11-10,LW,L,2011-12,2,0,0,0,0.0,-2,2,0.0,2,1944.0,16:12,0,0,0,0.0,0,0,1,0,1,0,0,0,489.0,4:4,0,0,0,0.0,0:0,-111
8466182,Henrik,Tallinder,1979-01-10,D,L,2011-12,39,0,6,6,0.15,-11,43,0.0,16,49864.0,21:18,0,0,0,0.0,32,41,19,19,0,0,1,1,1595.0,0:40,0,0,0,5971.0,2:33,-111
8466215,Joe,Corvo,1977-06-20,D,R,2011-12,75,4,21,25,0.33,10,168,2.38,13,84644.0,18:48,0,0,0,0.0,27,56,14,32,-18,1,8,9,10835.0,2:24,0,0,0,1404.0,0:18,2250000
8466251,Jason,Chimera,1979-05-02,LW,L,2011-12,82,20,19,39,0.48,4,205,9.76,78,71010.0,14:25,30,32,62,48.39,132,27,23,26,-3,1,0,1,4359.0,0:53,2,0,2,4495.0,0:54,1875000
8466285,Brian,Campbell,1979-05-23,D,L,2011-12,82,4,49,53,0.65,-9,131,3.05,6,132331.0,26:53,0,0,0,0.0,46,118,29,46,-17,1,30,31,20381.0,4:8,0,0,0,6299.0,1:16,7142875
8466309,Mike,Mottau,1978-03-19,D,L,2011-12,35,0,2,2,0.06,-11,22,0.0,15,29571.0,14:4,0,0,0,0.0,38,47,17,21,-4,0,0,0,90.0,0:2,0,0,0,1899.0,0:54,-111
8466333,Andrew,Ference,1979-03-17,D,L,2011-12,72,6,18,24,0.33,9,107,5.61,46,81597.0,18:53,1,0,1,100.0,68,81,7,38,-31,0,2,2,2766.0,0:38,0,1,1,8295.0,1:55,2250000
8466371,John,Madden,1973-05-04,C,L,2011-12,31,3,0,3,0.1,-4,33,9.09,4,22288.0,11:58,155,158,313,49.52,23,12,19,4,15,0,0,0,147.0,0:4,0,0,0,2095.0,1:7,600000
8466378,Martin,St. Louis,1975-06-18,RW,L,2011-12,77,25,49,74,0.96,-3,185,13.51,16,104563.0,22:37,18,23,41,43.9,17,39,66,53,13,4,12,16,17439.0,3:46,0,0,0,1976.0,0:25,5625000
8466393,Pascal,Dupuis,1979-04-07,RW,L,2011-12,82,25,34,59,0.72,18,214,11.68,34,83289.0,16:55,51,64,115,44.35,111,44,25,18,7,0,1,1,1947.0,0:23,3,0,3,11217.0,2:16,1500000
8466398,Tom,Kostopoulos,1979-01-24,RW,R,2011-12,81,4,8,12,0.15,-15,91,4.4,57,59892.0,12:19,25,59,84,29.76,124,48,29,23,6,1,0,1,517.0,0:6,1,0,1,7069.0,1:27,916667
8467096,Dan,Boyle,1976-07-12,D,R,2011-12,81,9,39,48,0.59,10,252,3.57,57,124334.0,25:34,0,0,0,0.0,58,137,21,66,-45,3,14,17,19121.0,3:56,0,0,0,7291.0,1:30,6666666
8467304,Andy,Sutton,1975-03-10,D,L,2011-12,52,3,7,10,0.19,5,41,7.32,80,52054.0,16:41,0,0,0,0.0,112,95,14,49,-35,0,0,0,89.0,0:1,0,0,0,5517.0,1:46,2062500
8467329,Vincent,Lecavalier,1980-04-21,C,L,2011-12,64,22,27,49,0.77,-2,182,12.09,50,72696.0,18:55,556,606,1162,47.85,103,31,24,34,-10,5,6,11,13058.0,3:24,0,0,0,702.0,0:10,7727272
8467330,David,Legwand,1980-08-17,C,L,2011-12,78,19,34,53,0.68,3,140,13.57,26,86678.0,18:31,512,597,1109,46.17,31,29,46,43,3,5,14,19,10522.0,2:14,0,1,1,5983.0,1:16,4500000
8467331,Brad,Stuart,1979-11-06,D,L,2011-12,81,6,15,21,0.26,16,96,6.25,29,102326.0,21:3,0,0,0,0.0,177,115,22,27,-5,1,0,1,1501.0,0:18,1,0,1,15436.0,3:10,3750000
8467332,Bryan,Allen,1980-08-21,D,L,2011-12,82,1,13,14,0.17,-1,87,1.15,76,94269.0,19:9,0,0,0,0.0,111,188,22,36,-14,0,0,0,617.0,0:7,0,1,1,12381.0,2:30,2900000
8467334,Manny,Malhotra,1980-05-18,C,L,2011-12,78,7,11,18,0.23,-11,60,11.67,14,57780.0,12:20,536,380,916,58.52,44,45,22,22,0,0,0,0,346.0,0:4,0,0,0,11295.0,2:24,2500000
8467335,Mark,Bell,1980-08-05,C,L,2011-12,5,0,0,0,0.0,0,0,,5,1931.0,6:26,12,10,22,54.55,7,0,0,0,0,0,0,0,0.0,0:0,0,0,0,0.0,0:0,575000
8467336,Mike,Rupp,1980-01-13,LW,L,2011-12,60,4,1,5,0.08,-1,31,12.9,97,23928.0,6:38,19,15,34,55.88,103,13,3,9,-6,0,0,0,677.0,0:11,0,0,0,32.0,0:0,1333333
8467338,Alex,Tanguay,1979-11-21,LW,L,2011-12,64,13,36,49,0.77,7,84,15.48,28,73135.0,19:2,25,42,67,37.31,22,47,35,54,-19,1,14,15,12468.0,3:14,1,1,2,5200.0,1:21,3500000
8467344,Robyn,Regehr,1980-04-19,D,L,2011-12,76,1,4,5,0.07,-12,49,2.04,56,84933.0,18:37,0,0,0,0.0,172,112,11,28,-17,0,0,0,205.0,0:2,0,0,0,12179.0,2:40,4020000
8467346,Simon,Gagne,1980-02-29,LW,L,2011-12,34,7,10,17,0.5,-1,75,9.33,18,36697.0,17:59,2,5,7,28.57,17,10,8,24,-16,0,4,4,6286.0,3:4,1,0,1,2411.0,1:10,3500000
8467351,Scott,Gomez,1979-12-23,C,L,2011-12,38,2,9,11,0.29,-9,59,3.39,14,32225.0,14:8,165,168,333,49.55,11,12,14,14,0,2,1,3,5339.0,2:20,0,0,0,139.0,0:3,7357143
8467353,Nik,Antropov,1980-02-18,C,L,2011-12,69,15,20,35,0.51,0,95,15.79,42,68373.0,16:30,283,369,652,43.4,94,41,25,23,2,4,6,10,8424.0,2:2,0,0,0,7444.0,1:47,-111
8467365,John,Erskine,1980-06-26,D,L,2011-12,28,0,2,2,0.07,3,20,0.0,51,20325.0,12:5,0,0,0,0.0,39,27,4,8,-4,0,0,0,31.0,0:1,0,1,1,888.0,0:31,1500000
8467370,Mike,Fisher,1980-06-05,C,R,2011-12,72,24,27,51,0.71,11,157,15.29,33,83362.0,19:17,588,629,1217,48.32,116,76,44,34,10,5,9,14,9814.0,2:16,0,1,1,5435.0,1:15,4200000
8467371,Mike,Ribeiro,1980-02-10,C,L,2011-12,74,18,45,63,0.85,5,142,12.68,66,89011.0,20:2,341,467,808,42.2,113,46,39,64,-25,2,13,15,12691.0,2:51,0,0,0,4299.0,0:58,5000000
8467389,Brad,Richards,1980-05-02,C,L,2011-12,82,25,41,66,0.8,-1,229,10.92,22,99705.0,20:15,682,634,1316,51.82,51,49,47,46,1,7,17,24,20486.0,4:9,0,0,0,844.0,0:10,6666666
8467396,Erik,Cole,1978-11-06,LW,L,2011-12,82,35,26,61,0.74,11,241,14.52,48,91166.0,18:31,24,32,56,42.86,186,30,39,36,3,11,3,14,16064.0,3:15,0,0,0,716.0,0:8,4500000
8467400,Francois,Beauchemin,1980-06-04,D,L,2011-12,82,8,14,22,0.27,-14,139,5.76,48,125723.0,25:33,1,1,2,50.0,154,194,30,47,-17,3,2,5,7300.0,1:29,0,1,1,20797.0,4:13,3800000
8467407,Brian,Gionta,1979-01-18,RW,R,2011-12,31,8,7,15,0.48,-7,75,10.67,16,36149.0,19:26,14,19,33,42.42,35,13,15,13,2,2,1,3,5403.0,2:54,0,0,0,3878.0,2:5,5000000
8467408,Matt,Walker,1980-04-07,D,R,2011-12,4,0,0,0,0.0,-2,2,0.0,16,2631.0,10:57,0,0,0,0.0,1,5,2,1,1,0,0,0,6.0,0:1,0,0,0,30.0,0:7,1700000
8467412,Alexei,Ponikarovsky,1980-04-09,LW,L,2011-12,82,14,19,33,0.4,-3,156,8.97,34,72554.0,14:44,4,8,12,33.33,143,36,33,19,14,4,3,7,6584.0,1:20,0,0,0,1242.0,0:15,1500000
8467423,Shawn,Horcoff,1978-09-17,C,L,2011-12,81,13,21,34,0.42,-23,123,10.57,24,95186.0,19:35,728,747,1475,49.36,62,47,46,48,-2,5,8,13,13934.0,2:52,0,0,0,12920.0,2:39,5500000
8467428,Krys,Barch,1980-03-26,RW,L,2011-12,51,2,3,5,0.1,0,24,8.33,114,22491.0,7:21,2,5,7,28.57,67,10,5,5,0,0,0,0,81.0,0:1,0,0,0,42.0,0:0,837500
8467439,Jaroslav,Spacek,1974-02-11,D,L,2011-12,46,5,10,15,0.33,6,42,11.9,8,44391.0,16:5,0,0,0,0.0,29,68,14,18,-4,3,2,5,4600.0,1:40,0,0,0,1698.0,0:36,3833333
8467452,Rob,Scuderi,1978-12-30,D,L,2011-12,82,1,8,9,0.11,-7,63,1.59,16,101403.0,20:36,0,0,0,0.0,61,116,17,52,-35,0,0,0,481.0,0:5,0,0,0,12992.0,2:38,3400000
8467463,Mikael,Samuelsson,1976-12-23,RW,R,2011-12,54,14,17,31,0.57,1,138,10.14,20,51670.0,15:56,12,21,33,36.36,79,11,23,15,8,7,6,13,8307.0,2:33,0,0,0,165.0,0:3,2500000
8467466,Trent,Hunter,1980-07-05,RW,R,2011-12,38,2,5,7,0.18,-4,51,3.92,8,23025.0,10:5,4,20,24,16.67,72,6,3,7,-4,0,1,1,1935.0,0:50,0,0,0,21.0,0:0,2000000
8467478,Kent,Huskins,1979-05-04,D,L,2011-12,25,2,5,7,0.28,9,16,12.5,10,23202.0,15:28,0,0,0,0.0,6,35,0,11,-11,0,0,0,330.0,0:13,0,0,0,1101.0,0:44,1000000
8467493,Chris,Neil,1979-06-18,RW,R,2011-12,72,13,15,28,0.39,-10,127,10.24,178,55263.0,12:47,0,2,2,0.0,271,20,21,20,1,2,4,6,7375.0,1:42,0,0,0,0.0,0:0,2000000
8467496,Andrei,Markov,1978-12-20,D,L,2011-12,13,0,3,3,0.23,-4,17,0.0,4,14046.0,18:0,0,0,0,0.0,7,7,2,1,1,0,2,2,2914.0,3:44,0,0,0,377.0,0:29,5750000
8467514,Pavel,Datsyuk,1978-07-20,C,L,2011-12,70,19,48,67,0.96,21,164,11.59,14,82188.0,19:34,702,547,1249,56.2,76,31,97,40,57,4,19,23,12928.0,3:4,0,0,0,5129.0,1:13,6700000
8467543,Toby,Petersen,1978-10-27,C,L,2011-12,39,2,3,5,0.13,-7,44,4.55,6,17915.0,7:39,3,4,7,42.86,34,14,8,5,3,0,1,1,1344.0,0:34,0,0,0,595.0,0:15,-111
8467545,Michael,Ryder,1980-03-31,RW,R,2011-12,82,35,27,62,0.76,17,211,16.59,46,85519.0,17:22,34,37,71,47.89,86,50,48,39,9,7,3,10,13142.0,2:40,0,0,0,124.0,0:1,3500000
8467579,Trevor,Gillies,1979-01-30,LW,L,2011-12,3,0,0,0,0.0,-1,1,0.0,0,517.0,2:52,0,0,0,0.0,2,0,0,0,0,0,0,0,0.0,0:0,0,0,0,0.0,0:0,-111
8467580,Mark,Eaton,1977-05-06,D,L,2011-12,62,1,3,4,0.06,-17,44,2.27,10,59708.0,16:3,0,0,0,0.0,53,114,13,28,-15,0,0,0,134.0,0:2,0,0,0,7356.0,1:58,-111
8467831,Jeff,Halpern,1976-05-03,C,R,2011-12,69,4,12,16,0.23,-1,63,6.35,24,52197.0,12:36,365,260,625,58.4,55,44,22,6,16,0,0,0,432.0,0:6,0,0,0,7228.0,1:44,825000
8467844,Jason,Blake,1973-09-02,LW,L,2011-12,45,7,5,12,0.27,-4,109,6.42,6,38185.0,14:8,0,1,1,0.0,41,17,19,9,10,2,1,3,3915.0,1:27,0,0,0,23.0,0:0,4000000
8467875,Daniel,Sedin,1980-09-26,LW,L,2011-12,72,30,37,67,0.93,14,229,13.1,40,81281.0,18:48,6,13,19,31.58,21,15,28,25,3,10,15,25,15146.0,3:30,0,0,0,327.0,0:4,6100000
8467876,Henrik,Sedin,1980-09-26,C,L,2011-12,82,14,67,81,0.99,23,113,12.39,52,93913.0,19:5,652,650,1302,50.08,32,17,31,37,-6,8,19,27,18041.0,3:40,0,0,0,453.0,0:5,6100000
8467878,Tim,Connolly,1981-05-07,C,R,2011-12,70,13,23,36,0.51,-14,104,12.5,40,71418.0,17:0,383,403,786,48.73,29,76,32,41,-9,2,3,5,7875.0,1:52,0,0,0,7131.0,1:41,4750000
8467881,Taylor,Pyatt,1981-08-19,LW,L,2011-12,73,9,10,19,0.26,-4,111,8.11,23,53952.0,12:19,6,5,11,54.55,137,20,14,8,6,0,1,1,2584.0,0:35,0,0,0,0.0,0:0,-111
8467890,Barret,Jackman,1981-03-05,D,L,2011-12,81,1,12,13,0.16,20,82,1.22,57,100498.0,20:40,0,0,0,0.0,106,153,22,31,-9,0,0,0,253.0,0:3,0,0,0,16705.0,3:26,3625000
8467899,Martin,Havlat,1981-04-19,RW,L,2011-12,39,7,20,27,0.69,10,96,7.29,22,41237.0,17:37,0,7,7,0.0,6,14,19,25,-6,4,4,8,5173.0,2:12,0,1,1,1367.0,0:35,4250000
8467910,Nolan,Yonkman,1981-04-01,D,R,2011-12,1,0,0,0,0.0,0,0,,0,379.0,6:19,0,0,0,0.0,0,0,1,0,1,0,0,0,0.0,0:0,0,0,0,0.0,0:0,-111
8467915,Mike,Commodore,1979-11-07,D,R,2011-12,30,0,2,2,0.07,7,23,0.0,38,22685.0,12:36,0,0,0,0.0,53,32,4,7,-3,0,0,0,74.0,0:2,0,0,0,1525.0,0:50,3750000
8467917,Jordan,Leopold,1980-08-03,D,L,2011-12,79,10,14,24,0.3,4,110,9.09,28,106037.0,22:22,0,0,0,0.0,54,128,14,40,-26,1,4,5,9476.0,1:59,0,0,0,11008.0,2:19,3000000
8467925,Adam,Hall,1980-08-14,RW,R,2011-12,57,2,5,7,0.12,-11,63,3.17,17,40581.0,11:51,276,188,464,59.48,89,30,12,6,6,0,0,0,208.0,0:3,0,0,0,9808.0,2:52,600000
8467928,Doug,Janik,1980-03-26,D,L,2011-12,9,0,1,1,0.11,2,6,0.0,6,7831.0,14:30,0,0,0,0.0,7,6,2,2,0,0,0,0,37.0,0:4,0,0,0,346.0,0:38,512500
8467931,Matt,Carkner,1980-11-03,D,R,2011-12,29,1,2,3,0.1,0,17,5.88,33,20721.0,11:54,0,0,0,0.0,58,26,3,6,-3,0,0,0,0.0,0:0,0,0,0,1563.0,0:53,700000
8467943,Niklas,Hagman,1979-12-05,LW,L,2011-12,71,9,14,23,0.32,-7,125,7.2,14,62099.0,14:34,8,12,20,40.0,49,29,20,17,3,2,0,2,2488.0,0:35,0,0,0,6321.0,1:29,3000000
8467967,Chris,Kelly,1980-11-11,C,L,2011-12,82,20,19,39,0.48,33,122,16.39,41,72498.0,14:44,419,390,809,51.79,79,56,35,15,20,1,0,1,989.0,0:12,2,0,2,8775.0,1:47,2125000
8467977,Brian,McGrattan,1981-09-02,RW,R,2011-12,30,0,2,2,0.07,-1,10,0.0,61,9576.0,5:19,0,0,0,0.0,29,3,4,1,3,0,0,0,25.0,0:0,0,0,0,0.0,0:0,600000
8467988,Ryan,Malone,1979-12-01,LW,L,2011-12,68,20,28,48,0.71,-11,144,13.89,82,72156.0,17:41,29,50,79,36.71,142,36,37,30,7,5,10,15,11949.0,2:55,1,0,1,2293.0,0:33,4500000
8468001,Derek,MacKenzie,1981-06-11,C,L,2011-12,66,7,7,14,0.21,4,61,11.48,40,41584.0,10:30,234,195,429,54.55,189,19,26,10,16,1,0,1,196.0,0:2,2,1,3,7093.0,1:47,600000
8468064,Martin,Erat,1981-08-29,RW,L,2011-12,71,19,39,58,0.82,12,107,17.76,30,78731.0,18:28,60,66,126,47.62,52,37,60,49,11,5,13,18,10061.0,2:21,1,0,1,4111.0,0:57,4500000
8468083,Henrik,Zetterberg,1980-10-09,C,L,2011-12,82,22,47,69,0.84,14,267,8.24,47,97609.0,19:50,548,567,1115,49.15,45,26,42,54,-12,3,11,14,15838.0,3:13,0,2,2,5293.0,1:4,6083333
8468085,Radim,Vrbata,1981-06-13,RW,R,2011-12,77,35,27,62,0.81,24,232,15.09,24,86128.0,18:38,27,40,67,40.3,57,16,37,24,13,9,8,17,14883.0,3:13,1,0,1,5870.0,1:16,3000000
8468086,Alexandre,Giroux,1981-06-16,LW,L,2011-12,9,1,0,1,0.11,-2,18,5.56,8,6586.0,12:11,1,0,1,100.0,11,0,7,1,6,0,0,0,1101.0,2:2,0,0,0,0.0,0:0,-111
8468095,George,Parros,1979-12-29,RW,R,2011-12,46,1,3,4,0.09,1,17,5.88,85,17606.0,6:22,0,0,0,0.0,57,16,5,8,-3,0,0,0,10.0,0:0,0,0,0,0.0,0:0,875000
8468101,Radek,Martinek,1976-08-31,D,R,2011-12,7,1,0,1,0.14,-3,10,10.0,0,8164.0,19:26,0,0,0,0.0,5,7,3,4,-1,0,0,0,220.0,0:31,0,0,0,1138.0,2:42,2200000
8468114,Douglas,Murray,1980-03-12,D,L,2011-12,60,0,4,4,0.07,3,71,0.0,31,66173.0,18:22,0,0,0,0.0,126,143,14,33,-19,0,0,0,427.0,0:7,0,0,0,6489.0,1:48,2500000
8468162,Jerred,Smithson,1979-02-04,C,R,2011-12,69,1,5,6,0.09,-5,37,2.7,34,48503.0,11:42,362,283,645,56.12,128,43,17,14,3,0,0,0,410.0,0:5,0,1,1,7852.0,1:53,800000
8468172,Ruslan,Fedotenko,1979-01-18,LW,L,2011-12,73,9,11,20,0.27,-7,94,9.57,16,59552.0,13:35,16,18,34,47.06,86,57,22,11,11,1,1,2,1632.0,0:22,0,0,0,5476.0,1:15,-111
8468208,Joel,Ward,1980-12-02,RW,R,2011-12,73,6,12,18,0.25,12,79,7.59,20,54437.0,12:25,29,23,52,55.77,75,41,35,21,14,0,0,0,626.0,0:8,0,0,0,2761.0,0:37,3000000
8468213,Jim,Vandermeer,1980-02-21,D,L,2011-12,25,1,3,4,0.16,3,19,5.26,33,15622.0,10:24,0,0,0,0.0,14,10,6,7,-1,0,0,0,114.0,0:4,0,0,0,602.0,0:24,1000000
8468224,Sean,Avery,1980-04-10,LW,L,2011-12,15,3,0,3,0.2,2,15,20.0,21,6313.0,7:0,0,3,3,0.0,10,1,4,3,1,0,0,0,14.0,0:0,0,0,0,0.0,0:0,3875000
8468309,Mark,Streit,1977-12-11,D,L,2011-12,82,7,40,47,0.57,-27,149,4.7,46,115024.0,23:22,0,1,1,0.0,110,115,50,63,-13,3,20,23,18247.0,3:42,0,0,0,3493.0,0:42,4100000
8468434,Andy,McDonald,1977-08-25,LW,L,2011-12,25,10,12,22,0.88,4,64,15.62,2,27788.0,18:31,66,50,116,56.9,3,5,11,12,-1,3,3,6,4410.0,2:56,0,0,0,1962.0,1:18,4700000
8468463,Mathieu,Darche,1976-11-26,LW,L,2011-12,61,5,7,12,0.2,-4,77,6.49,18,44392.0,12:7,6,13,19,31.58,79,45,15,9,6,0,0,0,1816.0,0:29,2,2,4,6580.0,1:47,-111
8468478,Mike,Weaver,1978-05-02,D,R,2011-12,82,0,16,16,0.2,-2,51,0.0,14,100013.0,20:19,0,0,0,0.0,114,137,38,23,15,0,0,0,446.0,0:5,0,1,1,14422.0,2:55,900000
8468482,Dany,Heatley,1981-01-21,LW,L,2011-12,82,24,29,53,0.65,2,238,10.08,28,103046.0,20:56,36,31,67,53.73,70,45,33,33,0,8,11,19,16717.0,3:23,0,0,0,970.0,0:11,7500000
8468483,Marian,Gaborik,1982-02-14,RW,L,2011-12,82,41,35,76,0.93,15,276,14.86,34,96018.0,19:30,0,2,2,0.0,63,40,30,41,-11,10,11,21,17607.0,3:34,0,0,0,489.0,0:5,7500000
8468484,Rostislav,Klesla,1982-03-21,D,L,2011-12,65,3,10,13,0.2,13,87,3.45,54,75498.0,19:21,1,1,2,50.0,112,150,13,23,-10,0,0,0,223.0,0:3,0,0,0,10734.0,2:45,2975000
8468485,Raffi,Torres,1981-10-08,LW,L,2011-12,79,15,11,26,0.33,2,99,15.15,83,53886.0,11:22,7,8,15,46.67,128,21,18,22,-4,1,0,1,3867.0,0:48,0,0,0,11.0,0:0,1750000
8468486,Scott,Hartnell,1982-04-18,LW,L,2011-12,82,37,30,67,0.82,19,232,15.95,136,87462.0,17:46,20,43,63,31.75,188,37,27,42,-15,16,7,23,15801.0,3:12,0,0,0,434.0,0:5,4200000
8468493,Ron,Hainsey,1981-03-24,D,L,2011-12,56,0,10,10,0.18,9,57,0.0,23,70889.0,21:5,0,0,0,0.0,33,133,10,33,-23,0,1,1,2440.0,0:43,0,0,0,8645.0,2:34,4500000
8468498,Brooks,Orpik,1980-09-26,D,L,2011-12,73,2,16,18,0.25,19,44,4.55,61,98780.0,22:33,0,0,0,0.0,259,139,13,25,-12,0,0,0,265.0,0:3,0,1,1,14670.0,3:20,3750000
8468499,Krys,Kolanos,1981-07-27,C,R,2011-12,13,0,1,1,0.08,-1,29,0.0,2,7686.0,9:51,17,13,30,56.67,13,0,5,6,-1,0,0,0,789.0,1:0,0,0,0,0.0,0:0,-111
8468501,Anton,Volchenkov,1982-02-25,D,L,2011-12,72,2,9,11,0.15,3,63,3.17,34,77669.0,17:58,0,0,0,0.0,177,125,14,15,-1,0,0,0,146.0,0:2,0,1,1,13391.0,3:5,4250000
8468504,Brad,Boyes,1982-04-17,RW,R,2011-12,65,8,15,23,0.35,2,100,8.0,6,51351.0,13:10,126,141,267,47.19,29,24,18,26,-8,2,6,8,7744.0,1:59,0,0,0,328.0,0:5,4000000
8468505,Steve,Ott,1982-08-19,C,L,2011-12,74,11,28,39,0.53,5,108,10.19,156,81439.0,18:20,561,450,1011,55.49,278,27,26,25,1,4,4,8,8968.0,2:1,0,2,2,7772.0,1:45,2950000
8468508,Justin,Williams,1981-10-04,RW,R,2011-12,82,22,37,59,0.72,10,241,9.13,44,84385.0,17:9,11,14,25,44.0,36,37,32,62,-30,9,10,19,12910.0,2:37,0,0,0,673.0,0:8,3825000
8468509,Niklas,Kronwall,1981-01-12,D,L,2011-12,82,15,21,36,0.44,-2,141,10.64,38,112499.0,22:51,0,0,0,0.0,133,177,21,31,-10,7,7,14,13208.0,2:41,0,1,1,14189.0,2:53,3000000
8468510,Jeff,Taffe,1981-02-19,LW,L,2011-12,5,0,2,2,0.4,2,7,0.0,0,3873.0,12:54,1,5,6,16.67,7,2,0,1,-1,0,0,0,432.0,1:26,0,0,0,30.0,0:6,-111
8468513,Nick,Schultz,1982-08-25,D,L,2011-12,82,1,6,7,0.09,-12,51,1.96,40,96964.0,19:42,0,0,0,0.0,83,165,14,32,-18,1,0,1,1790.0,0:21,0,0,0,11917.0,2:25,3500000
8468515,Brad,Winchester,1981-03-01,LW,L,2011-12,67,6,4,10,0.15,-5,72,8.33,88,31386.0,7:48,20,13,33,60.61,78,13,13,13,0,0,0,0,632.0,0:9,0,0,0,78.0,0:1,725000
8468518,Tomas,Kopecky,1982-02-05,RW,L,2011-12,80,10,22,32,0.4,-8,143,6.99,32,82897.0,17:16,140,126,266,52.63,45,35,60,27,33,2,6,8,10250.0,2:8,0,0,0,9634.0,2:0,3000000
8468520,Kurtis,Foster,1981-11-24,D,R,2011-12,51,4,10,14,0.27,-13,85,4.71,35,48631.0,15:53,0,0,0,0.0,46,35,4,17,-13,2,9,11,9496.0,3:6,0,0,0,536.0,0:10,1800000
8468526,Jarret,Stoll,1982-06-24,C,R,2011-12,78,6,15,21,0.27,2,133,4.51,60,78051.0,16:40,662,542,1204,54.98,165,46,19,18,1,1,7,8,9650.0,2:3,0,0,0,9588.0,2:2,3600000
8468534,Andreas,Lilja,1975-07-13,D,L,2011-12,46,0,6,6,0.13,9,35,0.0,34,37777.0,13:41,0,0,0,0.0,61,72,8,17,-9,0,0,0,62.0,0:1,0,0,0,2523.0,0:54,737500
8468535,Antoine,Vermette,1982-07-20,C,L,2011-12,82,11,26,37,0.45,-13,149,7.38,28,84659.0,17:12,645,495,1140,56.58,124,48,44,34,10,4,5,9,10008.0,2:2,1,1,2,6857.0,1:23,3750000
8468542,Paul,Martin,1981-03-05,D,L,2011-12,73,2,25,27,0.37,9,93,2.15,18,100750.0,23:0,0,0,0,0.0,24,117,27,37,-10,0,4,4,7993.0,1:49,0,1,1,11440.0,2:36,5000000
8468575,Dominic,Moore,1980-08-03,C,L,2011-12,79,4,21,25,0.32,-18,103,3.88,54,73631.0,15:32,419,343,762,54.99,52,23,25,20,5,0,3,3,3950.0,0:50,1,0,1,7772.0,1:38,1100000
8468584,Jon,Disalvatore,1981-03-30,RW,R,2011-12,1,0,0,0,0.0,0,2,0.0,2,867.0,14:27,0,0,0,0.0,1,0,0,0,0,0,0,0,62.0,1:2,0,0,0,0.0,0:0,-111
8468598,Lubomir,Visnovsky,1976-08-11,D,L,2011-12,68,6,21,27,0.4,7,112,5.36,47,84816.0,20:47,1,0,1,100.0,63,78,22,35,-13,1,9,10,14419.0,3:32,0,0,0,418.0,0:6,5600000
8468611,Matt,Hendricks,1981-06-17,C,L,2011-12,78,4,5,9,0.12,-6,97,4.12,95,56733.0,12:7,142,123,265,53.58,219,52,26,18,8,0,0,0,452.0,0:5,0,1,1,5701.0,1:13,825000
8468635,Travis,Moen,1982-04-06,LW,L,2011-12,48,9,7,16,0.33,-3,45,20.0,41,45262.0,15:42,5,7,12,41.67,75,41,13,13,0,0,0,0,393.0,0:8,1,0,1,6827.0,2:22,1500000
8468636,Greg,Zanon,1980-06-05,D,L,2011-12,56,3,5,8,0.14,3,41,7.32,18,59799.0,17:47,0,0,0,0.0,116,136,11,13,-2,0,0,0,207.0,0:3,0,0,0,5983.0,1:46,1933333
8468639,John-Michael,Liles,1980-11-25,D,L,2011-12,66,7,20,27,0.41,-14,106,6.6,20,84542.0,21:20,0,0,0,0.0,68,111,16,51,-35,4,9,13,12860.0,3:14,0,0,0,2136.0,0:32,4200000
8468660,Darcy,Hordichuk,1980-08-10,LW,L,2011-12,43,1,2,3,0.07,-3,27,3.7,64,11223.0,4:21,0,1,1,0.0,67,2,4,5,-1,0,0,0,3.0,0:0,0,0,0,0.0,0:0,825000
8468674,Deryk,Engelland,1982-04-03,D,R,2011-12,73,4,13,17,0.23,10,86,4.65,56,70730.0,16:8,0,0,0,0.0,174,77,9,18,-9,0,0,0,50.0,0:0,0,0,0,4507.0,1:1,566667
8468695,Matthew,Lombardi,1982-03-18,C,L,2011-12,62,8,10,18,0.29,-19,101,7.92,10,50471.0,13:34,151,155,306,49.35,58,34,16,16,0,0,0,0,1597.0,0:25,1,0,1,4677.0,1:15,3500000
8468700,Paul,Gaustad,1982-02-03,C,L,2011-12,70,7,14,21,0.3,-1,75,9.33,76,62022.0,14:46,659,491,1150,57.3,114,47,22,26,-4,0,0,0,342.0,0:4,0,1,1,11573.0,2:45,2300000
8468704,Antti,Miettinen,1980-07-03,RW,R,2011-12,45,5,8,13,0.29,-5,58,8.62,0,31609.0,11:42,9,12,21,42.86,38,11,7,5,2,1,3,4,2244.0,0:49,0,0,0,2449.0,0:54,1300000
8468778,Colton,Orr,1982-03-03,RW,R,2011-12,5,1,0,1,0.2,1,3,33.33,5,1344.0,4:28,0,1,1,0.0,7,0,0,2,-2,0,0,0,0.0,0:0,0,0,0,0.0,0:0,1000000
8468789,Jason,Williams,1980-08-11,C,R,2011-12,8,1,1,2,0.25,1,4,25.0,4,5075.0,10:34,0,1,1,0.0,1,2,4,3,1,0,1,1,1068.0,2:13,0,0,0,17.0,0:2,600000
8468881,Jason,Jaffray,1981-06-30,LW,L,2011-12,13,0,1,1,0.08,-1,10,0.0,7,5073.0,6:30,8,7,15,53.33,16,2,3,1,2,0,0,0,144.0,0:11,0,0,0,0.0,0:0,-111
8468887,Warren,Peters,1982-07-10,C,L,2011-12,58,1,4,5,0.09,-15,54,1.85,54,36831.0,10:35,255,210,465,54.84,70,34,24,9,15,0,0,0,182.0,0:3,0,0,0,4872.0,1:24,-111
8468927,Steve,Montador,1979-12-21,D,R,2011-12,52,5,9,14,0.27,4,57,8.77,45,46051.0,14:45,0,0,0,0.0,49,46,6,21,-15,2,4,6,4532.0,1:27,0,0,0,399.0,0:7,2750000
8469120,Raitis,Ivanans,1979-01-03,LW,L,2011-12,1,0,0,0,0.0,-1,0,,0,665.0,11:5,0,0,0,0.0,3,1,0,0,0,0,0,0,0.0,0:0,0,0,0,0.0,0:0,-111
8469454,Ilya,Kovalchuk,1983-04-15,RW,R,2011-12,77,37,46,83,1.08,-9,310,11.94,33,112901.0,24:26,13,24,37,35.14,27,18,42,120,-78,10,19,29,22748.0,4:55,3,2,5,5328.0,1:9,6666666
8469455,Jason,Spezza,1983-06-13,C,R,2011-12,80,34,50,84,1.05,11,232,14.66,36,95623.0,19:55,909,791,1700,53.47,28,23,64,84,-20,10,14,24,16194.0,3:22,0,0,0,2028.0,0:25,7000000
8469457,Stephen,Weiss,1983-04-03,C,L,2011-12,80,20,37,57,0.71,5,149,13.42,60,98449.0,20:30,781,688,1469,53.17,92,61,56,33,23,5,12,17,15815.0,3:17,1,0,1,6072.0,1:15,3100000
8469459,Mikko,Koivu,1983-03-12,C,L,2011-12,55,12,32,44,0.8,10,129,9.3,28,70455.0,21:21,587,536,1123,52.27,62,21,47,44,3,2,13,15,11632.0,3:31,1,3,4,5718.0,1:43,6750000
8469460,Mike,Komisarek,1982-01-19,D,R,2011-12,45,1,4,5,0.11,-13,34,2.94,41,44972.0,16:39,0,0,0,0.0,104,80,25,26,-1,0,0,0,151.0,0:3,0,0,0,4563.0,1:41,4300000
8469462,Tuomo,Ruutu,1983-02-16,LW,L,2011-12,72,18,16,34,0.47,-3,156,11.54,50,71110.0,16:27,44,80,124,35.48,151,24,32,42,-10,3,2,5,10702.0,2:28,0,0,0,255.0,0:3,3800000
8469465,Dan,Hamhuis,1982-12-13,D,L,2011-12,82,4,33,37,0.45,29,140,2.86,46,115271.0,23:25,0,0,0,0.0,103,99,48,62,-14,1,10,11,9171.0,1:51,0,2,2,14418.0,2:55,4500000
8469466,Ales,Hemsky,1983-08-13,RW,R,2011-12,69,10,26,36,0.52,-13,137,7.3,43,72864.0,17:36,2,4,6,33.33,22,21,37,55,-18,1,8,9,8855.0,2:8,0,0,0,174.0,0:2,4100000
8469467,Chuck,Kobasew,1982-04-17,RW,R,2011-12,58,7,7,14,0.24,-10,65,10.77,51,41233.0,11:50,7,15,22,31.82,62,20,17,7,10,0,1,1,1757.0,0:30,1,0,1,4390.0,1:15,1250000
8469469,R.J.,Umberger,1982-05-03,C,L,2011-12,77,20,20,40,0.52,-10,200,10.0,27,84045.0,18:11,150,156,306,49.02,102,70,45,24,21,5,5,10,14596.0,3:9,0,1,1,4721.0,1:1,3750000
8469470,Carlo,Colaiacovo,1983-01-27,D,L,2011-12,64,2,17,19,0.3,7,68,2.94,22,72975.0,19:0,0,0,0,0.0,73,81,9,14,-5,0,8,8,7782.0,2:1,0,0,0,1067.0,0:16,2125000
8469473,Marcel,Goc,1983-08-24,C,L,2011-12,57,11,16,27,0.47,5,97,11.34,10,60252.0,17:37,505,473,978,51.64,38,23,43,13,30,3,1,4,4227.0,1:14,0,0,0,6889.0,2:0,1700000
8469474,Colby,Armstrong,1982-11-23,RW,R,2011-12,29,1,2,3,0.1,-8,14,7.14,9,16218.0,9:19,7,11,18,38.89,37,5,6,7,-1,0,0,0,150.0,0:5,0,0,0,478.0,0:16,3000000
8469476,Tim,Gleason,1983-01-29,D,L,2011-12,82,1,17,18,0.22,12,65,1.54,71,101893.0,20:42,0,0,0,0.0,129,112,18,32,-14,0,2,2,1484.0,0:18,0,1,1,12814.0,2:36,2750000
8469480,Jeff,Woywitka,1983-09-01,D,L,2011-12,27,1,5,6,0.22,2,13,7.69,8,16865.0,10:24,0,0,0,0.0,18,22,4,7,-3,0,0,0,29.0,0:1,0,0,0,406.0,0:15,650000
8469483,David,Steckel,1982-03-15,C,L,2011-12,76,8,5,13,0.17,-14,79,10.13,10,58495.0,12:49,643,465,1108,58.03,170,66,33,31,2,1,0,1,804.0,0:10,2,0,2,10442.0,2:17,1100000
8469485,Derek,Roy,1983-05-04,C,L,2011-12,80,17,27,44,0.55,-7,176,9.66,54,92757.0,19:19,672,657,1329,50.56,35,50,46,59,-13,6,6,12,12568.0,2:37,1,0,1,8219.0,1:42,4000000
8469490,Tim,Jackman,1981-11-14,RW,R,2011-12,75,1,6,7,0.09,-21,103,0.97,94,41035.0,9:7,15,19,34,44.12,160,16,18,7,11,0,0,0,1630.0,0:21,0,0,0,92.0,0:1,550000
8469492,Fedor,Tyutin,1983-07-19,D,L,2011-12,66,5,21,26,0.39,-21,124,4.03,49,95605.0,24:8,0,0,0,0.0,100,91,16,20,-4,1,11,12,13091.0,3:18,0,1,1,11175.0,2:49,2843750
8469500,Michael,Cammalleri,1982-06-08,LW,L,2011-12,66,20,21,41,0.62,-10,175,11.43,26,71721.0,18:6,104,124,228,45.61,17,19,25,39,-14,3,9,12,12017.0,3:2,0,0,0,2424.0,0:36,6000000
8469501,Chris,Thorburn,1983-06-03,RW,R,2011-12,72,4,7,11,0.15,-6,69,5.8,83,43988.0,10:10,39,28,67,58.21,151,46,13,14,-1,0,0,0,316.0,0:4,0,0,0,2125.0,0:29,866667
8469506,Jason,Pominville,1982-11-30,RW,R,2011-12,82,30,43,73,0.89,-7,235,12.77,12,96825.0,19:40,179,196,375,47.73,30,52,45,38,7,8,18,26,15416.0,3:8,2,1,3,10908.0,2:13,5300000
8469508,Jay,McClement,1983-03-02,C,L,2011-12,80,10,7,17,0.21,-8,95,10.53,31,66013.0,13:45,448,425,873,51.32,72,54,34,16,18,0,0,0,259.0,0:3,1,0,1,14900.0,3:6,1450000
8469516,Brendan,Bell,1983-03-31,D,L,2011-12,1,0,0,0,0.0,-1,2,0.0,0,686.0,11:26,0,0,0,0.0,0,0,0,0,0,0,0,0,0.0,0:0,0,0,0,0.0,0:0,525000
8469521,Tomas,Plekanec,1982-10-31,C,L,2011-12,81,17,35,52,0.64,-15,220,7.73,56,100848.0,20:45,824,854,1678,49.11,67,57,43,48,-5,5,13,18,15010.0,3:5,3,3,6,15658.0,3:13,5000000
8469531,Jay,Harrison,1982-11-03,D,L,2011-12,72,9,14,23,0.32,-10,128,7.03,60,88788.0,20:33,0,0,0,0.0,117,153,15,40,-25,2,3,5,5817.0,1:20,0,0,0,7149.0,1:39,700000
8469534,Aaron,Johnson,1983-04-30,D,L,2011-12,56,3,13,16,0.29,-12,63,4.76,26,55464.0,16:30,0,0,0,0.0,99,72,17,21,-4,1,1,2,2844.0,0:50,0,0,0,4529.0,1:20,550000
8469542,Stephane,Veilleux,1981-11-16,LW,L,2011-12,22,0,2,2,0.09,-2,16,0.0,15,12955.0,9:48,3,7,10,30.0,27,5,11,1,10,0,0,0,56.0,0:2,0,0,0,1161.0,0:52,525000
8469544,Patrick,Sharp,1981-12-27,LW,R,2011-12,74,33,36,69,0.93,28,282,11.7,38,88353.0,19:53,139,152,291,47.77,80,18,55,29,26,7,10,17,15672.0,3:31,1,0,1,4861.0,1:5,3900000
8469547,Jordin,Tootoo,1983-02-02,RW,R,2011-12,77,6,24,30,0.39,-5,136,4.41,92,60771.0,13:9,4,8,12,33.33,151,17,42,44,-2,1,1,2,986.0,0:12,0,0,0,307.0,0:3,1250000
8469555,Christian,Ehrhoff,1982-07-06,D,L,2011-12,66,5,27,32,0.48,-2,136,3.68,47,91309.0,23:3,0,0,0,0.0,47,82,24,51,-27,1,10,11,11754.0,2:58,0,2,2,5230.0,1:19,4000000
8469581,Kyle,Wellwood,1983-05-16,C,R,2011-12,77,18,29,47,0.61,3,93,19.35,4,69080.0,14:57,135,115,250,54.0,10,13,35,26,9,4,6,10,9190.0,1:59,0,0,0,231.0,0:3,700000
8469582,Colin,Stuart,1982-07-08,LW,L,2011-12,2,0,0,0,0.0,-3,0,,0,743.0,6:11,0,0,0,0.0,0,0,0,0,0,0,0,0,2.0,0:1,0,0,0,0.0,0:0,525000
8469591,Cody,McCormick,1983-04-18,C,R,2011-12,50,1,3,4,0.08,-7,43,2.33,56,23492.0,7:49,8,9,17,47.06,67,11,8,9,-1,0,0,0,11.0,0:0,0,0,0,121.0,0:2,1200000
8469598,Kevin,Bieksa,1981-06-16,D,R,2011-12,78,8,36,44,0.56,12,166,4.82,94,110635.0,23:38,0,1,1,0.0,159,106,29,68,-39,2,8,10,8091.0,1:43,0,0,0,12132.0,2:35,4600000
8469619,Dennis,Seidenberg,1981-07-18,D,L,2011-12,80,5,18,23,0.29,15,174,2.87,39,115388.0,24:2,0,0,0,0.0,154,151,17,25,-8,0,8,8,12494.0,2:36,0,2,2,12387.0,2:34,3250000
8469622,Ryane,Clowe,1982-09-30,LW,L,2011-12,76,17,28,45,0.59,-5,180,9.44,97,81469.0,17:51,6,14,20,30.0,109,36,42,55,-13,4,11,15,10350.0,2:16,0,0,0,127.0,0:1,3625000
8469623,Marek,Zidlicky,1977-02-03,D,R,2011-12,63,2,20,22,0.35,-6,70,2.86,34,80630.0,21:19,0,0,0,0.0,62,58,14,44,-30,2,6,8,12985.0,3:26,0,0,0,1586.0,0:25,4000000
8469626,Andrew,Alberts,1981-06-30,D,L,2011-12,44,2,1,3,0.07,4,19,10.53,40,37743.0,14:17,0,0,0,0.0,91,39,13,16,-3,0,0,0,168.0,0:3,0,0,0,3054.0,1:9,1225000
8469638,Jussi,Jokinen,1983-04-01,LW,L,2011-12,79,12,34,46,0.58,-2,118,10.17,54,83766.0,17:40,459,374,833,55.1,41,48,37,40,-3,3,15,18,13352.0,2:49,2,0,2,6155.0,1:17,3000000
8469639,Brooks,Laich,1983-06-23,C,L,2011-12,82,16,25,41,0.5,-8,191,8.38,34,90991.0,18:29,664,730,1394,47.63,120,92,52,31,21,5,4,9,10823.0,2:11,1,0,1,12176.0,2:28,4500000
8469664,David,Moss,1981-12-28,RW,R,2011-12,32,2,7,9,0.28,-3,82,2.44,12,26907.0,14:0,93,127,220,42.27,43,24,15,18,-3,0,0,0,1744.0,0:54,0,0,0,2833.0,1:28,1300000
8469665,Johnny,Oduya,1981-10-01,D,L,2011-12,81,3,15,18,0.22,-6,82,3.66,33,99440.0,20:27,0,0,0,0.0,64,140,23,36,-13,0,0,0,3787.0,0:46,0,0,0,10403.0,2:8,3500000
8469684,Milan,Jurcina,1983-06-07,D,R,2011-12,65,3,8,11,0.17,-34,127,2.36,30,73230.0,18:46,0,0,0,0.0,173,116,26,25,1,2,1,3,3264.0,0:50,0,0,0,6621.0,1:41,1600000
8469685,Andrew,Murray,1981-11-06,C,L,2011-12,39,1,3,4,0.1,3,33,3.03,4,18029.0,7:42,5,10,15,33.33,66,8,6,4,2,0,0,0,100.0,0:2,0,0,0,886.0,0:22,575000
8469707,PA,Parenteau,1983-03-24,RW,R,2011-12,80,18,49,67,0.84,-8,167,10.78,89,89532.0,18:39,10,16,26,38.46,99,23,37,56,-19,6,13,19,14116.0,2:56,0,0,0,100.0,0:1,1250000
8469755,Brandon,Segal,1983-07-12,RW,R,2011-12,10,0,0,0,0.0,-2,8,0.0,4,3950.0,6:35,1,3,4,25.0,12,5,0,0,0,0,0,0,11.0,0:1,0,0,0,0.0,0:0,-111
8469759,Vernon,Fiddler,1980-05-09,C,L,2011-12,82,8,13,21,0.26,-13,123,6.5,60,68807.0,13:59,534,515,1049,50.91,82,67,40,13,27,0,0,0,617.0,0:7,0,1,1,9829.0,1:59,1800000
8469760,Zbynek,Michalek,1982-12-23,D,R,2011-12,62,2,11,13,0.21,0,77,2.6,24,80537.0,21:38,0,0,0,0.0,47,144,10,26,-16,0,1,1,874.0,0:14,0,1,1,13541.0,3:38,4000000
8469765,Marc-Andre,Bergeron,1980-10-13,D,L,2011-12,43,4,20,24,0.56,6,80,5.0,20,49933.0,19:21,0,0,0,0.0,37,43,19,19,0,1,8,9,7251.0,2:48,0,0,0,322.0,0:7,1000000
8469770,Dennis,Wideman,1983-03-20,D,R,2011-12,82,11,35,46,0.56,-8,175,6.29,46,117616.0,23:54,0,0,0,0.0,113,132,30,68,-38,4,16,20,16131.0,3:16,0,0,0,9534.0,1:56,3937500
8469779,Keith,Aucoin,1978-11-06,C,L,2011-12,27,3,8,11,0.41,4,21,14.29,0,17918.0,11:3,57,64,121,47.11,10,7,12,7,5,0,0,0,1914.0,1:10,0,0,0,4.0,0:0,-111
8469812,Chad,LaRose,1982-03-27,RW,R,2011-12,67,19,13,32,0.48,-15,199,9.55,48,67395.0,16:45,18,25,43,41.86,131,15,26,19,7,3,4,7,7928.0,1:58,1,0,1,2811.0,0:41,1700000
8469820,Zenon,Konopka,1981-01-02,C,L,2011-12,55,3,2,5,0.09,-4,34,8.82,193,25889.0,7:50,232,162,394,58.88,54,18,7,14,-7,1,0,1,517.0,0:9,0,0,0,2796.0,0:50,-111
8469992,Sheldon,Brookbank,1980-10-03,D,R,2011-12,80,3,11,14,0.18,11,49,6.12,72,74906.0,15:36,0,0,0,0.0,120,110,12,29,-17,0,0,0,363.0,0:4,0,1,1,8749.0,1:49,-111
8470005,Mark,Cullen,1978-10-28,C,L,2011-12,6,0,1,1,0.17,2,1,0.0,2,2879.0,7:59,15,12,27,55.56,2,1,2,1,1,0,0,0,33.0,0:5,0,0,0,2.0,0:0,-111
8470018,Matt,Ellis,1981-08-31,LW,L,2011-12,60,3,5,8,0.13,-3,85,3.53,25,34986.0,9:43,117,127,244,47.95,34,17,22,7,15,0,0,0,141.0,0:2,0,0,0,1177.0,0:19,525000
8470039,Tomas,Fleischmann,1984-05-16,LW,L,2011-12,82,27,34,61,0.74,-7,217,12.44,26,93966.0,19:5,14,13,27,51.85,32,33,56,40,16,6,16,22,15580.0,3:10,0,0,0,692.0,0:8,4500000
8470041,Rick,Nash,1984-06-16,LW,L,2011-12,82,30,29,59,0.72,-19,306,9.8,40,93896.0,19:5,6,13,19,31.58,104,21,62,26,36,6,13,19,17017.0,3:27,2,0,2,3243.0,0:39,7800000
8470047,Valtteri,Filppula,1984-03-20,C,L,2011-12,81,23,43,66,0.81,18,144,15.97,14,88736.0,18:15,193,180,373,51.74,42,23,39,30,9,3,8,11,11956.0,2:27,1,0,1,4452.0,0:54,3000000
8470054,Keith,Ballard,1982-11-26,D,L,2011-12,47,1,6,7,0.15,0,41,2.44,64,43866.0,15:33,0,0,0,0.0,61,63,8,29,-21,0,0,0,565.0,0:12,0,0,0,2754.0,0:58,3300000
8470061,Derek,Meech,1984-04-21,D,L,2011-12,2,0,0,0,0.0,1,2,0.0,4,1373.0,11:26,0,0,0,0.0,1,0,1,1,0,0,0,0,155.0,1:17,0,0,0,0.0,0:0,700000
8470063,Adam,Burish,1983-01-06,RW,R,2011-12,65,6,13,19,0.29,6,82,7.32,76,49873.0,12:47,217,172,389,55.78,69,36,17,13,4,0,2,2,2098.0,0:32,0,0,0,5652.0,1:26,1150000
8470104,Tom,Gilbert,1983-01-10,D,R,2011-12,67,3,19,22,0.33,-8,72,4.17,20,96740.0,24:3,0,0,0,0.0,65,115,30,50,-20,2,4,6,9411.0,2:20,0,0,0,12894.0,3:12,4000000
8470105,Scottie,Upshall,1983-10-07,RW,L,2011-12,26,2,3,5,0.19,-3,53,3.77,29,19845.0,12:43,3,3,6,50.0,44,2,8,3,5,1,0,1,2095.0,1:20,0,0,0,479.0,0:18,3500000
8470110,Trevor,Daley,1983-10-09,D,L,2011-12,79,4,21,25,0.32,3,134,2.99,42,102610.0,21:38,0,0,0,0.0,45,115,22,25,-3,1,5,6,10278.0,2:10,0,0,0,11849.0,2:29,3300000
8470120,Alexander,Semin,1984-03-03,RW,R,2011-12,77,21,33,54,0.7,9,183,11.48,56,77570.0,16:47,1,10,11,9.09,31,19,52,39,13,2,9,11,11658.0,2:31,0,0,0,69.0,0:0,6700000
8470121,Matt,Greene,1983-05-13,D,R,2011-12,82,4,11,15,0.18,4,76,5.26,58,82029.0,16:40,0,0,0,0.0,241,112,10,44,-34,0,0,0,490.0,0:5,0,1,1,15074.0,3:3,2950000
8470123,Cam,Janssen,1984-04-15,RW,R,2011-12,48,0,1,1,0.02,-8,17,0.0,75,13484.0,4:40,2,3,5,40.0,74,3,2,4,-2,0,0,0,75.0,0:1,0,0,0,40.0,0:0,525000
8470137,Joni,Pitkanen,1983-09-19,D,L,2011-12,30,5,12,17,0.57,-15,62,8.06,16,40148.0,22:18,0,0,0,0.0,27,43,9,17,-8,2,6,8,7016.0,3:53,0,0,0,3052.0,1:41,4500000
8470144,Frans,Nielsen,1984-04-24,C,L,2011-12,82,17,30,47,0.57,-3,133,12.78,6,85867.0,17:27,523,633,1156,45.24,29,66,58,33,25,5,10,15,12276.0,2:29,0,0,0,9927.0,2:1,525000
8470151,Jay,Bouwmeester,1983-09-27,D,L,2011-12,82,5,24,29,0.35,-21,107,4.67,26,127711.0,25:57,0,0,0,0.0,69,118,25,60,-35,2,8,10,10727.0,2:10,0,0,0,16283.0,3:18,6680000
8470152,Joakim,Lindstrom,1983-12-05,C,L,2011-12,16,2,3,5,0.31,-9,22,9.09,0,13361.0,13:55,2,3,5,40.0,1,6,9,2,7,1,0,1,2192.0,2:17,0,0,0,2.0,0:0,600000
8470153,Pierre-Marc,Bouchard,1984-04-27,C,L,2011-12,37,9,13,22,0.59,-1,84,10.71,18,36239.0,16:19,4,12,16,25.0,3,9,22,11,11,2,5,7,7552.0,3:24,0,0,0,55.0,0:1,4080000
8470156,Joey,Crabb,1983-04-03,RW,R,2011-12,67,11,15,26,0.39,1,75,14.67,33,54045.0,13:26,1,9,10,10.0,101,34,23,29,-6,0,0,0,429.0,0:6,2,0,2,6309.0,1:34,750000
8470159,Boyd,Gordon,1983-10-19,C,R,2011-12,75,8,15,23,0.31,9,114,7.02,10,71669.0,15:55,669,508,1177,56.84,48,86,28,10,18,0,0,0,581.0,0:7,1,2,3,12981.0,2:53,1325000
8470162,Matt,Stajan,1983-12-19,C,L,2011-12,61,8,10,18,0.3,-3,77,10.39,29,47618.0,13:0,331,308,639,51.8,49,33,28,21,7,0,2,2,1722.0,0:28,0,0,0,3655.0,0:59,3500000
8470169,Gregory,Campbell,1983-12-17,C,L,2011-12,78,8,8,16,0.21,-3,74,10.81,80,59895.0,12:47,344,334,678,50.74,107,53,22,18,4,0,0,0,721.0,0:9,0,0,0,7870.0,1:40,1100000
8470171,Max,Talbot,1984-02-11,C,L,2011-12,81,19,15,34,0.42,5,115,16.52,59,77758.0,15:59,284,356,640,44.38,150,58,30,21,9,1,1,2,1164.0,0:14,2,1,3,16968.0,3:29,1800000
8470176,Sean,Bergenheim,1984-02-08,LW,L,2011-12,62,17,6,23,0.37,-5,185,9.19,48,61053.0,16:24,3,8,11,27.27,109,21,29,16,13,5,0,5,6298.0,1:41,1,0,1,4613.0,1:14,2750000
8470180,Eric,Nystrom,1983-02-14,LW,L,2011-12,74,16,5,21,0.28,-10,102,15.69,24,61021.0,13:44,14,15,29,48.28,176,38,20,24,-4,0,0,0,684.0,0:9,0,0,0,5635.0,1:16,1400000
8470187,Johnny,Boychuk,1984-01-19,D,R,2011-12,77,5,10,15,0.19,27,171,2.92,53,95237.0,20:36,0,0,0,0.0,145,133,8,31,-23,0,0,0,1524.0,0:19,0,0,0,10278.0,2:13,1875000
8470189,David,Van Der Gulik,1983-04-20,LW,L,2011-12,25,1,5,6,0.24,3,20,5.0,2,12304.0,8:12,11,27,38,28.95,32,11,8,2,6,0,0,0,25.0,0:1,0,0,0,1573.0,1:2,525000
8470192,Steve,Eminger,1983-10-31,D,R,2011-12,42,2,3,5,0.12,0,19,10.53,28,33469.0,13:16,0,0,0,0.0,63,53,5,9,-4,0,1,1,234.0,0:5,0,1,1,3055.0,1:12,800000
8470201,Jiri,Hudler,1984-01-04,RW,L,2011-12,81,25,25,50,0.62,10,127,19.69,42,76140.0,15:40,2,5,7,28.57,48,15,21,26,-5,2,8,10,10921.0,2:14,0,0,0,53.0,0:0,2875000
8470207,Joffrey,Lupul,1983-09-23,LW,R,2011-12,66,25,42,67,1.02,1,191,13.09,48,73699.0,18:36,21,37,58,36.21,110,25,26,41,-15,8,13,21,12986.0,3:16,0,0,0,81.0,0:1,4250000
8470222,James,Wisniewski,1984-02-21,D,R,2011-12,48,6,21,27,0.56,-13,99,6.06,37,71417.0,24:47,0,1,1,0.0,50,74,15,22,-7,2,10,12,11206.0,3:53,0,0,0,5244.0,1:49,5500000
8470230,Daniel,Paille,1984-04-15,LW,L,2011-12,69,9,6,15,0.22,-5,86,10.47,15,47593.0,11:29,2,5,7,28.57,59,24,20,17,3,0,0,0,242.0,0:3,2,0,2,5561.0,1:20,1075000
8470232,Kris,Newbury,1982-02-19,C,L,2011-12,7,0,0,0,0.0,-1,2,0.0,24,2472.0,5:53,6,11,17,35.29,14,1,0,0,0,0,0,0,24.0,0:3,0,0,0,0.0,0:0,-111
8470257,Alexander,Steen,1984-03-01,LW,L,2011-12,43,15,13,28,0.65,24,134,11.19,28,49347.0,19:7,53,42,95,55.79,24,29,22,14,8,3,2,5,6463.0,2:30,0,0,0,4391.0,1:42,3362500
8470265,Anton,Babchuk,1984-05-06,D,R,2011-12,32,2,8,10,0.31,2,48,4.17,6,27819.0,14:29,0,0,0,0.0,17,48,9,12,-3,1,2,3,4718.0,2:27,0,0,0,64.0,0:2,2500000
8470273,Ian,White,1984-06-04,D,R,2011-12,77,7,25,32,0.42,23,196,3.57,22,106178.0,22:58,0,0,0,0.0,49,92,20,32,-12,0,10,10,13822.0,2:59,0,0,0,4959.0,1:4,2875000
8470274,Chris,Higgins,1983-06-02,LW,L,2011-12,71,18,25,43,0.61,11,165,10.91,16,69504.0,16:18,12,18,30,40.0,61,29,50,16,34,1,7,8,7284.0,1:42,1,0,1,5072.0,1:11,1900000
8470280,Ben,Eager,1984-01-22,LW,L,2011-12,63,8,5,13,0.21,-1,69,11.59,107,32286.0,8:32,0,2,2,0.0,73,17,13,17,-4,0,0,0,193.0,0:3,0,0,0,22.0,0:0,1100000
8470281,Duncan,Keith,1983-07-16,D,L,2011-12,74,4,36,40,0.54,15,162,2.47,42,119412.0,26:53,0,0,0,0.0,45,121,48,50,-2,1,12,13,14037.0,3:9,0,2,2,10156.0,2:17,5538462
8470283,Tim,Brent,1984-03-10,C,R,2011-12,79,12,12,24,0.3,-8,71,16.9,27,51615.0,10:53,278,293,571,48.69,64,33,19,13,6,3,4,7,7350.0,1:33,1,0,1,2658.0,0:33,750000
8470289,Jim,Slater,1982-12-09,C,L,2011-12,78,13,8,21,0.27,-9,118,11.02,42,69091.0,14:45,634,531,1165,54.42,163,73,23,19,4,0,0,0,539.0,0:6,1,0,1,10366.0,2:12,1000000
8470294,DJ,King,1984-06-27,LW,L,2011-12,1,0,0,0,0.0,0,1,0.0,0,418.0,6:58,0,0,0,0.0,2,0,0,0,0,0,0,0,0.0,0:0,0,0,0,0.0,0:0,-111
8470299,Erik,Christensen,1983-12-17,C,L,2011-12,49,7,5,12,0.24,-13,44,15.91,8,30595.0,10:24,159,143,302,52.65,26,4,11,16,-5,3,1,4,4306.0,1:27,0,0,0,37.0,0:0,925000
8470301,Andre,Deveaux,1984-02-23,C,R,2011-12,9,0,1,1,0.11,3,2,0.0,29,2903.0,5:22,1,0,1,100.0,16,0,0,0,0,0,0,0,95.0,0:10,0,0,0,0.0,0:0,-111
8470302,Patrick,Dwyer,1983-06-22,RW,R,2011-12,73,5,7,12,0.16,0,120,4.17,23,67319.0,15:22,15,14,29,51.72,129,62,33,13,20,0,1,1,1159.0,0:15,2,0,2,8731.0,1:59,625000
8470309,Ryan,Whitney,1983-02-19,D,L,2011-12,51,3,17,20,0.39,-16,41,7.32,16,64147.0,20:57,0,0,0,0.0,18,85,16,54,-38,2,8,10,6902.0,2:15,0,0,0,2723.0,0:53,4000000
8470310,Aaron,Rome,1983-09-27,D,L,2011-12,43,4,6,10,0.23,-4,42,9.52,46,39284.0,15:13,0,0,0,0.0,64,62,4,13,-9,1,1,2,1378.0,0:32,0,0,0,1782.0,0:41,750000
8470317,Nate,Guenin,1982-12-10,D,R,2011-12,15,2,0,2,0.13,6,5,40.0,6,10037.0,11:9,0,0,0,0.0,26,17,2,3,-1,0,0,0,0.0,0:0,0,0,0,165.0,0:11,525000
8470318,Jonathan,Ericsson,1984-03-02,D,L,2011-12,69,1,10,11,0.16,16,63,1.59,47,70756.0,17:5,0,0,0,0.0,128,43,9,42,-33,0,0,0,433.0,0:6,0,0,0,8415.0,2:1,3250000
8470324,Josh,Gorges,1984-08-14,D,L,2011-12,82,2,14,16,0.2,14,59,3.39,39,111343.0,22:37,0,0,0,0.0,131,250,20,43,-23,0,0,0,2069.0,0:25,0,0,0,19153.0,3:53,2500000
8470329,Chris,Campoli,1984-07-09,D,L,2011-12,43,2,9,11,0.26,-3,43,4.65,8,44378.0,17:12,0,0,0,0.0,43,59,12,31,-19,0,3,3,5206.0,2:1,0,0,0,1695.0,0:39,1750000
8470358,Alexandre,Burrows,1981-04-11,RW,L,2011-12,80,28,24,52,0.65,24,198,14.14,90,88677.0,18:28,7,13,20,35.0,87,38,39,25,14,3,4,7,10303.0,2:8,2,0,2,9020.0,1:52,2000000
8470543,Chris,Kunitz,1979-09-26,LW,L,2011-12,82,26,35,61,0.74,16,230,11.3,49,90108.0,18:18,20,18,38,52.63,180,28,28,30,-2,6,12,18,17335.0,3:31,0,0,0,672.0,0:8,3725000
8470580,Jed,Ortmeyer,1978-09-03,RW,R,2011-12,35,1,1,2,0.06,-8,41,2.44,14,20409.0,9:43,4,5,9,44.44,53,14,14,2,12,0,0,0,45.0,0:1,0,0,0,2121.0,1:0,-111
8470595,Eric,Staal,1984-10-29,C,L,2011-12,82,24,46,70,0.85,-20,262,9.16,48,106013.0,21:32,882,799,1681,52.47,48,35,66,47,19,7,16,23,17899.0,3:38,3,2,5,7116.0,1:26,8250000
8470596,Nathan,Horton,1985-05-29,RW,R,2011-12,46,17,15,32,0.7,0,90,18.89,54,43975.0,15:55,2,1,3,66.67,32,11,12,12,0,6,2,8,7032.0,2:32,0,0,0,67.0,0:1,4000000
8470598,Thomas,Vanek,1984-01-19,LW,R,2011-12,78,26,35,61,0.78,-6,204,12.75,52,79256.0,16:56,3,3,6,50.0,34,22,24,43,-19,10,14,24,14248.0,3:2,0,0,0,1334.0,0:17,7142857
8470599,Milan,Michalek,1984-12-07,LW,L,2011-12,77,35,25,60,0.78,4,212,16.51,32,90337.0,19:33,1,5,6,16.67,36,46,39,18,21,10,5,15,13406.0,2:54,1,1,2,6819.0,1:28,4333333
8470600,Ryan,Suter,1985-01-21,D,L,2011-12,79,7,39,46,0.58,15,134,5.22,30,125635.0,26:30,0,1,1,0.0,46,116,37,42,-5,3,22,25,17506.0,3:41,1,1,2,11130.0,2:20,3500000
8470601,Braydon,Coburn,1985-02-27,D,L,2011-12,81,4,20,24,0.3,10,113,3.54,56,107132.0,22:2,0,1,1,0.0,164,119,33,43,-10,0,0,0,1733.0,0:21,0,2,2,16120.0,3:19,3200000
8470602,Dion,Phaneuf,1985-04-10,D,L,2011-12,82,12,32,44,0.54,-10,202,5.94,92,124423.0,25:17,0,0,0,0.0,214,127,30,76,-46,7,15,22,17501.0,3:33,0,1,1,12304.0,2:30,6500000
8470603,Andrei,Kostitsyn,1985-02-03,LW,L,2011-12,72,16,20,36,0.5,-1,122,13.11,26,65300.0,15:6,3,14,17,17.65,112,9,23,37,-14,5,1,6,7447.0,1:43,0,0,0,91.0,0:1,3250000
8470604,Jeff,Carter,1985-01-01,C,R,2011-12,55,21,13,34,0.62,-12,184,11.41,16,63305.0,19:11,393,381,774,50.78,16,17,26,20,6,10,3,13,10248.0,3:6,0,0,0,2442.0,0:44,5272727
8470606,Dustin,Brown,1984-11-04,RW,R,2011-12,82,22,32,54,0.66,18,214,10.28,53,99231.0,20:10,17,22,39,43.59,293,32,39,53,-14,9,7,16,16384.0,3:19,1,2,3,8216.0,1:40,3175000
8470607,Brent,Seabrook,1985-04-20,D,R,2011-12,78,9,25,34,0.44,21,156,5.77,22,115711.0,24:43,0,0,0,0.0,198,165,34,57,-23,2,2,4,10545.0,2:15,0,1,1,11562.0,2:28,5800000
8470609,Steve,Bernier,1985-03-31,RW,R,2011-12,32,1,5,6,0.19,6,23,4.35,16,22972.0,11:57,3,12,15,20.0,61,13,10,3,7,0,0,0,970.0,0:30,0,0,0,98.0,0:3,525000
8470610,Zach,Parise,1984-07-28,LW,L,2011-12,82,31,38,69,0.84,-5,293,10.58,32,105707.0,21:29,30,33,63,47.62,65,39,65,35,30,7,7,14,16956.0,3:26,3,4,7,9608.0,1:57,6000000
8470611,Eric,Fehr,1985-09-07,C,R,2011-12,35,2,1,3,0.09,-6,54,3.7,12,20369.0,9:41,0,0,0,0.0,22,13,6,4,2,0,0,0,910.0,0:26,0,0,0,19.0,0:0,2200000
8470612,Ryan,Getzlaf,1985-05-10,C,R,2011-12,82,11,46,57,0.7,-11,185,5.95,75,106269.0,21:35,639,715,1354,47.19,182,72,35,95,-60,4,19,23,18088.0,3:40,0,1,1,5150.0,1:2,5325000
8470613,Brent,Burns,1985-03-09,D,R,2011-12,81,11,26,37,0.46,8,201,5.47,34,109539.0,22:32,0,0,0,0.0,68,117,25,75,-50,5,11,16,13304.0,2:44,0,0,0,8647.0,1:46,3550000
8470614,Mark,Stuart,1984-04-27,D,L,2011-12,80,3,11,14,0.18,-4,60,5.0,98,82569.0,17:12,0,0,0,0.0,198,182,7,43,-36,0,0,0,150.0,0:1,1,0,1,14018.0,2:55,1700000
8470615,,,,,,2011-12,13,0,4,4,0.31,-2,19,0.0,2,8727.0,11:11,37,51,88,42.05,10,1,2,3,-1,0,0,0,27.0,0:2,0,0,0,0.0,0:0,-111
8470616,Ryan,Kesler,1984-08-31,C,R,2011-12,77,22,27,49,0.64,11,222,9.91,56,92824.0,20:5,724,627,1351,53.59,108,59,43,20,23,8,11,19,16081.0,3:28,1,1,2,9311.0,2:0,5000000
8470617,Mike,Richards,1985-02-11,C,L,2011-12,74,18,26,44,0.59,3,171,10.53,71,83856.0,18:53,539,528,1067,50.52,115,39,40,42,-2,3,11,14,13819.0,3:6,4,0,4,9073.0,2:2,5750000
8470618,Anthony,Stewart,1985-01-05,RW,R,2011-12,77,9,11,20,0.26,-2,64,14.06,30,37536.0,8:7,3,14,17,17.65,92,15,15,13,2,0,2,2,1684.0,0:21,0,0,0,38.0,0:0,900000
8470619,Brian,Boyle,1984-12-18,C,L,2011-12,82,11,15,26,0.32,2,165,6.67,59,74975.0,15:14,629,586,1215,51.77,236,83,25,15,10,0,1,1,4136.0,0:50,0,1,1,9804.0,1:59,1700000
8470621,Corey,Perry,1985-05-16,RW,R,2011-12,80,37,23,60,0.75,-7,277,13.36,127,102621.0,21:22,19,29,48,39.58,69,45,35,50,-15,14,9,23,17152.0,3:34,1,1,2,6154.0,1:16,5325000
8470622,Patrick,Eaves,1984-05-01,RW,R,2011-12,10,0,1,1,0.1,0,24,0.0,2,6628.0,11:2,2,3,5,40.0,21,7,2,1,1,0,0,0,101.0,0:10,0,0,0,1450.0,2:25,1200000
8470626,Loui,Eriksson,1985-07-17,LW,L,2011-12,82,26,45,71,0.87,18,187,13.9,12,97228.0,19:45,7,9,16,43.75,20,40,50,43,7,5,7,12,13035.0,2:38,2,1,3,8769.0,1:46,4250000
8470630,Kevin,Klein,1984-12-13,D,R,2011-12,66,4,17,21,0.32,-8,91,4.4,4,78967.0,19:56,0,0,0,0.0,84,151,25,50,-25,0,1,1,1097.0,0:16,0,1,1,9143.0,2:18,1350000
8470636,Josh,Hennessy,1985-02-07,C,L,2011-12,3,0,0,0,0.0,1,2,0.0,2,1219.0,6:46,8,5,13,61.54,2,0,0,0,0,0,0,0,0.0,0:0,0,0,0,20.0,0:6,600000
8470638,Patrice,Bergeron,1985-07-24,C,R,2011-12,81,22,42,64,0.79,36,191,11.52,20,90307.0,18:34,973,668,1641,59.29,73,67,55,25,30,5,9,14,12247.0,2:31,2,1,3,8802.0,1:48,5000000
8470640,Matt,Carle,1984-09-25,D,L,2011-12,82,4,34,38,0.46,4,132,3.03,36,113261.0,23:1,0,0,0,0.0,55,164,18,55,-37,3,9,12,12983.0,2:38,0,0,0,8491.0,1:43,3437500
8470642,Shea,Weber,1985-08-14,D,R,2011-12,78,19,30,49,0.63,21,230,8.26,46,122434.0,26:9,0,0,0,0.0,177,140,51,46,5,10,12,22,16507.0,3:31,2,0,2,10609.0,2:16,7500000
8470644,Colin,McDonald,1984-09-30,RW,R,2011-12,5,0,0,0,0.0,0,6,0.0,0,2541.0,8:28,0,0,0,0.0,8,0,1,0,1,0,0,0,166.0,0:33,0,0,0,0.0,0:0,525000
8470647,B.J.,Crombeen,1985-07-10,RW,R,2011-12,40,1,2,3,0.08,-2,50,2.0,71,19927.0,8:18,3,9,12,25.0,22,2,3,2,1,0,0,0,60.0,0:1,0,0,0,44.0,0:1,1000000
8470649,Patrick,O'Sullivan,1985-02-01,C,L,2011-12,23,2,2,4,0.17,-4,34,5.88,2,15248.0,11:2,5,4,9,55.56,7,4,6,2,4,0,1,1,2624.0,1:54,0,0,0,9.0,0:0,625000
8470654,Maxim,Lapierre,1985-03-29,C,R,2011-12,82,9,10,19,0.23,-3,103,8.74,130,55232.0,11:13,251,231,482,52.07,244,24,17,9,8,0,0,0,371.0,0:4,0,0,0,5580.0,1:8,1000000
8470655,David,Backes,1984-05-01,RW,R,2011-12,82,24,30,54,0.66,15,234,10.26,101,98390.0,19:59,658,695,1353,48.63,226,72,50,22,28,8,9,17,11826.0,2:24,2,1,3,8841.0,1:47,4500000
8470661,Jean-Francois,Jacques,1985-04-29,LW,L,2011-12,6,0,0,0,0.0,2,7,0.0,12,2384.0,6:37,0,0,0,0.0,6,0,0,0,0,0,0,0,0.0,0:0,0,0,0,0.0,0:0,650000
8470662,Colin,Fraser,1985-01-28,C,L,2011-12,67,2,6,8,0.12,-2,54,3.7,67,39135.0,9:44,175,195,370,47.3,149,25,16,12,4,0,0,0,447.0,0:6,0,0,0,4736.0,1:10,825000
8470666,Daniel,Carcillo,1985-01-28,LW,L,2011-12,28,2,9,11,0.39,10,27,7.41,82,19152.0,11:24,2,2,4,50.0,76,9,8,2,6,0,0,0,577.0,0:20,0,0,0,0.0,0:0,775000
8470667,Clarke,MacArthur,1985-04-06,LW,L,2011-12,73,20,23,43,0.59,3,148,13.51,37,69397.0,15:50,5,6,11,45.45,60,21,17,34,-17,3,6,9,8773.0,2:0,0,0,0,22.0,0:0,3250000
8470672,Ryan,O'Byrne,1984-07-19,D,R,2011-12,74,1,6,7,0.09,-5,42,2.38,57,83714.0,18:51,0,0,0,0.0,180,141,13,24,-11,0,0,0,127.0,0:1,0,0,0,12801.0,2:52,1800000
8470678,Alexandre,Picard,1985-07-05,D,L,2011-12,17,0,4,4,0.24,4,10,0.0,4,13405.0,13:8,0,0,0,0.0,12,14,4,3,1,0,0,0,458.0,0:26,0,0,0,231.0,0:13,600000
8470685,Alexander,Sulzer,1984-05-30,D,L,2011-12,27,3,6,9,0.33,8,33,9.09,8,28874.0,17:49,0,0,0,0.0,17,38,4,9,-5,0,1,1,572.0,0:21,0,0,0,801.0,0:29,-111
8470687,Zack,Stortini,1985-09-11,RW,R,2011-12,1,0,0,0,0.0,0,1,0.0,7,293.0,4:53,0,0,0,0.0,1,0,0,0,0,0,0,0,0.0,0:0,0,0,0,0.0,0:0,550000
8470697,Philippe,Dupuis,1985-04-24,C,R,2011-12,30,0,0,0,0.0,-2,30,0.0,16,18892.0,10:29,29,29,58,50.0,37,16,7,7,0,0,0,0,48.0,0:1,0,0,0,4404.0,2:26,-111
8470699,Jan,Hejda,1978-06-18,D,L,2011-12,81,5,14,19,0.23,-17,78,6.41,24,100518.0,20:40,1,0,1,100.0,142,134,27,44,-17,0,0,0,370.0,0:4,0,0,0,14824.0,3:3,3250000
8470700,Byron,Bitz,1984-07-21,RW,R,2011-12,10,1,3,4,0.4,2,6,16.67,14,6299.0,10:29,0,3,3,0.0,20,7,5,1,4,0,0,0,37.0,0:3,0,0,0,3.0,0:0,700000
8470708,Guillaume,Desbiens,1985-04-20,RW,R,2011-12,10,0,0,0,0.0,-1,2,0.0,25,4265.0,7:6,1,1,2,50.0,16,2,0,2,-2,0,0,0,0.0,0:0,0,0,0,0.0,0:0,-111
8470713,Paul,Bissonnette,1985-03-11,LW,L,2011-12,31,1,0,1,0.03,-4,15,6.67,41,11299.0,6:4,0,1,1,0.0,70,1,2,4,-2,0,0,0,19.0,0:0,0,0,0,0.0,0:0,612500
8470714,Corey,Potter,1984-01-05,D,R,2011-12,62,4,17,21,0.34,-16,98,4.08,24,74205.0,19:56,0,0,0,0.0,90,79,31,40,-9,1,10,11,9204.0,2:28,0,0,0,3201.0,0:51,525000
8470719,Alexandre,Bolduc,1985-06-26,C,L,2011-12,2,0,0,0,0.0,-1,1,0.0,2,859.0,7:9,1,0,1,100.0,1,0,0,0,0,0,0,0,0.0,0:0,0,0,0,0.0,0:0,575000
8470724,Kyle,Quincey,1985-08-12,D,L,2011-12,72,7,19,26,0.36,-1,168,4.17,89,94434.0,21:51,0,1,1,0.0,101,94,24,35,-11,4,6,10,10159.0,2:21,0,2,2,9937.0,2:18,3125000
8470729,Tyson,Strachan,1984-10-30,D,R,2011-12,15,1,2,3,0.2,1,14,7.14,5,12912.0,14:20,0,0,0,0.0,31,21,3,3,0,0,0,0,111.0,0:7,0,0,0,187.0,0:12,750000
8470737,Brett,Sterling,1984-04-24,LW,L,2011-12,4,0,0,0,0.0,-1,5,0.0,0,1815.0,7:33,3,1,4,75.0,1,0,1,1,0,0,0,0,298.0,1:14,0,0,0,0.0,0:0,-111
8470740,Lee,Stempniak,1983-02-04,RW,R,2011-12,61,14,14,28,0.46,-2,130,10.77,16,59398.0,16:13,7,19,26,26.92,55,22,35,27,8,2,3,5,6794.0,1:51,0,0,0,5184.0,1:24,1900000
8470750,John,Mitchell,1985-01-22,C,L,2011-12,63,5,11,16,0.25,10,64,7.81,8,38416.0,10:9,103,96,199,51.76,89,27,11,16,-5,0,2,2,2481.0,0:39,0,0,0,131.0,0:2,-111
8470755,Brad,Richardson,1985-02-04,C,L,2011-12,59,5,3,8,0.14,-6,98,5.1,30,45527.0,12:51,33,23,56,58.93,65,15,20,13,7,0,0,0,842.0,0:14,1,0,1,2717.0,0:46,1175000
8470760,Marc,Methot,1985-06-21,D,L,2011-12,46,1,6,7,0.15,-11,42,2.38,24,55344.0,20:3,0,0,0,0.0,106,52,10,13,-3,0,0,0,177.0,0:3,0,0,0,6344.0,2:17,3000000
8470774,Bruno,Gervais,1984-10-03,D,R,2011-12,50,6,7,13,0.26,-4,57,10.53,8,42802.0,14:16,0,0,0,0.0,42,63,17,14,3,1,1,2,2116.0,0:42,0,0,0,2381.0,0:47,525000
8470775,Nate,Thompson,1984-10-05,C,L,2011-12,68,9,6,15,0.22,-23,85,10.59,21,60477.0,14:49,293,299,592,49.49,107,56,29,14,15,0,0,0,580.0,0:8,0,0,0,11014.0,2:41,900000
8470777,Francis,Wathier,1984-12-07,LW,L,2011-12,1,0,0,0,0.0,0,0,,0,325.0,5:25,0,0,0,0.0,3,0,0,0,0,0,0,0,0.0,0:0,0,0,0,0.0,0:0,-111
8470778,Drew,Miller,1984-02-17,LW,L,2011-12,80,14,11,25,0.31,6,131,10.69,20,61794.0,12:52,5,20,25,20.0,79,66,26,9,17,0,0,0,450.0,0:5,0,0,0,9726.0,2:1,837500
8470780,Mark,Flood,1984-09-29,D,R,2011-12,33,3,4,7,0.21,-1,30,10.0,10,30390.0,15:20,0,0,0,0.0,10,43,2,8,-6,1,1,2,2017.0,1:1,0,0,0,2201.0,1:6,-111
8470794,Joe,Pavelski,1984-07-11,C,R,2011-12,82,31,30,61,0.74,18,269,11.52,31,101419.0,20:36,507,357,864,58.68,50,84,73,61,12,8,10,18,15759.0,3:12,1,0,1,7774.0,1:34,4000000
8470798,Dylan,Reese,1984-08-29,D,R,2011-12,28,1,6,7,0.25,0,26,3.85,11,28703.0,17:5,0,0,0,0.0,22,25,12,12,0,0,0,0,173.0,0:6,0,0,0,1228.0,0:43,635250
8470803,Kyle,Brodziak,1984-05-25,C,R,2011-12,82,22,22,44,0.54,-15,160,13.75,66,93801.0,19:3,707,722,1429,49.48,81,62,70,27,43,5,6,11,8257.0,1:40,0,0,0,11945.0,2:25,1150000
8470816,Jay,Rosehill,1985-07-16,LW,L,2011-12,31,0,0,0,0.0,-4,15,0.0,60,10990.0,5:54,1,3,4,25.0,53,5,3,6,-3,0,0,0,22.0,0:0,0,0,0,0.0,0:0,600000
8470828,Toby,Enstrom,1984-11-05,D,L,2011-12,62,6,27,33,0.53,6,94,6.38,38,88703.0,23:50,0,0,0,0.0,24,84,8,29,-21,2,9,11,12214.0,3:17,0,0,0,4389.0,1:10,3750000
8470834,Dustin,Byfuglien,1985-03-27,D,R,2011-12,66,12,41,53,0.8,-8,223,5.38,72,95496.0,24:6,0,0,0,0.0,112,57,49,55,-6,4,15,19,13827.0,3:29,0,1,1,1689.0,0:25,5200000
8470838,Andrew,Joudrey,1984-07-15,C,L,2011-12,1,0,0,0,0.0,0,1,0.0,0,556.0,9:16,1,0,1,100.0,0,2,0,0,0,0,0,0,0.0,0:0,0,0,0,0.0,0:0,-111
8470839,Shane,O'Brien,1983-08-09,D,L,2011-12,76,3,17,20,0.26,2,114,2.63,105,87642.0,19:13,0,0,0,0.0,138,86,28,33,-5,1,1,2,1970.0,0:25,0,1,1,7828.0,1:43,1100000
8470852,Matt,Moulson,1983-11-01,LW,L,2011-12,82,36,33,69,0.84,1,219,16.44,6,94968.0,19:18,2,2,4,50.0,33,40,57,32,25,14,10,24,15431.0,3:8,0,0,0,174.0,0:2,3133333
8470854,Tanner,Glass,1983-11-29,LW,L,2011-12,78,5,11,16,0.21,-12,86,5.81,73,62796.0,13:25,29,44,73,39.73,246,51,9,20,-11,0,0,0,477.0,0:6,0,0,0,8362.0,1:47,750000
8470871,Chris,Porter,1984-05-29,LW,L,2011-12,47,4,3,7,0.15,-1,61,6.56,11,29308.0,10:23,8,11,19,42.11,124,4,4,5,-1,0,0,0,131.0,0:2,0,0,0,615.0,0:13,600000
8470877,David,Jones,1984-08-10,RW,R,2011-12,72,20,17,37,0.51,-8,136,14.71,32,68041.0,15:45,16,18,34,47.06,85,24,21,10,11,3,3,6,8075.0,1:52,1,0,1,2848.0,0:39,-111
8470886,Clayton,Stoner,1985-02-19,D,L,2011-12,51,1,4,5,0.1,3,47,2.13,62,53839.0,17:35,0,0,0,0.0,72,80,14,23,-9,0,0,0,61.0,0:1,0,0,0,5097.0,1:39,550000
8470896,Steve,MacIntyre,1980-08-08,LW,L,2011-12,12,0,0,0,0.0,0,0,,6,2287.0,3:10,0,0,0,0.0,5,0,0,0,0,0,0,0,8.0,0:0,0,0,0,0.0,0:0,-111
8470905,Randy,Jones,1981-07-23,D,L,2011-12,39,1,1,2,0.05,4,24,4.17,8,34666.0,14:48,0,0,0,0.0,23,40,7,23,-16,0,0,0,139.0,0:3,0,0,0,3697.0,1:34,-111
8470920,David,Clarkson,1984-03-31,RW,R,2011-12,80,30,16,46,0.57,-8,228,13.16,138,78524.0,16:21,102,141,243,41.98,169,19,32,16,16,8,8,16,14659.0,3:3,0,0,0,84.0,0:1,2666667
8470966,Mark,Giordano,1983-10-03,D,L,2011-12,61,9,18,27,0.44,0,125,7.2,75,84254.0,23:1,0,0,0,0.0,84,127,26,51,-25,5,5,10,12318.0,3:21,0,1,1,8077.0,2:12,4020000
8470986,Darryl,Boyce,1984-07-07,C,L,2011-12,37,1,4,5,0.14,-8,25,4.0,35,22160.0,9:58,84,79,163,51.53,46,14,6,8,-2,0,0,0,103.0,0:2,0,0,0,2257.0,1:1,-111
8470988,Bryan,Rodney,1984-04-22,D,R,2011-12,1,0,0,0,0.0,-1,0,,0,797.0,13:17,0,0,0,0.0,1,0,0,0,0,0,0,0,102.0,1:42,0,0,0,0.0,0:0,-111
8471185,Curtis,Glencross,1982-12-28,LW,L,2011-12,67,26,22,48,0.72,-13,110,23.64,62,72455.0,18:1,41,41,82,50.0,81,49,39,46,-7,8,5,13,8249.0,2:3,1,1,2,8906.0,2:12,2550000
8471187,Brett,Lebda,1982-01-15,D,L,2011-12,30,1,3,4,0.13,-1,36,2.78,14,29658.0,16:28,0,0,0,0.0,21,21,7,9,-2,0,0,0,1540.0,0:51,0,0,0,1220.0,0:40,700000
8471208,Dustin,Penner,1982-09-28,RW,L,2011-12,65,7,10,17,0.26,-7,119,5.88,43,55851.0,14:19,14,18,32,43.75,90,16,27,38,-11,1,0,1,6048.0,1:33,0,0,0,159.0,0:2,4250000
8471214,Alex,Ovechkin,1985-09-17,LW,R,2011-12,78,38,27,65,0.83,-8,303,12.54,26,92665.0,19:48,6,9,15,40.0,215,42,34,51,-17,13,10,23,17006.0,3:38,0,0,0,121.0,0:1,9538462
8471215,Evgeni,Malkin,1986-07-31,C,L,2011-12,75,50,59,109,1.45,18,339,14.75,70,94606.0,21:1,575,635,1210,47.52,29,41,52,73,-21,12,22,34,19616.0,4:21,0,0,0,185.0,0:2,8700000
8471216,Cam,Barker,1986-04-04,D,L,2011-12,25,2,0,2,0.08,0,35,5.71,23,27541.0,18:21,0,0,0,0.0,36,19,2,18,-16,1,0,1,3481.0,2:19,0,0,0,555.0,0:22,3083333
8471217,Andrew,Ladd,1985-12-12,LW,L,2011-12,82,28,22,50,0.61,-8,265,10.57,64,96264.0,19:33,32,27,59,54.24,76,25,40,43,-3,4,8,12,12861.0,2:36,0,0,0,7578.0,1:32,4400000
8471218,Blake,Wheeler,1986-08-31,RW,R,2011-12,80,17,47,64,0.8,3,208,8.17,55,91562.0,19:4,4,6,10,40.0,113,46,50,33,17,6,9,15,12650.0,2:38,0,0,0,861.0,0:10,2550000
8471220,Rostislav,Olesz,1985-10-10,LW,L,2011-12,6,0,0,0,0.0,-1,6,0.0,6,3278.0,9:6,0,2,2,0.0,7,1,0,1,-1,0,0,0,4.0,0:0,0,0,0,0.0,0:0,3125000
8471222,Ladislav,Smid,1986-02-01,D,L,2011-12,78,5,10,15,0.19,4,47,10.64,44,97832.0,20:54,0,0,0,0.0,186,184,31,47,-16,0,0,0,281.0,0:3,0,1,1,15780.0,3:22,2250000
8471226,Drew,Stafford,1985-10-30,RW,R,2011-12,80,20,30,50,0.62,5,226,8.85,46,84710.0,17:38,45,41,86,52.33,102,22,40,40,0,3,4,7,10827.0,2:15,1,0,1,4783.0,0:59,4000000
8471228,Alexander,Radulov,1986-07-05,RW,L,2011-12,9,3,4,7,0.78,3,21,14.29,4,10448.0,19:20,0,0,0,0.0,5,5,5,4,1,0,1,1,878.0,1:37,0,0,0,7.0,0:0,984200
8471229,Petteri,Nokelainen,1986-01-16,C,R,2011-12,56,3,4,7,0.12,-6,37,8.11,37,29572.0,8:48,165,144,309,53.4,46,10,6,6,0,0,0,0,562.0,0:10,0,0,0,4490.0,1:20,550000
8471231,Kyle,Chipchura,1986-02-19,C,L,2011-12,53,3,13,16,0.3,2,43,6.98,42,33470.0,10:31,174,190,364,47.8,67,14,13,6,7,0,0,0,165.0,0:3,0,0,0,849.0,0:16,550000
8471232,Lauri,Korpikoski,1986-07-28,LW,L,2011-12,82,17,20,37,0.45,3,146,11.64,14,84318.0,17:8,23,64,87,26.44,91,43,24,24,0,0,2,2,3556.0,0:43,3,0,3,12837.0,2:36,1800000
8471233,Travis,Zajac,1985-05-13,C,R,2011-12,15,2,4,6,0.4,-3,25,8.0,4,15637.0,17:22,118,86,204,57.84,11,3,12,6,6,1,0,1,1056.0,1:10,0,0,0,1183.0,1:18,3887500
8471234,Wojtek,Wolski,1986-02-24,LW,L,2011-12,31,4,8,12,0.39,-5,50,8.0,2,25599.0,13:45,5,5,10,50.0,34,5,10,7,3,0,1,1,2752.0,1:28,0,0,0,1.0,0:0,3800000
8471236,Andrej,Meszaros,1985-10-13,D,L,2011-12,62,7,18,25,0.4,6,114,6.14,38,76872.0,20:39,0,0,0,0.0,144,88,21,30,-9,2,1,3,5208.0,1:24,0,0,0,8973.0,2:24,4000000
8471240,Jeff,Schultz,1986-02-25,D,L,2011-12,54,1,5,6,0.11,-2,22,4.55,12,49545.0,15:17,0,0,0,0.0,49,58,10,33,-23,0,0,0,36.0,0:0,0,0,0,4345.0,1:20,2750000
8471241,Mark,Fistric,1986-06-01,D,L,2011-12,60,0,2,2,0.03,-3,30,0.0,41,59435.0,16:30,1,0,1,100.0,235,105,10,19,-9,0,0,0,58.0,0:0,0,0,0,8000.0,2:13,1000000
8471242,Mike,Green,1985-10-12,D,R,2011-12,32,3,4,7,0.22,5,64,4.69,12,40403.0,21:2,0,0,0,0.0,27,44,23,30,-7,3,1,4,5220.0,2:43,0,0,0,2271.0,1:10,5250000
8471245,Dave,Bolland,1986-06-05,C,R,2011-12,76,19,18,37,0.49,0,126,15.08,47,75247.0,16:30,582,621,1203,48.38,58,38,53,25,28,7,5,12,9062.0,1:59,3,0,3,8057.0,1:46,3375000
8471254,Bryan,Bickell,1986-03-09,LW,L,2011-12,71,9,15,24,0.34,-3,84,10.71,48,51704.0,12:8,0,1,1,0.0,128,23,21,22,-1,0,0,0,2019.0,0:28,0,0,0,11.0,0:0,541667
8471260,Blake,Comeau,1986-02-18,LW,R,2011-12,74,5,10,15,0.2,-11,137,3.65,30,68600.0,15:27,29,62,91,31.87,144,22,37,33,4,0,0,0,2933.0,0:39,0,0,0,5704.0,1:17,2500000
8471261,Dane,Byers,1986-02-21,LW,L,2011-12,8,0,0,0,0.0,0,8,0.0,29,3882.0,8:5,0,0,0,0.0,4,4,2,0,2,0,0,0,0.0,0:0,0,0,0,438.0,0:54,550000
8471266,David,Booth,1984-11-24,LW,L,2011-12,62,16,14,30,0.48,-5,159,10.06,34,55541.0,14:55,9,9,18,50.0,81,13,20,25,-5,3,5,8,6587.0,1:46,0,0,0,112.0,0:1,4250000
8471268,Victor,Oreskovich,1986-08-15,RW,R,2011-12,1,0,0,0,0.0,0,0,,7,377.0,6:17,0,0,0,0.0,1,0,0,0,0,0,0,0,25.0,0:25,0,0,0,0.0,0:0,605000
8471269,Nicklas,Grossmann,1985-01-22,D,L,2011-12,74,0,11,11,0.15,5,56,0.0,36,83541.0,18:48,0,0,0,0.0,164,152,8,32,-24,0,0,0,363.0,0:4,0,0,0,9856.0,2:13,1625000
8471273,Brandon,Dubinsky,1986-04-29,C,L,2011-12,77,10,24,34,0.44,16,140,7.14,110,75181.0,16:16,205,190,395,51.9,207,36,37,21,16,0,2,2,8219.0,1:46,1,2,3,5778.0,1:15,4200000
8471274,Alex,Goligoski,1985-07-30,D,L,2011-12,71,9,21,30,0.42,0,140,6.43,16,97006.0,22:46,0,0,0,0.0,49,93,19,46,-27,2,7,9,13425.0,3:9,0,1,1,5457.0,1:16,1833333
8471276,David,Krejci,1986-04-28,C,R,2011-12,79,23,39,62,0.78,-5,145,15.86,36,87326.0,18:25,544,501,1045,52.06,69,46,43,34,9,2,9,11,11567.0,2:26,0,0,0,3425.0,0:43,3750000
8471279,Sami,Lepisto,1984-10-17,D,L,2011-12,26,1,2,3,0.12,3,19,5.26,4,16482.0,10:33,0,0,0,0.0,24,9,8,8,0,0,0,0,274.0,0:10,0,0,0,101.0,0:3,700000
8471280,Nick,Johnson,1985-12-24,RW,R,2011-12,77,8,18,26,0.34,-6,146,5.48,45,66757.0,14:26,3,10,13,23.08,59,21,33,17,16,0,1,1,1778.0,0:23,0,0,0,34.0,0:0,-111
8471283,Brandon,Prust,1984-03-16,LW,L,2011-12,82,5,12,17,0.21,-1,68,7.35,156,58766.0,11:56,3,2,5,60.0,144,51,15,23,-8,0,0,0,329.0,0:4,2,0,2,8211.0,1:40,800000
8471284,Andrej,Sekera,1986-06-08,D,L,2011-12,69,3,10,13,0.19,3,88,3.41,18,81155.0,19:36,0,1,1,0.0,56,93,25,30,-5,1,0,1,3582.0,0:51,0,0,0,6724.0,1:37,2750000
8471296,Alexei,Emelin,1986-04-25,D,L,2011-12,67,3,4,7,0.1,-18,62,4.84,30,69526.0,17:17,0,0,0,0.0,236,88,13,46,-33,0,0,0,691.0,0:10,1,1,2,5247.0,1:18,984200
8471299,Peter,Regin,1986-04-16,C,L,2011-12,10,2,2,4,0.4,3,15,13.33,2,8456.0,14:5,29,30,59,49.15,6,3,1,2,-1,0,0,0,568.0,0:56,0,0,0,489.0,0:48,1000000
8471303,Alexander,Edler,1986-04-21,D,L,2011-12,82,11,38,49,0.6,0,228,4.82,34,117414.0,23:51,0,3,3,0.0,143,145,32,51,-19,5,17,22,16948.0,3:26,1,0,1,11136.0,2:15,3250000
8471309,Johan,Franzen,1979-12-23,RW,L,2011-12,77,29,27,56,0.73,23,211,13.74,40,81809.0,17:42,79,100,179,44.13,60,30,30,35,-5,11,2,13,13614.0,2:56,0,0,0,152.0,0:1,3954545
8471311,Tyler,Kennedy,1986-07-15,C,R,2011-12,60,11,22,33,0.55,10,195,5.64,29,51735.0,14:22,42,47,89,47.19,70,10,19,11,8,0,3,3,5046.0,1:24,0,0,0,55.0,0:0,2000000
8471312,JT,Wyman,1986-02-27,RW,R,2011-12,40,2,9,11,0.28,1,31,6.45,8,25311.0,10:32,22,35,57,38.6,33,15,8,2,6,0,0,0,143.0,0:3,0,0,0,2785.0,1:9,-111
8471314,Mike,Lundin,1984-09-24,D,L,2011-12,17,0,2,2,0.12,-1,9,0.0,4,20611.0,20:12,0,0,0,0.0,3,35,0,4,-4,0,0,0,595.0,0:35,0,0,0,2564.0,2:30,1000000
8471321,Brett,Carson,1985-11-29,D,R,2011-12,2,0,0,0,0.0,-2,1,0.0,0,1363.0,11:21,0,0,0,0.0,0,1,0,0,0,0,0,0,0.0,0:0,0,0,0,33.0,0:16,575000
8471323,Ryan,Jones,1984-06-14,LW,L,2011-12,79,17,16,33,0.42,-7,137,12.41,42,73117.0,15:25,3,12,15,20.0,119,61,46,47,-1,3,3,6,4030.0,0:51,2,1,3,11700.0,2:28,1500000
8471331,Kevin,Porter,1986-03-12,C,L,2011-12,35,4,3,7,0.2,-2,32,12.5,17,19283.0,9:10,14,32,46,30.43,36,8,13,6,7,0,0,0,1016.0,0:29,0,0,0,613.0,0:17,850000
8471338,Torrey,Mitchell,1985-01-30,C,R,2011-12,76,9,10,19,0.25,-6,100,9.0,29,56706.0,12:26,36,47,83,43.37,94,33,33,27,6,0,0,0,684.0,0:9,0,0,0,2824.0,0:37,1366667
8471339,Ryan,Callahan,1985-03-21,RW,R,2011-12,76,29,25,54,0.71,-8,235,12.34,61,95929.0,21:2,10,10,20,50.0,271,88,51,16,35,13,4,17,16895.0,3:42,1,2,3,8276.0,1:48,4275000
8471346,Kris,Versteeg,1986-05-13,RW,R,2011-12,71,23,31,54,0.76,4,181,12.71,49,84816.0,19:54,21,44,65,32.31,52,19,62,36,26,8,10,18,14383.0,3:22,1,0,1,2749.0,0:38,3083333
8471348,Nikita,Nikitin,1986-06-16,D,L,2011-12,61,7,25,32,0.52,-10,103,6.8,18,84901.0,23:11,0,0,0,0.0,47,114,24,30,-6,3,6,9,10191.0,2:47,0,1,1,10037.0,2:44,600000
8471352,Jake,Dowell,1985-03-04,C,L,2011-12,52,2,5,7,0.13,-3,39,5.13,53,23815.0,7:37,94,103,197,47.72,80,11,9,11,-2,0,0,0,62.0,0:1,0,0,0,1494.0,0:28,-111
8471362,Mikhail,Grabovski,1984-01-31,C,L,2011-12,74,23,28,51,0.69,0,163,14.11,51,78178.0,17:36,466,439,905,51.49,56,32,49,45,4,5,5,10,9303.0,2:5,0,0,0,1273.0,0:17,2900000
8471365,Steven,Zalewski,1986-08-20,C,L,2011-12,7,0,0,0,0.0,-2,6,0.0,0,4435.0,10:33,22,22,44,50.0,11,1,1,1,0,0,0,0,89.0,0:12,0,0,0,18.0,0:2,-111
8471371,Mike,Brown,1985-06-24,RW,R,2011-12,50,2,2,4,0.08,-8,56,3.57,74,27830.0,9:16,0,1,1,0.0,120,24,10,9,1,0,0,0,92.0,0:1,0,1,1,1897.0,0:37,736667
8471385,Adam,Pardy,1984-03-29,D,L,2011-12,36,0,3,3,0.08,-5,29,0.0,16,35574.0,16:28,0,0,0,0.0,39,49,9,9,0,0,0,0,194.0,0:5,0,0,0,1777.0,0:49,2000000
8471386,Scott,Parse,1984-09-05,LW,R,2011-12,9,2,0,2,0.22,1,9,22.22,14,6091.0,11:16,1,2,3,33.33,7,4,3,2,1,1,0,1,299.0,0:33,0,0,0,0.0,0:0,-111
8471388,Patrick,Kaleta,1986-06-08,RW,R,2011-12,63,5,5,10,0.16,-5,69,7.25,116,49725.0,13:9,10,9,19,52.63,139,46,19,17,2,0,0,0,180.0,0:2,0,0,0,7263.0,1:55,907500
8471390,Mike,Santorelli,1985-12-14,C,R,2011-12,60,9,2,11,0.18,-10,117,7.69,18,44654.0,12:24,176,213,389,45.24,49,17,15,10,5,2,1,3,3945.0,1:5,0,0,0,127.0,0:2,1600000
8471392,Roman,Polak,1986-04-28,D,R,2011-12,77,0,11,11,0.14,6,88,0.0,57,87163.0,18:51,0,0,0,0.0,173,141,15,21,-6,0,0,0,371.0,0:4,0,0,0,10891.0,2:21,2750000
8471402,Lennart,Petrell,1984-04-13,LW,L,2011-12,60,4,5,9,0.15,-10,36,11.11,45,34680.0,9:38,7,15,22,31.82,122,47,20,21,-1,0,0,0,93.0,0:1,1,1,2,4035.0,1:7,-111
8471409,Andrew,Gordon,1985-12-13,RW,R,2011-12,37,2,3,5,0.14,-10,38,5.26,6,24098.0,10:51,0,5,5,0.0,49,17,8,7,1,0,0,0,203.0,0:5,0,0,0,4592.0,2:4,537500
8471419,Mark,Mancari,1985-07-11,RW,R,2011-12,6,0,0,0,0.0,0,5,0.0,0,2992.0,8:18,0,2,2,0.0,5,0,1,1,0,0,0,0,0.0,0:0,0,0,0,0.0,0:0,-111
8471426,Troy,Brouwer,1985-08-17,RW,R,2011-12,82,18,15,33,0.4,-15,133,13.53,61,84508.0,17:10,38,45,83,45.78,247,60,39,22,17,3,2,5,10514.0,2:8,0,1,1,7457.0,1:30,2350000
8471428,Pierre-Luc,Letourneau-Leblond,1985-06-04,RW,L,2011-12,3,0,0,0,0.0,1,3,0.0,10,874.0,4:51,0,0,0,0.0,2,0,0,1,-1,0,0,0,9.0,0:3,0,0,0,0.0,0:0,525000
8471436,Matt,Hunwick,1985-05-21,D,L,2011-12,33,3,3,6,0.18,-3,40,7.5,8,35756.0,18:3,0,1,1,0.0,24,30,11,19,-8,0,0,0,2118.0,1:4,0,0,0,2213.0,1:7,1550000
8471450,Brandon,Yip,1985-04-25,RW,R,2011-12,35,3,4,7,0.2,1,41,7.32,28,22424.0,10:40,2,5,7,28.57,51,10,8,4,4,0,0,0,1013.0,0:28,0,0,0,113.0,0:3,-111
8471451,Aaron,Gagnon,1986-04-24,C,R,2011-12,7,0,0,0,0.0,-1,6,0.0,0,3968.0,9:26,18,22,40,45.0,1,4,1,0,1,0,0,0,0.0,0:0,0,0,0,24.0,0:3,-111
8471476,Daniel,Winnik,1985-03-06,LW,L,2011-12,84,8,15,23,0.27,-11,184,4.35,52,84133.0,16:41,33,33,66,50.0,95,50,55,24,31,0,0,0,1591.0,0:18,1,1,2,12337.0,2:26,950000
8471482,Grant,Clitsome,1985-04-14,D,L,2011-12,63,4,13,17,0.27,-9,87,4.6,32,64272.0,17:0,0,1,1,0.0,85,61,15,30,-15,1,4,5,7131.0,1:53,0,1,1,3002.0,0:47,1250000
8471483,Kyle,Wilson,1984-12-15,C,R,2011-12,5,0,0,0,0.0,-1,2,0.0,0,2443.0,8:8,0,1,1,0.0,7,1,1,3,-2,0,0,0,0.0,0:0,0,0,0,55.0,0:11,550000
8471490,Adam,Cracknell,1985-07-15,RW,R,2011-12,2,1,0,1,0.5,1,1,100.0,0,917.0,7:38,0,1,1,0.0,1,3,1,0,1,0,0,0,0.0,0:0,0,0,0,73.0,0:36,575000
8471498,Jannik,Hansen,1986-03-15,RW,R,2011-12,82,16,23,39,0.48,18,137,11.68,34,73294.0,14:53,12,17,29,41.38,118,24,39,23,16,0,0,0,701.0,0:8,1,2,3,10560.0,2:8,1350000
8471504,Rene,Bourque,1981-12-10,RW,L,2011-12,76,18,6,24,0.32,-19,158,11.39,68,81290.0,17:49,12,8,20,60.0,86,25,32,27,5,3,3,6,11125.0,2:26,1,0,1,8414.0,1:50,3333333
8471514,Rich,Peverley,1982-07-08,C,R,2011-12,57,11,31,42,0.74,20,112,9.82,22,57776.0,16:53,203,129,332,61.14,23,13,20,22,-2,1,10,11,9375.0,2:44,0,2,2,5702.0,1:40,1325000
8471521,Brad,Staubitz,1984-07-28,RW,R,2011-12,62,1,0,1,0.02,-5,27,3.7,121,24260.0,6:31,3,3,6,50.0,96,20,7,5,2,0,0,0,31.0,0:0,0,0,0,43.0,0:0,575000
8471634,Ryan,Shannon,1983-03-02,RW,R,2011-12,45,4,8,12,0.27,-11,46,8.7,10,32488.0,12:1,22,18,40,55.0,22,15,16,9,7,1,2,3,2435.0,0:54,0,0,0,1157.0,0:25,-111
8471636,Tim,Sestito,1984-08-28,LW,L,2011-12,18,0,0,0,0.0,-5,6,0.0,7,8912.0,8:15,31,44,75,41.33,28,5,1,3,-2,0,0,0,46.0,0:2,0,0,0,154.0,0:8,525000
8471657,Cody,McLeod,1984-06-26,LW,L,2011-12,75,6,5,11,0.15,0,62,9.68,164,32373.0,7:11,2,1,3,66.67,123,13,12,3,9,0,0,0,138.0,0:1,0,0,0,198.0,0:2,1033333
8471663,Mike,Blunden,1986-12-15,RW,R,2011-12,39,2,2,4,0.1,-1,34,5.88,27,21909.0,9:21,2,3,5,40.0,104,15,8,2,6,0,0,0,105.0,0:2,0,0,0,695.0,0:17,615000
8471664,Mason,Raymond,1985-09-17,LW,L,2011-12,55,10,10,20,0.36,4,125,8.0,18,51435.0,15:35,7,18,25,28.0,32,13,20,12,8,1,0,1,3776.0,1:8,1,0,1,2979.0,0:54,2550000
8471668,Mattias,Ritola,1987-03-14,C,L,2011-12,5,0,0,0,0.0,-2,14,0.0,6,3250.0,10:50,2,1,3,66.67,4,1,0,0,0,0,0,0,329.0,1:5,0,0,0,383.0,1:16,-111
8471669,Paul,Stastny,1985-12-27,C,L,2011-12,79,21,32,53,0.67,-8,190,11.05,34,89265.0,18:49,789,635,1424,55.41,40,49,59,24,35,7,12,19,11154.0,2:21,0,0,0,2924.0,0:37,6600000
8471670,Guillaume,Latendresse,1987-05-24,LW,L,2011-12,16,5,4,9,0.56,6,36,13.89,20,14583.0,15:11,2,2,4,50.0,37,3,12,6,6,1,0,1,2453.0,2:33,0,0,0,0.0,0:0,2500000
8471675,Sidney,Crosby,1987-08-07,C,L,2011-12,22,8,29,37,1.68,15,75,10.67,14,24383.0,18:28,227,226,453,50.11,11,7,10,15,-5,2,9,11,5124.0,3:52,0,0,0,166.0,0:7,8700000
8471676,Bobby,Ryan,1987-03-17,RW,R,2011-12,82,31,26,57,0.7,1,204,15.2,53,90288.0,18:21,20,49,69,28.99,113,24,35,49,-14,3,8,11,10613.0,2:9,2,0,2,3508.0,0:42,5100000
8471677,Jack,Johnson,1987-01-13,D,L,2011-12,82,12,26,38,0.46,-7,176,6.82,39,116949.0,23:46,0,0,0,0.0,107,129,21,44,-23,5,12,17,19798.0,4:1,0,0,0,9336.0,1:53,4357143
8471678,Benoit,Pouliot,1986-09-29,LW,L,2011-12,74,16,16,32,0.43,18,107,14.95,38,54214.0,12:12,8,10,18,44.44,97,14,37,8,29,1,1,2,4761.0,1:4,0,0,0,38.0,0:0,1100000
8471680,Gilbert,Brule,1987-01-01,C,R,2011-12,33,5,9,14,0.42,7,56,8.93,11,22897.0,11:33,8,13,21,38.1,55,13,10,10,0,1,0,1,2164.0,1:5,0,0,0,0.0,0:0,1850000
8471681,Jack,Skille,1987-05-19,RW,R,2011-12,46,4,6,10,0.22,-9,76,5.26,28,33026.0,11:57,8,8,16,50.0,99,16,10,6,4,0,0,0,667.0,0:14,1,0,1,931.0,0:20,825000
8471682,Devin,Setoguchi,1987-01-01,RW,R,2011-12,69,19,17,36,0.52,-17,174,10.92,28,72844.0,17:35,3,8,11,27.27,73,23,31,23,8,7,6,13,11566.0,2:47,0,0,0,15.0,0:0,3000000
8471683,Brian,Lee,1987-03-26,D,R,2011-12,55,1,15,16,0.29,-8,32,3.12,35,51264.0,15:32,0,0,0,0.0,127,62,9,25,-16,0,0,0,878.0,0:15,0,0,0,4851.0,1:28,875000
8471685,Anze,Kopitar,1987-08-24,C,L,2011-12,82,25,51,76,0.93,12,230,10.87,20,104987.0,21:20,763,655,1418,53.81,72,53,76,56,20,8,18,26,16708.0,3:23,2,2,4,11037.0,2:14,6800000
8471686,Marc,Staal,1987-01-13,D,L,2011-12,46,2,3,5,0.11,-7,61,3.28,16,54902.0,19:53,0,0,0,0.0,55,68,14,19,-5,1,1,2,1331.0,0:28,0,1,1,4779.0,1:43,3975000
8471689,Ryan,O'Marra,1987-06-09,C,R,2011-12,9,0,1,1,0.11,-1,7,0.0,4,5010.0,9:16,36,29,65,55.38,19,7,2,2,0,0,0,0,26.0,0:2,0,0,0,273.0,0:30,735000
8471691,Martin,Hanzal,1987-02-20,C,L,2011-12,64,8,26,34,0.53,12,145,5.52,63,70827.0,18:26,571,526,1097,52.05,239,32,41,22,19,3,8,11,11306.0,2:56,0,0,0,5888.0,1:32,1800000
8471693,Jakub,Kindl,1987-02-10,D,L,2011-12,55,1,12,13,0.24,7,69,1.45,25,46377.0,14:3,0,0,0,0.0,61,32,15,19,-4,0,1,1,2067.0,0:37,0,0,0,894.0,0:16,883333
8471694,Kenndal,McArdle,1987-01-04,LW,L,2011-12,9,0,0,0,0.0,-3,3,0.0,4,3299.0,6:6,0,0,0,0.0,10,4,3,3,0,0,0,0,5.0,0:0,0,0,0,0.0,0:0,600000
8471697,Niclas,Bergfors,1987-03-07,RW,R,2011-12,11,1,1,2,0.18,-2,11,9.09,2,5328.0,8:4,0,0,0,0.0,0,5,4,2,2,0,0,0,397.0,0:36,0,0,0,0.0,0:0,575000
8471698,T.J.,Oshie,1986-12-23,RW,R,2011-12,80,19,35,54,0.68,15,188,10.11,50,93741.0,19:31,24,29,53,45.28,130,45,61,14,47,3,13,16,11918.0,2:28,1,1,2,8681.0,1:48,2350000
8471699,Andrew,Cogliano,1987-06-14,LW,L,2011-12,82,13,13,26,0.32,-4,115,11.3,15,72353.0,14:42,162,224,386,41.97,88,43,32,32,0,2,1,3,2756.0,0:33,0,0,0,7894.0,1:36,2390000
8471701,Joe,Finley,1987-06-29,D,L,2011-12,5,0,0,0,0.0,-3,1,0.0,12,2338.0,7:47,0,0,0,0.0,3,0,0,1,-1,0,0,0,0.0,0:0,0,0,0,10.0,0:2,533333
8471702,Matt,Niskanen,1986-12-06,D,R,2011-12,75,4,17,21,0.28,9,118,3.39,47,80725.0,17:56,0,0,0,0.0,105,69,13,20,-7,3,5,8,9971.0,2:12,0,0,0,2189.0,0:29,1500000
8471703,Steve,Downie,1987-04-03,RW,R,2011-12,75,14,27,41,0.55,-6,140,10.0,137,71692.0,15:55,40,47,87,45.98,105,25,49,32,17,2,4,6,8695.0,1:55,0,0,0,39.0,0:0,1850000
8471705,Brendan,Mikkelson,1987-06-22,D,L,2011-12,41,1,2,3,0.07,-4,45,2.22,13,35425.0,14:24,0,0,0,0.0,42,44,4,15,-11,0,1,1,3342.0,1:21,0,0,0,332.0,0:8,721875
8471707,James,Neal,1987-09-03,LW,L,2011-12,80,40,41,81,1.01,6,329,12.16,87,91845.0,19:8,4,11,15,26.67,108,15,30,26,4,18,12,30,18856.0,3:55,0,0,0,88.0,0:1,2875000
8471709,Marc-Edouard,Vlasic,1987-03-30,D,L,2011-12,82,4,19,23,0.28,11,119,3.36,40,113935.0,23:9,0,0,0,0.0,45,171,18,44,-26,0,1,1,2735.0,0:33,0,1,1,10461.0,2:7,3100000
8471710,Taylor,Chorney,1987-04-27,D,L,2011-12,5,0,0,0,0.0,-1,2,0.0,0,4243.0,14:8,0,0,0,0.0,0,4,3,3,0,0,0,0,386.0,1:17,0,0,0,86.0,0:17,735000
8471714,Michael,Sauer,1987-08-07,D,R,2011-12,19,1,2,3,0.16,9,14,7.14,21,21355.0,18:43,0,0,0,0.0,21,31,11,5,6,0,0,0,336.0,0:17,0,0,0,2082.0,1:49,1250000
8471716,Justin,Abdelkader,1987-02-25,LW,L,2011-12,81,8,14,22,0.27,4,121,6.61,62,59847.0,12:18,239,213,452,52.88,148,42,16,14,2,0,0,0,632.0,0:7,0,0,0,6894.0,1:25,787500
8471717,Adam,McQuaid,1986-10-12,D,R,2011-12,72,2,8,10,0.14,16,63,3.17,99,64594.0,14:57,0,0,0,0.0,104,101,9,18,-9,0,0,0,216.0,0:3,0,0,0,4476.0,1:2,575000
8471719,Matt,Kassian,1986-10-28,LW,L,2011-12,24,2,0,2,0.08,-2,13,15.38,55,7986.0,5:32,0,0,0,0.0,32,5,1,2,-1,0,0,0,14.0,0:0,0,0,0,0.0,0:0,512500
8471724,Kris,Letang,1987-04-24,D,R,2011-12,51,10,32,42,0.82,21,142,7.04,34,76006.0,24:50,0,0,0,0.0,83,86,28,34,-6,4,11,15,12544.0,4:5,1,1,2,5082.0,1:39,3500000
8471729,Kris,Russell,1987-05-02,D,L,2011-12,55,6,6,12,0.22,12,56,10.71,25,56143.0,17:0,0,0,0,0.0,61,78,16,13,3,0,1,1,6083.0,1:50,0,0,0,1078.0,0:19,1300000
8471730,Evan,Brophey,1986-12-03,C,L,2011-12,3,0,0,0,0.0,0,0,,0,752.0,4:10,3,2,5,60.0,4,0,0,0,0,0,0,0,0.0,0:0,0,0,0,0.0,0:0,-111
8471735,Keith,Yandle,1986-09-09,D,L,2011-12,82,11,32,43,0.52,5,196,5.61,51,109903.0,22:20,0,0,0,0.0,31,77,24,75,-51,0,11,11,16976.0,3:27,0,0,0,815.0,0:9,5250000
8471741,Teemu,Laakso,1987-08-27,D,R,2011-12,9,0,0,0,0.0,-1,4,0.0,8,6258.0,11:35,0,0,0,0.0,7,7,0,6,-6,0,0,0,22.0,0:2,0,0,0,313.0,0:34,-111
8471742,Cody,Franson,1987-08-08,D,R,2011-12,57,5,16,21,0.37,-1,65,7.69,22,55371.0,16:11,0,0,0,0.0,102,53,20,45,-25,2,5,7,5215.0,1:31,0,0,0,199.0,0:3,800000
8471743,Vladimir,Sobotka,1987-07-02,LW,L,2011-12,73,5,15,20,0.27,12,117,4.27,42,69394.0,15:50,281,220,501,56.09,152,29,29,11,18,0,1,1,2824.0,0:38,1,0,1,8428.0,1:55,1300000
8471748,Mark,Fraser,1986-09-29,D,L,2011-12,4,0,0,0,0.0,-2,0,,14,3441.0,14:20,0,0,0,0.0,6,3,2,0,2,0,0,0,5.0,0:1,0,0,0,572.0,2:23,550000
8471752,Marc-Andre,Gragnani,1987-03-11,D,L,2011-12,58,2,13,15,0.26,6,47,4.26,26,56179.0,16:8,1,0,1,100.0,19,41,10,33,-23,1,6,7,8346.0,2:23,0,0,0,506.0,0:8,550000
8471760,Cody,Bass,1987-01-07,C,R,2011-12,14,0,1,1,0.07,0,13,0.0,32,7633.0,9:5,5,3,8,62.5,22,7,4,4,0,0,0,0,70.0,0:5,0,0,0,714.0,0:51,600000
8471761,Chris,Butler,1986-10-27,D,L,2011-12,68,2,13,15,0.22,-9,62,3.23,34,88160.0,21:36,0,0,0,0.0,70,115,17,50,-33,0,3,3,2978.0,0:43,0,0,0,9118.0,2:14,1250000
8471762,Chris,VandeVelde,1987-03-15,C,L,2011-12,5,1,0,1,0.2,2,1,100.0,2,2958.0,9:51,18,22,40,45.0,4,3,2,1,1,0,0,0,0.0,0:0,0,0,0,569.0,1:53,745000
8471766,Jared,Boll,1986-05-13,RW,R,2011-12,54,2,1,3,0.06,-8,35,5.71,126,26303.0,8:7,3,2,5,60.0,96,10,7,3,4,0,0,0,221.0,0:4,0,0,0,0.0,0:0,725000
8471767,Blair,Jones,1986-09-27,C,R,2011-12,43,3,5,8,0.19,-1,58,5.17,18,29305.0,11:21,128,174,302,42.38,49,29,18,13,5,0,1,1,1993.0,0:46,0,0,0,1991.0,0:46,525000
8471768,Tom,Pyatt,1987-02-14,LW,L,2011-12,74,12,7,19,0.26,-19,95,12.63,8,65687.0,14:47,128,153,281,45.55,40,52,17,13,4,1,0,1,1677.0,0:22,0,0,0,9749.0,2:11,525000
8471769,Niklas,Hjalmarsson,1987-06-06,D,L,2011-12,69,1,14,15,0.22,9,65,1.54,14,83544.0,20:10,0,0,0,0.0,42,142,30,51,-21,0,0,0,400.0,0:5,0,1,1,9814.0,2:22,3500000
8471794,Darren,Helm,1987-01-21,LW,L,2011-12,68,9,17,26,0.38,5,124,7.26,12,59211.0,14:30,403,374,777,51.87,97,27,27,18,9,0,0,0,737.0,0:10,0,0,0,9367.0,2:17,912500
8471804,Nathan,Gerbe,1987-07-24,C,L,2011-12,62,6,19,25,0.4,2,137,4.38,32,52852.0,14:12,7,12,19,36.84,53,13,18,17,1,0,1,1,1328.0,0:21,0,1,1,1596.0,0:25,1450000
8471807,Tom,Wandell,1987-01-29,C,L,2011-12,72,6,9,15,0.21,-5,103,5.83,16,42066.0,9:44,141,183,324,43.52,52,30,37,15,22,0,0,0,2127.0,0:29,0,0,0,653.0,0:9,775000
8471810,Derek,Joslin,1987-03-17,D,L,2011-12,44,2,2,4,0.09,-15,36,5.56,35,27941.0,10:35,1,0,1,100.0,47,30,6,4,2,0,1,1,1495.0,0:33,0,0,0,1391.0,0:31,700000
8471811,Cal,O'Reilly,1986-09-30,C,L,2011-12,33,2,5,7,0.21,-11,17,11.76,4,25267.0,12:45,120,148,268,44.78,5,10,10,6,4,1,1,2,2824.0,1:25,0,0,0,450.0,0:13,1050000
8471816,Mark,Fayne,1987-05-15,D,R,2011-12,82,4,13,17,0.21,-4,94,4.26,26,99332.0,20:11,0,0,0,0.0,84,88,20,35,-15,0,2,2,7435.0,1:30,0,1,1,7063.0,1:26,542500
8471817,Ryan,Reaves,1987-01-20,RW,R,2011-12,60,3,1,4,0.07,0,32,9.38,124,23511.0,6:31,1,1,2,50.0,171,7,11,3,8,0,0,0,115.0,0:1,0,0,0,51.0,0:0,525000
8471821,Matt,Watkins,1986-11-22,RW,L,2011-12,1,0,0,0,0.0,-1,0,,0,397.0,6:37,0,5,5,0.0,1,0,0,0,0,0,0,0,0.0,0:0,0,0,0,0.0,0:0,-111
8471840,Brett,Sutter,1987-06-02,LW,L,2011-12,15,0,3,3,0.2,-1,11,0.0,11,6816.0,7:34,14,7,21,66.67,23,1,3,3,0,0,0,0,27.0,0:1,0,0,0,246.0,0:16,525000
8471842,Tim,Kennedy,1986-04-30,LW,L,2011-12,27,1,1,2,0.07,-11,22,4.55,4,18036.0,11:8,64,77,141,45.39,48,11,9,7,2,0,0,0,710.0,0:26,0,0,0,268.0,0:9,550000
8471846,Kris,Fredheim,1987-02-23,D,R,2011-12,3,0,0,0,0.0,-2,0,,2,2156.0,11:58,0,0,0,0.0,1,5,1,0,1,0,0,0,0.0,0:0,0,0,0,163.0,0:54,-111
8471851,Matt,D'Agostini,1986-10-23,RW,R,2011-12,55,9,9,18,0.33,12,101,8.91,27,46264.0,14:1,8,21,29,27.59,48,18,19,8,11,3,0,3,5822.0,1:45,0,0,0,65.0,0:1,1650000
8471856,Joe,Vitale,1985-08-20,C,R,2011-12,68,4,10,14,0.21,-5,70,5.71,56,45610.0,11:10,403,320,723,55.74,106,36,17,8,9,0,0,0,200.0,0:2,0,1,1,2760.0,0:40,512500
8471859,Sergei,Kostitsyn,1987-03-20,LW,L,2011-12,75,17,26,43,0.57,8,97,17.53,34,74108.0,16:28,0,6,6,0.0,44,27,31,30,1,1,8,9,5770.0,1:16,1,0,1,4132.0,0:55,2500000
8471862,Colin,Greening,1986-03-09,C,L,2011-12,82,17,20,37,0.45,-4,184,9.24,46,76709.0,15:35,26,36,62,41.94,189,48,31,27,4,4,4,8,8679.0,1:45,0,0,0,799.0,0:9,816666
8471868,Ryan,Russell,1987-05-02,LW,L,2011-12,41,2,0,2,0.05,-7,39,5.13,2,28725.0,11:40,0,5,5,0.0,37,44,11,8,3,0,0,0,253.0,0:6,0,0,0,4410.0,1:47,-111
8471873,Anton,Stralman,1986-08-01,D,R,2011-12,53,2,16,18,0.34,9,55,3.64,20,54376.0,17:5,0,0,0,0.0,76,71,11,12,-1,0,4,4,3853.0,1:12,0,0,0,1924.0,0:36,900000
8471885,Chad,Rau,1987-01-18,C,R,2011-12,9,2,0,2,0.22,-1,7,28.57,0,5880.0,10:53,35,30,65,53.85,2,5,6,1,5,0,0,0,481.0,0:53,0,0,0,6.0,0:0,-111
8471887,Patric,Hornqvist,1987-01-01,RW,R,2011-12,76,27,16,43,0.57,9,230,11.74,28,69910.0,15:19,6,3,9,66.67,62,28,28,12,16,8,2,10,11667.0,2:33,0,0,0,30.0,0:0,3083333
8471916,Mike,Angelidis,1985-06-27,LW,L,2011-12,6,1,0,1,0.17,-1,8,12.5,5,2339.0,6:29,4,3,7,57.14,6,2,3,1,2,0,0,0,0.0,0:0,0,0,0,0.0,0:0,525000
8471941,Mike,Duco,1987-07-08,RW,L,2011-12,6,0,2,2,0.33,1,4,0.0,5,2900.0,8:3,0,0,0,0.0,17,2,2,1,1,0,0,0,6.0,0:1,0,0,0,0.0,0:0,-111
8471956,Andrew,Desjardins,1986-07-27,LW,L,2011-12,76,4,13,17,0.22,4,80,5.0,47,43692.0,9:34,192,170,362,53.04,93,49,37,25,12,0,0,0,130.0,0:1,0,1,1,3838.0,0:50,540000
8471958,Dan,Girardi,1984-04-29,D,R,2011-12,82,5,24,29,0.35,13,122,4.1,20,129140.0,26:14,0,0,0,0.0,211,185,37,61,-24,1,9,10,8670.0,1:45,0,1,1,16258.0,3:18,3325000
8471976,David,Desharnais,1986-09-14,C,L,2011-12,81,16,44,60,0.74,10,98,16.33,24,89410.0,18:23,678,693,1371,49.45,33,48,36,24,12,3,17,20,15994.0,3:17,0,0,0,2230.0,0:27,850000
8471978,Brett,Festerling,1986-03-03,D,L,2011-12,5,0,0,0,0.0,-1,2,0.0,2,3935.0,13:7,0,0,0,0.0,7,3,0,2,-2,0,0,0,0.0,0:0,0,0,0,312.0,1:2,577500
8471996,Bracken,Kearns,1981-05-12,C,L,2011-12,5,0,0,0,0.0,0,0,,10,2171.0,7:14,1,1,2,50.0,6,1,1,0,1,0,0,0,0.0,0:0,0,0,0,0.0,0:0,700000
8472262,Clay,Wilson,1983-04-05,D,L,2011-12,5,0,0,0,0.0,0,7,0.0,4,3975.0,13:15,0,0,0,0.0,1,2,1,3,-2,0,0,0,577.0,1:55,0,0,0,39.0,0:7,-111
8472355,Rod,Pelley,1984-09-01,C,L,2011-12,52,2,1,3,0.06,-3,44,4.55,16,24205.0,7:45,125,129,254,49.21,80,25,6,5,1,0,0,0,54.0,0:1,0,0,0,976.0,0:18,-111
8472361,Bill,Thomas,1983-06-20,RW,R,2011-12,7,1,0,1,0.14,0,9,11.11,0,3671.0,8:44,0,3,3,0.0,10,1,1,0,1,0,0,0,36.0,0:5,0,0,0,168.0,0:24,-111
8472368,Chris,Conner,1983-12-23,RW,L,2011-12,8,1,2,3,0.38,2,10,10.0,0,5070.0,10:33,0,0,0,0.0,4,3,4,0,4,0,0,0,0.0,0:0,0,0,0,731.0,1:31,550000
8472379,Tim,Stapleton,1982-07-19,C,R,2011-12,63,11,16,27,0.43,-2,74,14.86,10,38353.0,10:8,97,119,216,44.91,27,23,21,6,15,4,7,11,6333.0,1:40,0,0,0,123.0,0:1,-111
8472382,Andy,Greene,1982-10-30,D,L,2011-12,56,1,15,16,0.29,3,53,1.89,16,65538.0,19:30,0,0,0,0.0,35,96,15,15,0,0,1,1,1479.0,0:26,0,0,0,6066.0,1:48,3000000
8472394,Peter,Harrold,1983-06-08,D,R,2011-12,11,0,2,2,0.18,0,11,0.0,0,9638.0,14:36,0,0,0,0.0,3,11,1,2,-1,0,1,1,498.0,0:45,0,0,0,133.0,0:12,550000
8472410,Stephen,Gionta,1983-10-09,RW,R,2011-12,1,1,0,1,1.0,1,2,50.0,0,637.0,10:37,5,3,8,62.5,1,1,0,0,0,0,0,0,0.0,0:0,0,0,0,0.0,0:0,512500
8472424,Ryan,Hamilton,1985-04-15,LW,L,2011-12,2,0,1,1,0.5,-1,1,0.0,2,1576.0,13:8,0,0,0,0.0,5,0,2,0,2,0,0,0,0.0,0:0,0,0,0,0.0,0:0,525000
8473412,Bryan,Little,1987-11-12,C,R,2011-12,74,24,22,46,0.62,-11,162,14.81,26,89766.0,20:13,733,746,1479,49.56,44,13,44,21,23,6,7,13,12260.0,2:45,0,1,1,6705.0,1:30,2383333
8473419,Brad,Marchand,1988-05-11,LW,L,2011-12,76,28,27,55,0.72,31,167,16.77,87,80359.0,17:37,5,4,9,55.56,72,21,40,41,-1,5,1,6,9852.0,2:9,1,2,3,6348.0,1:23,2500000
8473422,Nick,Foligno,1987-10-31,LW,L,2011-12,82,15,32,47,0.57,2,153,9.8,124,72053.0,14:38,62,87,149,41.61,196,30,35,26,9,1,3,4,6515.0,1:19,0,0,0,820.0,0:10,1200000
8473426,Mike,Weber,1987-12-16,D,L,2011-12,51,1,4,5,0.1,-19,51,1.96,64,56841.0,18:34,0,0,0,0.0,123,90,14,34,-20,0,0,0,205.0,0:4,0,0,0,5384.0,1:45,950000
8473432,Derek,Dorsett,1986-12-20,RW,R,2011-12,77,12,8,20,0.26,-11,137,8.76,235,67884.0,14:41,14,14,28,50.0,199,40,36,12,24,2,1,3,3653.0,0:47,1,0,1,8381.0,1:48,562500
8473444,Jon,Matsumoto,1986-10-13,C,L,2011-12,1,0,0,0,0.0,0,0,,0,304.0,5:4,1,0,1,100.0,0,0,0,0,0,0,0,0,15.0,0:15,0,0,0,0.0,0:0,-111
8473446,Erik,Johnson,1988-03-21,D,R,2011-12,73,4,22,26,0.36,-7,155,2.58,26,91284.0,20:50,0,0,0,0.0,123,94,35,44,-9,1,11,12,10150.0,2:19,0,0,0,6892.0,1:34,2600000
8473449,Kyle,Okposo,1988-04-16,RW,R,2011-12,79,24,21,45,0.57,-15,152,15.79,46,80898.0,17:4,68,74,142,47.89,51,33,62,30,32,3,3,6,7957.0,1:40,0,0,0,458.0,0:5,2800000
8473453,Trevor,Lewis,1987-01-08,C,R,2011-12,72,3,4,7,0.1,-3,103,2.91,26,57183.0,13:14,87,112,199,43.72,117,25,25,20,5,0,0,0,1102.0,0:15,0,0,0,7477.0,1:43,725000
8473456,Rhett,Rakhshani,1988-03-06,RW,R,2011-12,5,0,0,0,0.0,0,3,0.0,2,3644.0,12:8,0,0,0,0.0,1,1,2,1,1,0,0,0,261.0,0:52,0,0,0,0.0,0:0,-111
8473459,Arturs,Kulda,1988-07-25,D,L,2011-12,9,0,0,0,0.0,3,8,0.0,4,5870.0,10:52,0,0,0,0.0,13,8,0,3,-3,0,0,0,0.0,0:0,0,0,0,6.0,0:0,-111
8473465,Jamie,McGinn,1988-08-05,LW,L,2011-12,78,20,17,37,0.47,-3,159,12.58,37,62931.0,13:26,6,1,7,85.71,159,37,29,25,4,6,2,8,3477.0,0:44,0,0,0,1058.0,0:13,680000
8473466,Ryan,White,1988-03-17,C,R,2011-12,20,0,3,3,0.15,-7,12,0.0,61,17420.0,14:31,29,30,59,49.15,61,17,5,4,1,0,0,0,148.0,0:7,0,1,1,2550.0,2:7,625000
8473473,Milan,Lucic,1988-06-07,LW,L,2011-12,81,26,35,61,0.75,7,149,17.45,135,82761.0,17:1,14,16,30,46.67,201,26,25,46,-21,7,4,11,10829.0,2:13,0,0,0,124.0,0:1,4083333
8473482,Jiri,Tlusty,1988-03-16,LW,L,2011-12,79,17,19,36,0.46,1,136,12.5,26,70654.0,14:54,3,8,11,27.27,83,57,31,20,11,2,4,6,4054.0,0:51,0,1,1,4627.0,0:58,525000
8473484,Kaspars,Daugavins,1988-05-18,LW,L,2011-12,65,5,6,11,0.17,-2,77,6.49,12,44192.0,11:19,23,37,60,38.33,58,33,27,24,3,0,1,1,506.0,0:7,0,1,1,7694.0,1:58,600000
8473485,Chris,Stewart,1987-10-30,RW,R,2011-12,79,15,15,30,0.38,1,166,9.04,109,73178.0,15:26,3,10,13,23.08,112,21,17,24,-7,2,2,4,7362.0,1:33,0,0,0,410.0,0:5,2875000
8473492,Matt,Beleskey,1988-06-07,LW,L,2011-12,70,4,11,15,0.21,-2,75,5.33,72,43113.0,10:15,11,15,26,42.31,104,20,10,10,0,0,1,1,1088.0,0:15,0,0,0,128.0,0:1,737500
8473493,Ben,Maxwell,1988-03-30,C,L,2011-12,15,1,5,6,0.4,4,10,10.0,2,6060.0,6:44,26,33,59,44.07,11,6,0,1,-1,0,0,0,64.0,0:4,0,0,0,119.0,0:7,715000
8473501,Ty,Wishart,1988-05-19,D,L,2011-12,1,0,0,0,0.0,0,0,,0,1036.0,17:16,0,0,0,0.0,1,0,0,0,0,0,0,0,0.0,0:0,0,0,0,53.0,0:53,803250
8473504,Cal,Clutterbuck,1987-11-18,RW,R,2011-12,74,15,12,27,0.36,-4,161,9.32,103,72623.0,16:21,5,10,15,33.33,288,31,28,21,7,3,4,7,9394.0,2:6,4,0,4,6598.0,1:29,1400000
8473507,Jeff,Petry,1987-12-09,D,R,2011-12,73,2,23,25,0.34,-7,111,1.8,26,95311.0,21:45,0,0,0,0.0,126,126,36,89,-53,1,5,6,5606.0,1:16,0,0,0,10902.0,2:29,850000
8473511,David,McIntyre,1987-02-04,C,L,2011-12,7,1,1,2,0.29,-1,6,16.67,2,4584.0,10:54,2,5,7,28.57,8,3,1,1,0,0,0,0,7.0,0:1,0,0,0,358.0,0:51,-111
8473512,Claude,Giroux,1988-01-12,C,R,2011-12,77,28,65,93,1.21,6,242,11.57,29,99534.0,21:32,828,715,1543,53.66,70,44,50,44,6,6,32,38,18081.0,3:54,0,2,2,10346.0,2:14,3750000
8473525,Theo,Peckham,1987-11-10,D,L,2011-12,54,1,2,3,0.06,0,25,4.0,80,54678.0,16:52,0,0,0,0.0,94,72,18,27,-9,0,0,0,181.0,0:3,0,0,0,8689.0,2:40,-111
8473526,Peter,Mueller,1988-04-14,C,R,2011-12,32,7,9,16,0.5,-3,82,8.54,8,28133.0,14:39,6,4,10,60.0,14,10,10,12,-2,1,4,5,2966.0,1:32,0,0,0,50.0,0:1,2000000
8473533,Jordan,Staal,1988-09-10,C,L,2011-12,62,25,25,50,0.81,11,149,16.78,34,74606.0,20:3,591,567,1158,51.04,101,23,39,26,13,5,2,7,7405.0,1:59,3,2,5,9808.0,2:38,4000000
8473534,Patrik,Berglund,1988-06-02,C,L,2011-12,82,19,19,38,0.46,4,188,10.11,30,88378.0,17:57,567,601,1168,48.54,97,36,39,24,15,0,4,4,11649.0,2:22,2,0,2,7531.0,1:31,2250000
8473537,Viktor,Stalberg,1986-01-17,LW,L,2011-12,79,22,21,43,0.54,6,215,10.23,34,66693.0,14:4,5,6,11,45.45,91,24,51,21,30,0,0,0,2145.0,0:27,0,0,0,139.0,0:1,875000
8473539,Carl,Sneep,1987-11-05,D,R,2011-12,1,0,1,1,1.0,1,0,,0,979.0,16:19,0,0,0,0.0,2,1,0,0,0,0,0,0,0.0,0:0,0,0,0,12.0,0:12,597500
8473542,Tom,Sestito,1987-09-28,LW,L,2011-12,14,0,1,1,0.07,-3,4,0.0,83,5791.0,6:53,2,2,4,50.0,37,2,0,0,0,0,0,0,38.0,0:2,0,0,0,0.0,0:0,550000
8473544,Derick,Brassard,1987-09-22,C,L,2011-12,74,14,27,41,0.55,-20,125,11.2,42,72535.0,16:20,278,339,617,45.06,137,16,35,28,7,5,10,15,13581.0,3:3,0,0,0,546.0,0:7,3200000
8473546,Michael,Grabner,1987-10-05,RW,L,2011-12,78,20,12,32,0.41,-18,174,11.49,12,72746.0,15:32,3,2,5,60.0,16,30,94,45,49,1,1,2,3694.0,0:47,1,0,1,7900.0,1:41,3000000
8473548,Phil,Kessel,1987-10-02,RW,R,2011-12,82,37,45,82,1.0,-10,295,12.54,20,98671.0,20:3,9,19,28,32.14,12,21,39,82,-43,10,13,23,16453.0,3:20,0,0,0,438.0,0:5,5400000
8473558,Cory,Emmerton,1988-06-01,C,L,2011-12,71,6,4,10,0.14,1,63,9.52,14,34512.0,8:6,151,162,313,48.24,37,31,16,7,9,0,1,1,335.0,0:4,0,0,0,2189.0,0:30,533333
8473562,John,McCarthy,1986-08-09,C,L,2011-12,10,0,0,0,0.0,-2,14,0.0,10,5661.0,9:26,18,25,43,41.86,10,1,2,1,1,0,0,0,40.0,0:4,0,0,0,0.0,0:0,525000
8473563,Nicklas,Backstrom,1987-11-23,C,L,2011-12,42,14,30,44,1.05,-4,95,14.74,24,48294.0,19:9,353,338,691,51.09,31,25,28,18,10,3,16,19,8410.0,3:20,0,0,0,2535.0,1:0,6700000
8473564,Michael,Frolik,1988-02-17,RW,L,2011-12,63,5,10,15,0.24,-10,117,4.27,22,48661.0,12:52,16,32,48,33.33,56,32,41,6,35,0,0,0,681.0,0:10,0,1,1,3973.0,1:3,2333333
8473565,Brian,Strait,1988-01-04,D,L,2011-12,9,0,1,1,0.11,-2,4,0.0,4,6959.0,12:53,0,0,0,0.0,12,12,0,5,-5,0,0,0,0.0,0:0,0,0,0,215.0,0:23,601667
8473568,Andreas,Nodl,1987-02-28,RW,L,2011-12,60,3,5,8,0.13,-5,66,4.55,8,42171.0,11:42,3,5,8,37.5,68,17,22,12,10,0,0,0,299.0,0:4,0,0,0,1782.0,0:29,-111
8473569,Jan,Mursak,1988-01-20,LW,R,2011-12,25,1,2,3,0.12,2,22,4.55,0,11335.0,7:33,1,2,3,33.33,21,11,4,4,0,0,0,0,130.0,0:5,0,0,0,0.0,0:0,-111
8473571,Jamie,McBain,1988-02-25,D,R,2011-12,76,8,19,27,0.36,-7,127,6.3,4,90273.0,19:47,0,0,0,0.0,15,106,30,40,-10,5,6,11,11750.0,2:34,0,0,0,2972.0,0:39,685000
8473573,Artem,Anisimov,1988-05-24,C,L,2011-12,79,16,20,36,0.46,12,132,12.12,34,73003.0,15:24,161,184,345,46.67,75,46,37,14,23,4,0,4,7653.0,1:36,1,0,1,4986.0,1:3,1875000
8473574,Shawn,Matthias,1988-02-19,LW,L,2011-12,79,10,14,24,0.3,-2,133,7.52,49,65458.0,13:48,295,302,597,49.41,60,38,25,13,12,1,1,2,2830.0,0:35,0,0,0,5297.0,1:7,851625
8473579,Nikolay,Kulemin,1986-07-14,LW,L,2011-12,70,7,21,28,0.4,2,107,6.54,6,63943.0,15:13,32,46,78,41.03,97,43,34,23,11,1,4,5,3625.0,0:51,0,1,1,5122.0,1:13,2350000
8473584,Andrew,MacDonald,1986-09-07,D,L,2011-12,75,5,14,19,0.25,-5,71,7.04,26,105187.0,23:22,0,0,0,0.0,48,185,50,56,-6,1,1,2,6086.0,1:21,0,0,0,9894.0,2:11,550000
8473588,Erik,Condra,1986-08-06,RW,R,2011-12,81,8,17,25,0.31,11,140,5.71,30,68840.0,14:9,11,16,27,40.74,16,69,48,23,25,0,0,0,396.0,0:4,2,2,4,13457.0,2:46,625000
8473589,Chris,Summers,1988-02-05,D,L,2011-12,21,0,3,3,0.14,-4,10,0.0,11,15689.0,12:27,0,0,0,0.0,50,19,2,2,0,0,0,0,0.0,0:0,0,0,0,1492.0,1:11,850000
8473592,Vladimir,Zharkov,1988-01-10,RW,L,2011-12,4,0,0,0,0.0,-2,0,,0,1171.0,4:52,0,0,0,0.0,1,0,0,1,-1,0,0,0,36.0,0:9,0,0,0,0.0,0:0,-111
8473600,Benn,Ferriero,1987-04-29,RW,R,2011-12,35,7,1,8,0.23,0,68,10.29,8,25304.0,12:2,3,9,12,25.0,43,13,9,3,6,0,0,0,659.0,0:18,0,0,0,32.0,0:0,605000
8473604,Jonathan,Toews,1988-04-29,C,L,2011-12,59,29,28,57,0.97,17,185,15.68,28,73786.0,20:50,675,462,1137,59.37,32,14,82,25,57,5,7,12,11609.0,3:16,1,2,3,6636.0,1:52,6300000
8473608,Blake,Geoffrion,1988-02-03,C,L,2011-12,35,2,3,5,0.14,0,29,6.9,27,23185.0,11:2,68,77,145,46.9,40,13,13,9,4,0,0,0,558.0,0:15,0,0,0,1540.0,0:44,850000
8473610,Bobby,Sanguinetti,1988-02-29,D,R,2011-12,3,0,0,0,0.0,0,5,0.0,0,2149.0,11:56,0,0,0,0.0,1,2,0,1,-1,0,0,0,511.0,2:50,0,0,0,2.0,0:0,600000
8473618,Mathieu,Perreault,1988-01-05,C,L,2011-12,64,16,14,30,0.47,9,60,26.67,24,46182.0,12:1,229,222,451,50.78,49,29,33,12,21,2,0,2,3862.0,1:0,0,0,0,79.0,0:1,525000
8473646,Ryan,Carter,1983-08-03,LW,L,2011-12,72,4,4,8,0.11,-13,50,8.0,90,44727.0,10:21,215,217,432,49.77,114,25,19,9,10,0,0,0,261.0,0:3,0,0,0,3872.0,0:53,750000
8473647,Frédéric,St-Denis,1986-01-23,D,L,2011-12,17,1,2,3,0.18,3,11,9.09,10,14811.0,14:31,0,0,0,0.0,7,21,6,9,-3,0,0,0,608.0,0:35,0,0,0,1376.0,1:20,-111
8473673,David,Schlemko,1987-05-07,D,L,2011-12,46,1,10,11,0.24,7,58,1.72,10,50665.0,18:21,0,0,0,0.0,52,88,5,20,-15,0,0,0,1005.0,0:21,0,0,0,5568.0,2:1,550000
8473682,Andrew,Ebbett,1983-01-02,C,L,2011-12,18,5,1,6,0.33,2,27,18.52,6,10350.0,9:35,15,13,28,53.57,15,9,4,3,1,1,0,1,829.0,0:46,0,0,0,389.0,0:21,525000
8473700,Ryan,Wilson,1987-02-03,D,L,2011-12,59,1,20,21,0.36,11,63,1.59,33,66319.0,18:44,0,1,1,0.0,97,70,33,28,5,0,4,4,2151.0,0:36,0,0,0,4626.0,1:18,1275000
8473712,Frazer,McLaren,1987-10-29,LW,L,2011-12,7,0,0,0,0.0,0,2,0.0,9,2049.0,4:52,0,0,0,0.0,6,2,2,0,2,0,0,0,0.0,0:0,0,0,0,0.0,0:0,575000
8473722,John,Scott,1982-09-26,LW,L,2011-12,35,0,1,1,0.03,-1,9,0.0,53,14071.0,6:42,0,0,0,0.0,39,10,8,10,-2,0,0,0,16.0,0:0,0,0,0,338.0,0:9,512500
8473734,Tim,Wallace,1984-08-06,RW,R,2011-12,49,3,6,9,0.18,-3,26,11.54,16,25271.0,8:35,8,12,20,40.0,104,11,14,9,5,0,0,0,301.0,0:6,0,0,0,505.0,0:10,-111
8473867,Greg,Rallo,1981-08-26,C,R,2011-12,1,0,0,0,0.0,0,1,0.0,0,211.0,3:31,0,0,0,0.0,0,0,0,1,-1,0,0,0,0.0,0:0,0,0,0,0.0,0:0,-111
8473898,Paul,Szczechura,1985-11-30,C,R,2011-12,9,1,3,4,0.44,0,11,9.09,4,6176.0,11:26,28,39,67,41.79,7,3,1,1,0,0,0,0,6.0,0:0,0,0,0,7.0,0:0,-111
8473908,Kevin,Westgarth,1984-02-07,RW,R,2011-12,25,1,1,2,0.08,-3,13,7.69,39,7892.0,5:15,0,1,1,0.0,31,6,1,7,-6,0,0,0,20.0,0:0,0,0,0,0.0,0:0,525000
8473913,Sean,Collins,1983-10-30,D,R,2011-12,2,0,0,0,0.0,-1,3,0.0,0,1312.0,10:56,0,0,0,0.0,0,1,0,0,0,0,0,0,0.0,0:0,0,0,0,29.0,0:14,-111
8473914,Mark,Letestu,1985-02-04,C,R,2011-12,62,11,14,25,0.4,-9,114,9.65,8,58208.0,15:38,375,347,722,51.94,60,19,32,8,24,4,4,8,9654.0,2:35,0,0,0,2994.0,0:48,625000
8473921,Joe,Piskula,1984-07-05,D,L,2011-12,5,0,0,0,0.0,-5,2,0.0,2,3269.0,10:53,0,0,0,0.0,6,5,0,1,-1,0,0,0,0.0,0:0,0,0,0,22.0,0:4,525000
8473927,Brad,Mills,1983-05-03,C,R,2011-12,27,0,1,1,0.04,-10,18,0.0,32,11627.0,7:10,77,49,126,61.11,36,3,4,0,4,0,0,0,39.0,0:1,0,0,0,1258.0,0:46,525000
8473932,Darroll,Powe,1985-06-22,C,L,2011-12,82,6,7,13,0.16,-20,109,5.5,57,68800.0,13:59,46,59,105,43.81,151,91,22,11,11,0,0,0,311.0,0:3,0,0,0,12067.0,2:27,1066667
8473933,Ben,Lovejoy,1984-02-20,D,R,2011-12,34,1,4,5,0.15,3,48,2.08,13,27030.0,13:15,0,0,0,0.0,30,37,1,8,-7,0,0,0,78.0,0:2,0,0,0,1075.0,0:31,525000
8473942,Trevor,Smith,1985-02-08,C,L,2011-12,16,2,3,5,0.31,2,17,11.76,4,11967.0,12:27,34,49,83,40.96,19,7,3,3,0,0,0,0,531.0,0:33,0,1,1,892.0,0:55,525000
8473953,Derek,Smith,1984-10-13,D,L,2011-12,47,2,9,11,0.23,-1,44,4.55,12,44939.0,15:56,0,0,0,0.0,27,55,14,21,-7,0,4,4,2843.0,1:0,0,0,0,909.0,0:19,700000
8473962,Teddy,Purcell,1985-09-08,LW,R,2011-12,81,24,41,65,0.8,9,152,15.79,16,78402.0,16:7,3,14,17,17.65,17,11,34,36,-2,8,11,19,12413.0,2:33,0,0,0,210.0,0:2,2362500
8473970,Rob,Klinkhammer,1986-08-12,LW,L,2011-12,15,0,2,2,0.13,0,26,0.0,2,10299.0,11:26,2,1,3,66.67,47,3,7,3,4,0,0,0,34.0,0:2,0,0,0,1056.0,1:10,525000
8473991,Karl,Alzner,1988-09-24,D,L,2011-12,82,1,16,17,0.21,12,56,1.79,29,102701.0,20:52,0,0,0,0.0,74,139,18,48,-30,0,1,1,289.0,0:3,0,0,0,13466.0,2:44,1285000
8473992,Justin,Falk,1988-10-11,D,L,2011-12,47,1,8,9,0.19,-13,46,2.17,54,54969.0,19:29,0,0,0,0.0,78,78,12,20,-8,1,0,1,658.0,0:14,0,0,0,6554.0,2:19,605000
8473994,Jamie,Benn,1989-07-18,LW,L,2011-12,71,26,37,63,0.89,15,203,12.81,55,76999.0,18:4,347,404,751,46.21,136,52,56,51,5,2,8,10,9775.0,2:17,1,0,1,2969.0,0:41,630000
8473999,Nick,Palmieri,1989-07-12,RW,R,2011-12,38,4,3,7,0.18,-10,55,7.27,14,24130.0,10:35,2,9,11,18.18,39,7,5,9,-4,0,0,0,1438.0,0:37,0,0,0,80.0,0:2,536667
8474000,Steven,Kampfer,1988-09-24,D,R,2011-12,23,2,3,5,0.22,-1,20,10.0,6,20563.0,14:54,0,0,0,0.0,19,31,3,6,-3,0,0,0,1206.0,0:52,0,0,0,642.0,0:27,635000
8474001,TJ,Galiardi,1988-04-22,LW,L,2011-12,69,9,6,15,0.22,-8,113,7.96,53,54021.0,13:2,75,92,167,44.91,110,22,47,16,31,0,0,0,2500.0,0:36,1,0,1,3950.0,0:57,700000
8474009,Nick,Bonino,1988-04-20,C,L,2011-12,50,5,13,18,0.36,1,63,7.94,8,37431.0,12:28,195,259,454,42.95,18,39,28,9,19,0,1,1,2242.0,0:44,0,0,0,190.0,0:3,693000
8474013,Ian,Cole,1989-02-21,D,L,2011-12,26,1,5,6,0.23,7,18,5.56,22,24820.0,15:54,0,0,0,0.0,16,27,5,8,-3,0,0,0,485.0,0:18,0,0,0,709.0,0:27,875000
8474024,Jim,O'Brien,1989-01-29,C,R,2011-12,28,3,3,6,0.21,6,37,8.11,4,19749.0,11:45,121,135,256,47.27,28,9,14,6,8,0,0,0,84.0,0:3,0,0,0,3298.0,1:57,620833
8474025,Eric,Tangradi,1989-02-10,LW,L,2011-12,24,0,2,2,0.08,-4,20,0.0,16,12873.0,8:56,0,2,2,0.0,42,7,5,2,3,0,0,0,1052.0,0:43,0,0,0,0.0,0:0,708333
8474027,Justin,Braun,1987-02-10,D,R,2011-12,66,2,9,11,0.17,-2,113,1.77,23,65525.0,16:32,0,0,0,0.0,46,66,16,31,-15,1,2,3,4370.0,1:6,0,0,0,4018.0,1:0,662500
8474029,Cade,Fairchild,1989-01-15,D,L,2011-12,5,0,1,1,0.2,-1,1,0.0,0,2896.0,9:39,0,0,0,0.0,1,4,0,0,0,0,0,0,22.0,0:4,0,0,0,64.0,0:12,-111
8474030,Aaron,Palushaj,1989-09-07,RW,R,2011-12,38,1,4,5,0.13,1,37,2.7,8,17251.0,7:33,0,4,4,0.0,28,11,9,5,4,0,0,0,97.0,0:2,0,0,0,52.0,0:1,737500
8474031,Kevin,Shattenkirk,1989-01-29,D,R,2011-12,81,9,34,43,0.53,20,178,5.06,60,104981.0,21:36,1,3,4,25.0,72,103,40,42,-2,5,13,18,13917.0,2:51,0,1,1,9353.0,1:55,875000
8474034,Patrick,Maroon,1988-04-23,LW,L,2011-12,2,0,0,0,0.0,0,1,0.0,2,1505.0,12:32,0,0,0,0.0,4,1,1,0,1,0,0,0,0.0,0:0,0,0,0,0.0,0:0,550000
8474035,Bill,Sweatt,1988-09-21,LW,L,2011-12,2,0,0,0,0.0,0,2,0.0,0,641.0,5:20,0,0,0,0.0,1,2,0,0,0,0,0,0,0.0,0:0,0,0,0,32.0,0:16,900000
8474037,James,van Riemsdyk,1989-05-04,LW,L,2011-12,43,11,13,24,0.56,-1,121,9.09,24,39142.0,15:10,2,3,5,40.0,37,18,17,8,9,2,3,5,7186.0,2:47,0,0,0,78.0,0:1,875000
8474038,Paul,Byron,1989-04-27,LW,L,2011-12,22,3,2,5,0.23,3,13,23.08,2,13504.0,10:13,8,14,22,36.36,26,2,8,9,-1,0,0,0,215.0,0:9,0,0,0,41.0,0:1,555000
8474040,Sam,Gagner,1989-08-10,C,R,2011-12,75,18,29,47,0.63,5,149,12.08,36,77322.0,17:10,334,367,701,47.65,21,23,27,36,-9,6,6,12,11092.0,2:27,0,0,0,212.0,0:2,2275000
8474042,Cody,Almond,1989-07-24,C,L,2011-12,10,1,0,1,0.1,-5,7,14.29,15,6128.0,10:12,25,33,58,43.1,15,8,3,2,1,0,0,0,45.0,0:4,0,0,0,627.0,1:2,585000
8474045,Zach,Hamill,1988-09-23,C,R,2011-12,16,0,2,2,0.12,3,13,0.0,4,10549.0,10:59,15,16,31,48.39,13,4,6,2,4,0,0,0,452.0,0:28,0,0,0,332.0,0:20,816667
8474046,Alex,Plante,1989-05-09,D,R,2011-12,3,0,1,1,0.33,0,0,,2,1916.0,10:38,0,0,0,0.0,5,1,0,1,-1,0,0,0,0.0,0:0,0,0,0,29.0,0:9,875000
8474048,Keith,Aulie,1989-06-11,D,L,2011-12,36,0,3,3,0.08,-7,18,0.0,29,29017.0,13:26,0,0,0,0.0,78,38,4,18,-14,0,0,0,12.0,0:0,0,0,0,2004.0,0:55,558333
8474049,Akim,Aliu,1989-04-24,RW,R,2011-12,2,2,1,3,1.5,3,3,66.67,12,1324.0,11:2,0,0,0,0.0,6,0,0,1,-1,0,0,0,42.0,0:21,0,0,0,0.0,0:0,713333
8474050,Brett,MacLean,1988-12-24,LW,R,2011-12,5,0,2,2,0.4,1,6,0.0,2,2545.0,8:29,0,0,0,0.0,3,1,2,0,2,0,1,1,132.0,0:26,0,0,0,26.0,0:5,735000
8474053,Logan,Couture,1989-03-28,C,L,2011-12,80,31,34,65,0.81,2,245,12.65,16,89102.0,18:33,468,442,910,51.43,42,76,61,36,25,11,15,26,12961.0,2:42,2,0,2,5272.0,1:5,816667
8474056,P.K.,Subban,1989-05-13,D,R,2011-12,81,7,29,36,0.44,9,205,3.41,119,118108.0,24:18,0,0,0,0.0,105,113,26,88,-62,5,9,14,16984.0,3:29,0,1,1,12702.0,2:36,875000
8474059,Linus,Omark,1987-02-05,LW,L,2011-12,14,3,0,3,0.21,-5,24,12.5,8,11300.0,13:27,2,5,7,28.57,7,6,4,10,-6,0,0,0,1478.0,1:45,0,0,0,0.0,0:0,-111
8474062,Riley,Nash,1989-05-09,C,R,2011-12,5,0,1,1,0.2,1,2,0.0,2,3172.0,10:34,11,24,35,31.43,1,1,7,0,7,0,0,0,476.0,1:35,0,0,0,0.0,0:0,704166
8474068,Kyle,Turris,1989-08-14,C,R,2011-12,55,12,17,29,0.53,10,142,8.45,31,55618.0,16:51,338,385,723,46.75,23,14,21,18,3,1,4,5,5967.0,1:48,0,0,0,346.0,0:6,1400000
8474074,Paul,Postma,1989-02-22,D,R,2011-12,3,0,0,0,0.0,0,3,0.0,0,1532.0,8:30,0,0,0,0.0,1,1,0,0,0,0,0,0,0.0,0:0,0,0,0,0.0,0:0,670833
8474077,Carson,McMillan,1988-09-10,RW,R,2011-12,11,1,2,3,0.27,1,8,12.5,11,7300.0,11:3,5,9,14,35.71,19,9,2,0,2,0,0,0,10.0,0:0,0,0,0,188.0,0:17,-111
8474089,Brad,Malone,1989-05-20,C,L,2011-12,9,0,2,2,0.22,1,6,0.0,0,5423.0,10:2,1,7,8,12.5,13,1,7,1,6,0,0,0,27.0,0:3,0,0,0,0.0,0:0,700000
8474090,Brendan,Smith,1989-02-08,D,L,2011-12,14,1,6,7,0.5,3,13,7.69,13,13130.0,15:37,0,0,0,0.0,17,8,5,4,1,0,1,1,1476.0,1:45,0,0,0,57.0,0:4,875000
8474091,Brandon,Sutter,1989-02-14,C,R,2011-12,82,17,15,32,0.39,-3,171,9.94,21,85598.0,17:23,654,641,1295,50.5,53,85,61,30,31,2,1,3,2201.0,0:26,3,0,3,11497.0,2:20,2066667
8474094,Matt,Halischuk,1988-06-01,RW,R,2011-12,73,15,13,28,0.38,9,96,15.62,27,49311.0,11:15,11,19,30,36.67,41,33,21,19,2,0,0,0,367.0,0:5,0,0,0,5609.0,1:16,712500
8474095,Dana,Tyrell,1989-04-23,C,L,2011-12,26,0,5,5,0.19,-5,23,0.0,6,16403.0,10:30,0,3,3,0.0,20,15,11,0,11,0,0,0,50.0,0:1,0,0,0,2430.0,1:33,683333
8474096,Nick,Spaling,1988-09-19,C,L,2011-12,77,10,12,22,0.29,-7,107,9.35,18,72579.0,15:42,448,446,894,50.11,43,38,45,17,28,0,0,0,790.0,0:10,0,1,1,9038.0,1:57,1050000
8474100,Dwight,King,1989-07-05,LW,L,2011-12,27,5,9,14,0.52,3,42,11.9,10,23716.0,14:38,2,1,3,66.67,37,5,6,6,0,0,2,2,2905.0,1:47,0,0,0,60.0,0:2,566667
8474102,David,Perron,1988-05-28,LW,R,2011-12,57,21,21,42,0.74,19,114,18.42,28,62540.0,18:17,2,8,10,20.0,32,13,29,9,20,5,5,10,9092.0,2:39,1,1,2,2515.0,0:44,2150000
8474113,TJ,Brennan,1989-04-03,D,L,2011-12,11,1,0,1,0.09,0,14,7.14,6,9320.0,14:7,0,0,0,0.0,20,6,1,2,-1,0,0,0,454.0,0:41,0,0,0,248.0,0:22,645833
8474121,Colton,Gillies,1989-02-12,C,L,2011-12,75,2,6,8,0.11,-9,48,4.17,35,45394.0,10:5,7,10,17,41.18,161,46,31,14,17,0,0,0,264.0,0:3,0,0,0,3265.0,0:43,625000
8474125,Carl,Gunnarsson,1986-11-09,D,L,2011-12,76,4,15,19,0.25,-9,89,4.49,20,98966.0,21:42,0,1,1,0.0,114,152,34,65,-31,0,6,6,5543.0,1:12,0,0,0,12030.0,2:38,1325000
8474128,Milan,Kytnar,1989-05-19,C,L,2011-12,1,0,0,0,0.0,0,1,0.0,0,331.0,5:31,0,1,1,0.0,0,0,2,1,1,0,0,0,0.0,0:0,0,0,0,0.0,0:0,-111
8474130,Corey,Tropp,1989-07-25,RW,R,2011-12,34,3,5,8,0.24,0,32,9.38,20,20577.0,10:5,0,5,5,0.0,47,20,6,7,-1,0,0,0,70.0,0:2,0,0,0,225.0,0:6,586667
8474134,Yannick,Weber,1988-09-23,D,R,2011-12,60,4,14,18,0.3,-7,88,4.55,30,56228.0,15:37,0,0,0,0.0,49,47,18,43,-25,4,4,8,10179.0,2:49,0,0,0,3162.0,0:52,850000
8474137,Drayson,Bowman,1989-03-08,LW,L,2011-12,37,6,7,13,0.35,2,70,8.57,4,29643.0,13:21,0,0,0,0.0,54,10,10,8,2,0,1,1,1981.0,0:53,0,0,0,204.0,0:5,658333
8474138,Dustin,Jeffrey,1988-02-27,LW,L,2011-12,26,4,2,6,0.23,-4,33,12.12,2,18888.0,12:6,109,116,225,48.44,19,8,6,5,1,0,0,0,857.0,0:32,1,0,1,950.0,0:36,575000
8474139,Maxime,Macenauer,1989-01-04,C,L,2011-12,29,1,3,4,0.14,-4,14,7.14,18,18818.0,10:48,113,114,227,49.78,17,4,14,13,1,0,0,0,122.0,0:4,0,0,0,5079.0,2:55,-111
8474141,Patrick,Kane,1988-11-19,RW,L,2011-12,82,23,43,66,0.8,7,253,9.09,40,99372.0,20:11,240,329,569,42.18,19,27,77,32,45,4,8,12,17046.0,3:27,0,0,0,363.0,0:4,6300000
8474143,Ryan,Thang,1987-05-11,LW,R,2011-12,1,0,0,0,0.0,0,0,,0,512.0,8:32,0,0,0,0.0,0,0,0,0,0,0,0,0,0.0,0:0,0,0,0,57.0,0:57,-111
8474145,Robert,Bortuzzo,1989-03-18,D,R,2011-12,6,0,0,0,0.0,1,3,0.0,2,3924.0,10:54,0,0,0,0.0,9,1,0,0,0,0,0,0,0.0,0:0,0,0,0,223.0,0:37,535000
8474146,Spencer,Machacek,1988-10-14,RW,R,2011-12,13,2,7,9,0.69,8,12,16.67,7,5855.0,7:30,1,0,1,100.0,24,1,4,1,3,0,0,0,25.0,0:1,0,0,0,0.0,0:0,-111
8474149,Evgenii,Dadonov,1989-03-12,RW,L,2011-12,15,2,1,3,0.2,-4,21,9.52,2,9044.0,10:2,0,6,6,0.0,13,1,6,1,5,0,0,0,272.0,0:18,0,0,0,58.0,0:3,654167
8474150,Mikael,Backlund,1989-03-17,C,L,2011-12,41,4,7,11,0.27,-13,85,4.71,16,37843.0,15:23,225,271,496,45.36,25,19,29,17,12,2,1,3,2797.0,1:8,0,0,0,2387.0,0:58,845833
8474151,Ryan,McDonagh,1989-06-13,D,L,2011-12,82,7,25,32,0.39,25,123,5.69,44,121721.0,24:44,1,1,2,50.0,118,182,46,53,-7,0,2,2,3082.0,0:37,0,0,0,15067.0,3:3,875000
8474153,Michal,Repik,1988-12-31,RW,R,2011-12,17,2,3,5,0.29,-3,35,5.71,6,10567.0,10:21,3,2,5,60.0,24,1,8,2,6,1,2,3,716.0,0:42,0,0,0,0.0,0:0,629167
8474157,Max,Pacioretty,1988-11-20,LW,L,2011-12,79,33,32,65,0.82,2,286,11.54,56,86556.0,18:15,1,4,5,20.0,104,39,33,36,-3,4,9,13,15010.0,3:10,0,0,0,430.0,0:5,1625000
8474161,Jakub,Voracek,1989-08-15,RW,L,2011-12,78,18,31,49,0.63,11,190,9.47,32,76243.0,16:17,7,16,23,30.43,44,18,35,38,-3,0,11,11,15748.0,3:21,0,0,0,2584.0,0:33,2250000
8474163,Kevin,Marshall,1989-03-10,D,L,2011-12,10,0,0,0,0.0,-1,6,0.0,8,5256.0,8:45,0,0,0,0.0,8,4,2,1,1,0,0,0,0.0,0:0,0,0,0,53.0,0:5,666667
8474164,Jonathon,Blum,1989-01-30,D,R,2011-12,33,3,4,7,0.21,-14,25,12.0,6,35518.0,17:56,0,0,0,0.0,17,71,8,17,-9,0,0,0,2367.0,1:11,0,0,0,3220.0,1:37,816667
8474166,Alec,Martinez,1987-07-26,D,L,2011-12,51,6,6,12,0.24,-1,78,7.69,8,45043.0,14:43,0,1,1,0.0,51,48,1,11,-10,3,4,7,5452.0,1:46,0,0,0,372.0,0:7,737500
8474168,Joakim,Andersson,1989-02-05,C,L,2011-12,5,0,0,0,0.0,1,3,0.0,0,2000.0,6:40,5,1,6,83.33,5,1,0,0,0,0,0,0,0.0,0:0,0,0,0,0.0,0:0,612500
8474176,Carl,Hagelin,1988-08-23,LW,L,2011-12,64,14,24,38,0.59,21,131,10.69,24,57778.0,15:2,1,5,6,16.67,78,23,31,18,13,0,0,0,1337.0,0:20,2,0,2,1633.0,0:25,637500
8474184,Keaton,Ellerby,1988-11-05,D,L,2011-12,40,0,5,5,0.12,-3,45,0.0,10,36931.0,15:23,0,0,0,0.0,80,75,1,13,-12,0,0,0,224.0,0:5,0,0,0,2116.0,0:52,787500
8474189,Lars,Eller,1989-05-08,C,L,2011-12,79,16,12,28,0.35,-5,129,12.4,66,72575.0,15:18,319,366,685,46.57,72,55,42,31,11,2,1,3,3139.0,0:39,2,1,3,8041.0,1:41,845833
8474190,Wayne,Simmonds,1988-08-26,RW,R,2011-12,82,28,21,49,0.6,-1,197,14.21,114,78278.0,15:54,7,10,17,41.18,140,34,30,25,5,11,5,16,15841.0,3:13,0,0,0,193.0,0:2,1750000
8474192,Matt,Frattin,1988-01-03,RW,R,2011-12,56,8,7,15,0.27,-4,92,8.7,25,44235.0,13:9,2,6,8,25.0,81,12,22,15,7,0,1,1,2172.0,0:38,0,0,0,47.0,0:0,875000
8474195,Maksim,Mayorov,1989-03-26,LW,L,2011-12,10,1,1,2,0.2,-3,9,11.11,2,6399.0,10:39,0,0,0,0.0,11,3,2,0,2,0,0,0,14.0,0:1,0,0,0,113.0,0:11,-111
8474201,Pierre-Cedric,Labrie,1986-12-06,LW,L,2011-12,14,0,2,2,0.14,-2,5,0.0,15,4956.0,5:54,3,2,5,60.0,36,5,4,2,2,0,0,0,0.0,0:0,0,0,0,0.0,0:0,525000
8474218,Jason,Demers,1988-06-09,D,R,2011-12,57,4,9,13,0.23,-8,73,5.48,22,57605.0,16:50,0,0,0,0.0,60,58,11,27,-16,2,3,5,6837.0,1:59,0,0,0,613.0,0:10,1250000
8474220,Jerome,Samson,1987-09-04,RW,R,2011-12,16,2,3,5,0.31,-3,31,6.45,8,11786.0,12:16,0,0,0,0.0,10,5,6,0,6,1,1,2,1186.0,1:14,0,0,0,21.0,0:1,-111
8474230,Micheal,Haley,1986-03-30,C,L,2011-12,14,0,0,0,0.0,-1,13,0.0,57,6674.0,7:56,1,1,2,50.0,31,2,2,1,1,0,0,0,83.0,0:5,0,0,0,148.0,0:10,550000
8474250,Zack,Smith,1988-04-05,LW,L,2011-12,81,14,12,26,0.32,4,134,10.45,98,68397.0,14:4,484,506,990,48.89,168,43,50,29,21,1,0,1,1128.0,0:13,2,1,3,10749.0,2:12,700000
8474291,Jay,Beagle,1985-10-16,C,R,2011-12,41,4,1,5,0.12,-2,49,8.16,23,29165.0,11:51,124,91,215,57.67,66,23,10,6,4,0,0,0,133.0,0:3,0,0,0,2601.0,1:3,512500
8474383,Joel,Rechlicz,1987-06-14,RW,R,2011-12,3,0,0,0,0.0,0,0,,10,356.0,1:58,0,0,0,0.0,2,0,0,0,0,0,0,0,0.0,0:0,0,0,0,0.0,0:0,525000
8474498,Jesse,Winchester,1983-10-04,C,R,2011-12,32,2,6,8,0.25,2,52,3.85,22,20423.0,10:38,126,109,235,53.62,51,9,13,6,7,0,0,0,44.0,0:1,1,0,1,4289.0,2:14,750000
8474500,Derek,Whitmore,1984-12-17,LW,L,2011-12,2,0,0,0,0.0,0,2,0.0,0,1502.0,12:31,0,0,0,0.0,3,1,1,0,1,0,0,0,145.0,1:12,0,0,0,13.0,0:6,-111
8474518,Davis,Drewiske,1984-11-22,D,L,2011-12,9,2,0,2,0.22,0,11,18.18,2,6785.0,12:33,0,0,0,0.0,5,5,1,2,-1,0,0,0,40.0,0:4,0,0,0,246.0,0:27,616667
8474519,Jack,Hillen,1986-01-24,D,L,2011-12,55,2,4,6,0.11,6,51,3.92,20,46409.0,14:3,0,0,0,0.0,42,65,2,15,-13,0,0,0,81.0,0:1,0,0,0,2794.0,0:50,650000
8474520,Jason,Garrison,1984-11-13,D,L,2011-12,77,16,17,33,0.43,6,168,9.52,32,109490.0,23:41,1,1,2,50.0,127,124,20,30,-10,9,3,12,11661.0,2:31,0,1,1,11902.0,2:34,675000
8474535,Chris,Mueller,1986-03-06,C,R,2011-12,4,0,0,0,0.0,-1,4,0.0,0,2195.0,9:8,15,12,27,55.56,1,2,1,0,1,0,0,0,0.0,0:0,0,0,0,53.0,0:13,550000
8474551,Ville,Leino,1983-10-06,LW,L,2011-12,71,8,17,25,0.35,-2,78,10.26,16,67834.0,15:55,95,135,230,41.3,41,28,30,24,6,1,0,1,4466.0,1:2,0,0,0,252.0,0:3,4500000
8474552,Fabian,Brunnstrom,1985-02-06,LW,L,2011-12,5,0,1,1,0.2,-2,6,0.0,4,2719.0,9:3,0,0,0,0.0,4,1,3,1,2,0,0,0,39.0,0:7,0,0,0,0.0,0:0,600000
8474563,Drew,Doughty,1989-12-08,D,R,2011-12,77,10,26,36,0.47,-2,168,5.95,69,115035.0,24:53,0,0,0,0.0,124,70,26,65,-39,3,10,13,17146.0,3:42,0,0,0,10550.0,2:17,7000000
8474564,Steven,Stamkos,1990-02-07,C,R,2011-12,82,60,37,97,1.18,7,303,19.8,66,108340.0,22:1,558,669,1227,45.48,109,37,42,45,-3,12,13,25,18698.0,3:48,0,0,0,2726.0,0:33,7500000
8474565,Alex,Pietrangelo,1990-01-18,D,R,2011-12,81,12,39,51,0.63,16,202,5.94,36,120194.0,24:43,0,0,0,0.0,90,133,47,37,10,6,18,24,13983.0,2:52,0,1,1,15589.0,3:12,816667
8474566,Nikita,Filatov,1990-05-25,LW,R,2011-12,9,0,1,1,0.11,1,6,0.0,4,5302.0,9:49,0,1,1,0.0,8,1,1,7,-6,0,0,0,589.0,1:5,0,0,0,0.0,0:0,845833
8474567,Zach,Bogosian,1990-07-15,D,R,2011-12,65,5,25,30,0.46,-3,150,3.33,71,90933.0,23:18,0,0,0,0.0,117,109,17,41,-24,1,6,7,9607.0,2:27,0,0,0,11692.0,2:59,2500000
8474568,Luke,Schenn,1989-11-02,D,R,2011-12,79,2,20,22,0.28,-6,81,2.47,62,76007.0,16:2,0,0,0,0.0,270,115,28,58,-30,0,1,1,309.0,0:3,0,1,1,6340.0,1:20,3600000
8474569,Colin,Wilson,1989-10-20,C,L,2011-12,68,15,20,35,0.51,5,114,13.16,21,65811.0,16:7,39,38,77,50.65,43,21,30,35,-5,5,7,12,9509.0,2:19,0,0,0,27.0,0:0,875000
8474570,Cody,Hodgson,1990-02-18,C,R,2011-12,83,19,22,41,0.49,1,154,12.34,10,68836.0,13:49,329,381,710,46.34,37,29,34,26,8,7,7,14,9728.0,1:57,0,0,0,1102.0,0:13,816667
8474571,Mikkel,Boedker,1989-12-16,LW,L,2011-12,82,11,13,24,0.29,-2,86,12.79,12,67094.0,13:38,1,1,2,50.0,108,21,29,14,15,0,1,1,5196.0,1:3,0,0,0,1748.0,0:21,1100000
8474573,Josh,Bailey,1989-10-02,RW,L,2011-12,80,13,19,32,0.4,-10,104,12.5,32,73057.0,15:13,323,413,736,43.89,64,35,62,39,23,1,3,4,5803.0,1:12,3,0,3,7557.0,1:34,1050000
8474574,Tyler,Myers,1990-02-01,D,R,2011-12,55,8,15,23,0.42,5,84,9.52,33,74217.0,22:29,0,0,0,0.0,78,70,26,44,-18,3,4,7,7999.0,2:25,0,0,0,6977.0,2:6,875000
8474575,Colten,Teubert,1990-03-08,D,R,2011-12,24,0,1,1,0.04,-5,13,0.0,25,18204.0,12:38,0,0,0,0.0,68,28,1,9,-8,0,0,0,9.0,0:0,0,0,0,493.0,0:20,816667
8474576,Zach,Boychuk,1989-10-04,LW,L,2011-12,16,0,2,2,0.12,-3,10,0.0,0,8563.0,8:55,2,2,4,50.0,16,2,2,2,0,0,0,0,777.0,0:48,0,0,0,0.0,0:0,845833
8474577,Joe,Colborne,1990-01-30,C,L,2011-12,10,1,4,5,0.5,2,7,14.29,4,8213.0,13:41,28,50,78,35.9,20,8,4,5,-1,0,0,0,382.0,0:38,0,0,0,5.0,0:0,875000
8474578,Erik,Karlsson,1990-05-31,D,R,2011-12,81,19,59,78,0.96,16,261,7.28,42,123040.0,25:19,0,1,1,0.0,60,65,67,84,-17,3,25,28,18931.0,3:53,0,0,0,2728.0,0:33,875000
8474579,Luca,Sbisa,1990-01-30,D,L,2011-12,80,5,19,24,0.3,-5,88,5.68,66,86061.0,17:55,0,0,0,0.0,186,99,22,37,-15,0,3,3,3274.0,0:40,0,0,0,8011.0,1:40,2175000
8474581,Jake,Gardiner,1990-07-04,D,L,2011-12,75,7,23,30,0.4,-2,79,8.86,18,97131.0,21:35,0,0,0,0.0,52,90,34,73,-39,1,6,7,8899.0,1:58,0,0,0,7886.0,1:45,875000
8474582,Mattias,Tedenby,1990-02-21,RW,L,2011-12,43,1,5,6,0.14,-15,46,2.17,16,27737.0,10:45,1,2,3,33.33,25,1,11,8,3,0,0,0,744.0,0:17,0,0,0,416.0,0:9,875000
8474584,Michael,Del Zotto,1990-06-24,D,L,2011-12,77,10,31,41,0.53,20,113,8.85,36,103664.0,22:26,0,0,0,0.0,156,95,28,35,-7,1,13,14,19352.0,4:11,1,2,3,6453.0,1:23,875000
8474585,Tyler,Cuma,1990-01-19,D,L,2011-12,1,0,0,0,0.0,0,0,,2,669.0,11:9,0,0,0,0.0,2,1,0,0,0,0,0,0,0.0,0:0,0,0,0,49.0,0:49,845833
8474586,Jordan,Eberle,1990-05-15,C,R,2011-12,78,34,42,76,0.97,4,180,18.89,10,82355.0,17:35,12,15,27,44.44,45,24,40,47,-7,10,10,20,14093.0,3:0,0,0,0,837.0,0:10,875000
8474587,Greg,Nemisz,1990-06-05,RW,R,2011-12,9,0,0,0,0.0,1,2,0.0,0,4163.0,7:42,19,29,48,39.58,3,1,0,2,-2,0,0,0,29.0,0:3,0,0,0,0.0,0:0,845833
8474589,Tyler,Ennis,1989-10-06,LW,L,2011-12,48,15,19,34,0.71,11,82,18.29,14,46551.0,16:9,145,171,316,45.89,26,18,19,22,-3,2,2,4,5595.0,1:56,0,0,0,113.0,0:2,875000
8474590,John,Carlson,1990-01-10,D,R,2011-12,82,9,23,32,0.39,-15,152,5.92,22,107543.0,21:51,0,1,1,0.0,83,153,31,92,-61,4,3,7,7050.0,1:25,0,1,1,12131.0,2:27,845833
8474594,Slava,Voynov,1990-01-15,D,R,2011-12,54,8,12,20,0.37,12,86,9.3,12,60052.0,18:32,0,0,0,0.0,74,47,11,30,-19,3,3,6,8021.0,2:28,0,0,0,315.0,0:5,762500
8474597,Cody,Goloubef,1989-11-30,D,R,2011-12,1,0,0,0,0.0,1,0,,0,360.0,6:0,0,0,0,0.0,1,0,0,0,0,0,0,0,0.0,0:0,0,0,0,0.0,0:0,783333
8474600,Roman,Josi,1990-06-01,D,L,2011-12,52,5,11,16,0.31,1,64,7.81,14,57379.0,18:23,0,0,0,0.0,33,98,16,16,0,1,3,4,4200.0,1:20,0,0,0,3129.0,1:0,875000
8474604,Aaron,Ness,1990-05-18,D,L,2011-12,9,0,0,0,0.0,0,6,0.0,2,9146.0,16:56,0,0,0,0.0,2,17,2,3,-1,0,0,0,33.0,0:3,0,0,0,146.0,0:16,791667
8474606,Colby,Robak,1990-04-24,D,L,2011-12,3,0,0,0,0.0,1,1,0.0,0,2262.0,12:34,0,0,0,0.0,1,2,1,1,0,0,0,0,70.0,0:23,0,0,0,0.0,0:0,791667
8474607,Max,Sauve,1990-01-30,C,L,2011-12,1,0,0,0,0.0,0,0,,0,223.0,3:43,0,0,0,0.0,0,0,0,1,-1,0,0,0,0.0,0:0,0,0,0,0.0,0:0,633333
8474609,Luke,Adam,1990-06-18,C,L,2011-12,52,10,10,20,0.38,-6,89,11.24,14,38694.0,12:24,114,145,259,44.02,26,15,24,16,8,0,3,3,5099.0,1:38,0,0,0,21.0,0:0,737500
8474610,Zac,Dalpe,1989-11-01,C,R,2011-12,16,1,2,3,0.19,-3,20,5.0,4,9201.0,9:35,5,6,11,45.45,16,4,5,3,2,0,0,0,897.0,0:56,0,0,0,20.0,0:1,704167
8474612,Travis,Hamonic,1990-08-16,D,R,2011-12,73,2,22,24,0.33,6,124,1.61,73,98231.0,22:25,0,0,0,0.0,170,157,37,52,-15,1,5,6,4629.0,1:3,0,0,0,10038.0,2:17,875000
8474613,Derek,Stepan,1990-06-18,C,R,2011-12,82,17,34,51,0.62,14,169,10.06,22,93212.0,18:56,386,481,867,44.52,137,44,51,25,26,4,12,16,15277.0,3:6,0,0,0,6339.0,1:17,820833
8474616,Patrice,Cormier,1990-06-14,C,L,2011-12,9,0,0,0,0.0,1,8,0.0,0,3437.0,6:21,22,8,30,73.33,12,0,0,1,-1,0,0,0,0.0,0:0,0,0,0,0.0,0:0,575000
8474618,Marco,Scandella,1990-02-23,D,L,2011-12,63,3,9,12,0.19,-22,77,3.9,19,82337.0,21:46,0,0,0,0.0,46,106,24,35,-11,1,5,6,6679.0,1:46,0,0,0,9129.0,2:24,643333
8474625,Jimmy,Hayes,1989-11-21,RW,R,2011-12,31,5,4,9,0.29,-3,41,12.2,16,19058.0,10:14,5,5,10,50.0,50,6,11,0,11,1,1,2,1204.0,0:38,0,0,0,41.0,0:1,654167
8474628,Michael,Stone,1990-06-07,D,R,2011-12,13,1,2,3,0.23,7,13,7.69,2,10829.0,13:53,0,0,0,0.0,16,18,1,2,-1,0,0,0,159.0,0:12,0,0,0,589.0,0:45,591667
8474631,Marc-Andre,Bourdon,1989-09-17,D,L,2011-12,45,4,3,7,0.16,4,45,8.89,52,43716.0,16:11,0,0,0,0.0,73,77,7,27,-20,0,0,0,865.0,0:19,0,0,0,1340.0,0:29,-111
8474634,Evgeny,Grachev,1990-02-21,C,R,2011-12,26,1,3,4,0.15,-4,14,7.14,2,14561.0,9:20,1,4,5,20.0,23,10,10,2,8,0,0,0,174.0,0:6,0,0,0,318.0,0:12,675000
8474641,Adam,Henrique,1990-02-06,C,L,2011-12,74,16,35,51,0.69,8,130,12.31,7,80631.0,18:9,501,525,1026,48.83,83,57,49,25,24,0,8,8,7300.0,1:38,4,3,7,7926.0,1:47,575000
8474642,Lance,Bouma,1990-03-25,LW,L,2011-12,27,1,2,3,0.11,-5,26,3.85,11,16464.0,10:9,11,11,22,50.0,45,26,8,6,2,0,0,0,219.0,0:8,0,0,0,813.0,0:30,563333
8474646,Brandon,McMillan,1990-03-22,LW,L,2011-12,25,0,4,4,0.16,-10,26,0.0,20,16824.0,11:12,23,44,67,34.33,21,13,2,1,1,0,0,0,77.0,0:3,0,0,0,3728.0,2:29,687500
8474649,Tomas,Kundratek,1989-12-26,D,R,2011-12,5,0,0,0,0.0,0,2,0.0,2,2925.0,9:45,0,0,0,0.0,3,4,1,2,-1,0,0,0,19.0,0:3,0,0,0,18.0,0:3,579167
8474659,Matt,Donovan,1990-05-09,D,L,2011-12,3,0,0,0,0.0,-3,6,0.0,0,3343.0,18:34,0,0,0,0.0,3,4,0,2,-2,0,0,0,201.0,1:7,0,0,0,55.0,0:18,875000
8474666,David,Ullstrom,1989-04-22,LW,L,2011-12,29,4,4,8,0.28,-2,40,10.0,6,19097.0,10:58,6,4,10,60.0,32,8,9,4,5,1,0,1,1625.0,0:56,0,0,0,87.0,0:3,637500
8474668,Dale,Weise,1988-08-05,RW,R,2011-12,68,4,4,8,0.12,-1,48,8.33,81,33290.0,8:9,0,4,4,0.0,118,23,14,8,6,0,0,0,207.0,0:3,0,0,0,144.0,0:2,605000
8474670,Andre,Petersson,1990-09-11,RW,R,2011-12,1,0,0,0,0.0,0,0,,0,302.0,5:2,0,0,0,0.0,0,0,0,0,0,0,0,0,0.0,0:0,0,0,0,0.0,0:0,730000
8474673,TJ,Brodie,1990-06-07,D,L,2011-12,54,2,12,14,0.26,3,44,4.55,14,53392.0,16:28,0,0,0,0.0,43,38,25,43,-18,1,5,6,5639.0,1:44,0,0,0,143.0,0:2,566667
8474679,Gustav,Nyquist,1989-09-01,RW,L,2011-12,18,1,6,7,0.39,2,19,5.26,2,11443.0,10:35,0,0,0,0.0,4,0,9,5,4,0,0,0,286.0,0:15,0,0,0,4.0,0:0,762500
8474681,Andrei,Loktionov,1990-05-30,C,L,2011-12,39,3,4,7,0.18,-4,60,5.0,2,29319.0,12:31,64,85,149,42.95,7,6,14,22,-8,1,0,1,1668.0,0:42,0,0,0,52.0,0:1,604167
8474685,Matt,Calvert,1989-12-24,LW,L,2011-12,13,0,3,3,0.23,-5,4,0.0,16,7120.0,9:7,0,0,0,0.0,8,1,3,2,1,0,0,0,53.0,0:4,0,0,0,0.0,0:0,712500
8474691,Philippe,Cornet,1990-03-28,LW,L,2011-12,2,0,1,1,0.5,0,0,,0,1269.0,10:34,0,0,0,0.0,2,0,0,2,-2,0,0,0,124.0,1:2,0,0,0,0.0,0:0,-111
8474693,Tomas,Kubalik,1990-05-01,RW,R,2011-12,8,1,1,2,0.25,-3,8,12.5,6,6382.0,13:17,0,0,0,0.0,6,5,0,4,-4,0,0,0,737.0,1:32,0,0,0,0.0,0:0,613333
8474697,Mark,Borowiecki,1989-07-12,D,L,2011-12,2,0,0,0,0.0,-1,1,0.0,2,1499.0,12:29,0,0,0,0.0,4,0,0,1,-1,0,0,0,33.0,0:16,0,0,0,13.0,0:6,610000
8474705,Mark,Olver,1988-01-01,C,L,2011-12,24,4,3,7,0.29,0,25,16.0,15,18645.0,12:56,33,58,91,36.26,43,9,4,8,-4,0,0,0,671.0,0:27,0,0,0,106.0,0:4,-111
8474707,Philip,Larsen,1989-12-07,D,R,2011-12,55,3,8,11,0.2,11,69,4.35,16,59253.0,17:57,0,0,0,0.0,89,73,10,32,-22,1,0,1,4216.0,1:16,0,0,0,1480.0,0:26,635000
8474709,Matt,Martin,1989-05-08,LW,L,2011-12,80,7,7,14,0.18,-17,130,5.38,121,58357.0,12:9,10,13,23,43.48,374,41,36,21,15,0,0,0,1841.0,0:23,0,2,2,6099.0,1:16,631667
8474715,Cam,Atkinson,1989-06-05,RW,R,2011-12,27,7,7,14,0.52,1,66,10.61,14,24928.0,15:23,0,1,1,0.0,23,17,15,9,6,1,1,2,4495.0,2:46,0,0,0,107.0,0:3,775000
8474716,Jared,Spurgeon,1989-11-29,D,R,2011-12,70,3,20,23,0.33,-4,92,3.26,6,90717.0,21:35,0,0,0,0.0,36,95,18,22,-4,2,10,12,11496.0,2:44,0,0,0,7152.0,1:42,526667
8474719,Teemu,Hartikainen,1990-05-03,C,L,2011-12,17,2,3,5,0.29,1,24,8.33,6,13272.0,13:0,4,8,12,33.33,36,11,4,5,-1,0,0,0,19.0,0:1,0,0,0,0.0,0:0,875000
8474727,Ben,Smith,1988-07-11,RW,R,2011-12,13,2,0,2,0.15,-5,18,11.11,0,7654.0,9:48,7,7,14,50.0,6,5,3,1,2,0,0,0,59.0,0:4,0,0,0,237.0,0:18,592500
8474736,Zac,Rinaldo,1990-06-15,C,L,2011-12,66,2,7,9,0.14,-1,54,3.7,232,29621.0,7:28,6,3,9,66.67,175,19,4,9,-5,0,0,0,233.0,0:3,0,0,0,16.0,0:0,540000
8474739,Tommy,Wingels,1988-04-12,C,R,2011-12,33,3,6,9,0.27,-1,71,4.23,18,27221.0,13:44,7,10,17,41.18,102,23,14,16,-2,0,1,1,1587.0,0:48,0,0,0,102.0,0:3,687500
8474749,Matt,Bartkowski,1988-06-04,D,L,2011-12,3,0,0,0,0.0,-2,0,,0,1103.0,6:7,0,0,0,0.0,5,2,0,0,0,0,0,0,0.0,0:0,0,0,0,0.0,0:0,660000
8474772,Stu,Bickel,1986-10-02,D,R,2011-12,51,0,9,9,0.18,2,22,0.0,108,31945.0,10:26,1,0,1,100.0,68,52,5,8,-3,0,0,0,23.0,0:0,0,1,1,907.0,0:17,600000
8474774,Dalton,Prout,1990-03-13,D,R,2011-12,5,0,0,0,0.0,1,2,0.0,0,3538.0,11:47,0,0,0,0.0,5,3,1,1,0,0,0,0,30.0,0:6,0,0,0,67.0,0:13,666667
8474818,Jordie,Benn,1987-07-26,D,L,2011-12,3,0,2,2,0.67,1,1,0.0,0,2512.0,13:57,0,0,0,0.0,3,2,0,0,0,0,0,0,162.0,0:54,0,0,0,135.0,0:45,550000
8474884,Mike,Hoffman,1989-11-24,LW,L,2011-12,1,0,0,0,0.0,-1,0,,0,541.0,9:1,0,0,0,0.0,2,0,0,0,0,0,0,0,0.0,0:0,0,0,0,0.0,0:0,610000
8474892,Eric,Wellwood,1990-03-06,LW,L,2011-12,24,5,4,9,0.38,12,36,13.89,2,15778.0,10:57,18,17,35,51.43,16,12,13,5,8,0,0,0,96.0,0:4,0,1,1,2159.0,1:29,-111
8475060,Matt,Taormina,1986-10-20,D,L,2011-12,30,1,6,7,0.23,6,33,3.03,4,29762.0,16:32,0,0,0,0.0,18,36,6,8,-2,0,1,1,976.0,0:32,0,0,0,1169.0,0:38,550000
8475098,Tyler,Bozak,1986-03-19,C,R,2011-12,73,18,29,47,0.64,-7,109,16.51,22,82528.0,18:50,631,567,1198,52.67,117,34,40,26,14,4,8,12,12212.0,2:47,0,1,1,3003.0,0:41,1500000
8475102,Travis,Turnbull,1986-07-07,C,R,2011-12,3,1,0,1,0.33,0,3,33.33,5,886.0,4:55,5,5,10,50.0,7,2,0,0,0,0,0,0,0.0,0:0,0,0,0,0.0,0:0,-111
8475104,Evan,Oberg,1988-02-16,D,L,2011-12,3,0,0,0,0.0,2,3,0.0,0,1770.0,9:50,0,0,0,0.0,3,0,0,2,-2,0,0,0,189.0,1:3,0,0,0,8.0,0:2,-111
8475118,Matt,Gilroy,1984-07-20,D,R,2011-12,67,3,17,20,0.3,2,80,3.75,18,70378.0,17:30,0,0,0,0.0,59,75,18,29,-11,0,0,0,2116.0,0:31,0,0,0,4518.0,1:7,-111
8475148,Tim,Erixon,1991-02-24,D,L,2011-12,18,0,2,2,0.11,-2,9,0.0,8,14037.0,12:59,0,0,0,0.0,15,15,1,3,-2,0,0,0,751.0,0:41,0,0,0,298.0,0:16,900000
8475149,Marcus,Johansson,1990-10-06,LW,L,2011-12,80,14,32,46,0.57,-5,90,15.56,8,80657.0,16:48,307,403,710,43.24,61,28,39,47,-8,1,7,8,10991.0,2:17,0,0,0,2596.0,0:32,900000
8475150,Jordan,Caron,1990-11-02,RW,L,2011-12,48,7,8,15,0.31,0,57,12.28,14,33201.0,11:31,1,1,2,50.0,64,15,6,5,1,0,0,0,1115.0,0:23,0,0,0,875.0,0:18,886667
8475151,Kyle,Palmieri,1991-02-01,RW,R,2011-12,18,4,3,7,0.39,3,34,11.76,6,12442.0,11:31,2,0,2,100.0,20,6,1,7,-6,0,0,0,1017.0,0:56,0,0,0,50.0,0:2,900000
8475153,Dylan,Olsen,1991-01-03,D,L,2011-12,28,0,1,1,0.04,-5,16,0.0,6,21886.0,13:1,0,0,0,0.0,43,23,6,17,-11,0,0,0,34.0,0:1,0,0,0,1441.0,0:51,738333
8475154,Carter,Ashton,1991-04-01,RW,L,2011-12,15,0,0,0,0.0,-10,22,0.0,13,9375.0,10:25,1,1,2,50.0,32,2,4,4,0,0,0,0,45.0,0:3,0,0,0,0.0,0:0,840000
8475155,Simon,Despres,1991-07-27,D,L,2011-12,18,1,3,4,0.22,5,22,4.55,10,15358.0,14:13,0,0,0,0.0,19,17,5,7,-2,1,0,1,1191.0,1:6,0,0,0,646.0,0:35,840000
8475158,Ryan,O'Reilly,1991-02-07,C,L,2011-12,81,18,37,55,0.68,-1,189,9.52,12,94918.0,19:31,762,681,1443,52.81,62,50,101,34,67,4,11,15,11495.0,2:21,0,0,0,5687.0,1:10,880000
8475159,Carl,Klingberg,1991-01-28,LW,R,2011-12,6,0,0,0,0.0,-1,7,0.0,4,1979.0,5:29,0,0,0,0.0,1,0,1,0,1,0,0,0,0.0,0:0,0,0,0,0.0,0:0,760000
8475160,Kyle,Clifford,1991-01-13,LW,L,2011-12,81,5,7,12,0.15,-5,88,5.68,123,45719.0,9:24,1,7,8,12.5,179,9,8,21,-13,0,0,0,908.0,0:11,0,0,0,1085.0,0:13,710000
8475162,Mat,Clark,1990-10-17,D,R,2011-12,2,0,0,0,0.0,-2,2,0.0,0,1323.0,11:1,0,0,0,0.0,2,2,0,0,0,0,0,0,0.0,0:0,0,0,0,0.0,0:0,750000
8475165,Anton,Lander,1991-04-24,C,L,2011-12,56,2,4,6,0.11,-8,54,3.7,12,35664.0,10:36,149,195,344,43.31,32,12,15,14,1,0,0,0,347.0,0:6,1,0,1,5425.0,1:36,880000
8475166,John,Tavares,1990-09-20,C,L,2011-12,82,31,50,81,0.99,-6,286,10.84,26,101196.0,20:34,814,772,1586,51.32,27,23,99,65,34,7,18,25,15608.0,3:10,0,0,0,471.0,0:5,900000
8475167,Victor,Hedman,1990-12-18,D,L,2011-12,61,5,18,23,0.38,-9,82,6.1,65,84544.0,23:5,0,0,0,0.0,96,127,33,35,-2,0,4,4,4181.0,1:8,0,1,1,10656.0,2:54,900000
8475168,Matt,Duchene,1991-01-16,C,L,2011-12,58,14,14,28,0.48,-11,132,10.61,8,56684.0,16:17,200,191,391,51.15,43,41,31,21,10,5,4,9,8380.0,2:24,0,0,0,150.0,0:2,900000
8475169,Evander,Kane,1991-08-02,LW,L,2011-12,74,30,27,57,0.77,11,287,10.45,53,77776.0,17:31,15,29,44,34.09,173,31,35,18,17,6,3,9,9741.0,2:11,0,0,0,207.0,0:2,900000
8475170,Brayden,Schenn,1991-08-22,C,L,2011-12,54,12,6,18,0.33,-7,97,12.37,34,45763.0,14:7,201,235,436,46.1,136,26,11,15,-4,4,1,5,5468.0,1:41,0,0,0,331.0,0:6,870000
8475171,Oliver,Ekman-Larsson,1991-07-17,D,L,2011-12,82,13,19,32,0.39,0,147,8.84,32,108780.0,22:6,0,0,0,0.0,140,92,30,38,-8,2,6,8,10212.0,2:4,1,0,1,7040.0,1:25,900000
8475172,Nazem,Kadri,1990-10-06,C,L,2011-12,21,5,2,7,0.33,2,28,17.86,8,17841.0,14:9,4,11,15,26.67,25,5,8,9,-1,1,0,1,2023.0,1:36,0,0,0,14.0,0:0,870000
8475173,Scott,Glennie,1991-02-22,RW,R,2011-12,1,0,0,0,0.0,0,0,,2,575.0,9:35,0,0,0,0.0,2,0,0,1,-1,0,0,0,154.0,2:34,0,0,0,0.0,0:0,870000
8475174,Jared,Cowen,1991-01-25,D,L,2011-12,82,5,12,17,0.21,-4,58,8.62,56,92952.0,18:53,0,0,0,0.0,217,74,28,38,-10,0,1,1,2958.0,0:36,0,1,1,15431.0,3:8,870000
8475175,Magnus,Paajarvi,1991-04-12,LW,L,2011-12,41,2,6,8,0.2,-7,79,2.53,4,32415.0,13:10,2,5,7,28.57,18,8,12,18,-6,0,2,2,2540.0,1:1,0,0,0,502.0,0:12,900000
8475176,Ryan,Ellis,1991-01-03,D,R,2011-12,32,3,8,11,0.34,5,34,8.82,4,28469.0,14:49,0,0,0,0.0,30,37,7,8,-1,2,2,4,3354.0,1:44,0,0,0,160.0,0:5,840000
8475177,Calvin,de Haan,1991-05-09,D,L,2011-12,1,0,0,0,0.0,1,2,0.0,0,781.0,13:1,0,0,0,0.0,2,0,0,0,0,0,0,0,0.0,0:0,0,0,0,106.0,1:46,870000
8475178,Zack,Kassian,1991-01-24,RW,R,2011-12,44,4,6,10,0.23,-2,54,7.41,51,29818.0,11:17,11,12,23,47.83,79,2,10,8,2,0,1,1,1408.0,0:32,0,0,0,7.0,0:0,870000
8475179,Dmitry,Kulikov,1990-10-29,D,L,2011-12,58,4,24,28,0.48,-5,104,3.85,36,76058.0,21:51,0,0,0,0.0,104,74,25,44,-19,2,8,10,9904.0,2:50,0,0,0,3628.0,1:2,900000
8475180,Peter,Holland,1991-01-14,C,L,2011-12,4,1,0,1,0.25,0,1,100.0,2,1849.0,7:42,7,11,18,38.89,4,1,0,0,0,0,0,0,50.0,0:12,0,0,0,0.0,0:0,870000
8475181,Nick,Leddy,1991-03-20,D,L,2011-12,82,3,34,37,0.45,-12,94,3.19,10,108646.0,22:4,0,0,0,0.0,67,78,30,41,-11,0,11,11,10396.0,2:6,0,0,0,6377.0,1:17,900000
8475182,David,Rundblad,1990-10-08,D,R,2011-12,30,1,6,7,0.23,-12,34,2.94,6,27017.0,15:0,0,0,0,0.0,34,28,6,19,-13,0,2,2,4051.0,2:15,0,0,0,62.0,0:2,900000
8475183,Louis,Leblanc,1991-01-26,C,R,2011-12,42,5,5,10,0.24,3,58,8.62,28,28219.0,11:11,28,36,64,43.75,68,18,15,9,6,0,0,0,998.0,0:23,0,0,0,239.0,0:5,870000
8475185,Jacob,Josefson,1991-03-02,C,L,2011-12,41,2,7,9,0.22,10,37,5.41,6,29763.0,12:5,181,173,354,51.13,16,13,13,9,4,0,0,0,409.0,0:9,0,0,0,2832.0,1:9,900000
8475186,John,Moore,1990-11-19,D,L,2011-12,67,2,5,7,0.1,-23,64,3.12,8,63603.0,15:49,0,0,0,0.0,47,70,4,13,-9,0,0,0,263.0,0:3,0,1,1,5365.0,1:20,840000
8475188,Brayden,McNabb,1991-01-21,D,L,2011-12,25,1,7,8,0.32,-1,23,4.35,15,26758.0,17:50,0,0,0,0.0,49,30,16,9,7,1,0,1,708.0,0:28,0,0,0,1993.0,1:19,715000
8475191,Reilly,Smith,1991-04-01,RW,L,2011-12,3,0,0,0,0.0,-3,2,0.0,2,1512.0,8:24,1,0,1,100.0,0,0,0,0,0,0,0,0,163.0,0:54,0,0,0,24.0,0:8,900000
8475197,Tyson,Barrie,1991-07-26,D,R,2011-12,10,0,0,0,0.0,-2,15,0.0,0,10588.0,17:38,0,0,0,0.0,9,10,4,5,-1,0,0,0,700.0,1:10,0,0,0,9.0,0:0,715000
8475200,Dmitry,Orlov,1991-07-23,D,L,2011-12,60,3,16,19,0.32,1,51,5.88,18,60749.0,16:52,0,1,1,0.0,99,54,23,48,-25,0,2,2,2670.0,0:44,0,0,0,2000.0,0:33,690000
8475204,Brandon,Pirri,1991-04-10,RW,L,2011-12,5,0,2,2,0.4,2,5,0.0,0,4055.0,13:31,26,28,54,48.15,5,2,5,2,3,0,0,0,196.0,0:39,0,0,0,59.0,0:11,618333
8475206,Stefan,Elliott,1991-01-30,D,R,2011-12,39,4,9,13,0.33,2,84,4.76,8,40112.0,17:8,0,0,0,0.0,3,31,7,14,-7,0,2,2,5470.0,2:20,0,0,0,166.0,0:4,843333
8475214,Jeremy,Morin,1991-04-16,LW,R,2011-12,3,0,0,0,0.0,-1,2,0.0,0,1595.0,8:51,0,0,0,0.0,4,0,0,0,0,0,0,0,18.0,0:6,0,0,0,0.0,0:0,735000
8475218,Mattias,Ekholm,1990-05-24,D,L,2011-12,2,0,0,0,0.0,-1,1,0.0,0,1490.0,12:25,0,0,0,0.0,0,3,0,1,-1,0,0,0,67.0,0:33,0,0,0,31.0,0:15,900000
8475219,Kristopher,Foucault,1990-12-12,LW,L,2011-12,1,0,0,0,0.0,0,0,,0,530.0,8:50,0,0,0,0.0,0,0,0,0,0,0,0,0,25.0,0:25,0,0,0,0.0,0:0,-111
8475220,Marcus,Foligno,1991-08-10,LW,L,2011-12,14,6,7,13,0.93,6,23,26.09,9,13285.0,15:48,0,3,3,0.0,44,11,7,2,5,2,1,3,1076.0,1:16,0,0,0,28.0,0:2,826667
8475225,Craig,Smith,1989-09-05,RW,R,2011-12,72,14,22,36,0.5,-9,172,8.14,30,61290.0,14:11,173,220,393,44.02,44,17,32,26,6,6,7,13,9246.0,2:8,0,0,0,94.0,0:1,715000
8475231,Casey,Cizikas,1991-02-27,C,L,2011-12,15,0,4,4,0.27,1,12,0.0,6,9541.0,10:36,47,68,115,40.87,26,9,1,1,0,0,0,0,77.0,0:5,0,0,0,164.0,0:10,793333
8475233,David,Savard,1990-10-22,D,R,2011-12,31,2,8,10,0.32,0,34,5.88,16,30829.0,16:34,0,0,0,0.0,30,15,5,10,-5,1,3,4,4303.0,2:18,0,0,0,340.0,0:10,740167
8475236,Cody,Eakin,1991-05-24,C,L,2011-12,30,4,4,8,0.27,2,31,12.9,4,16698.0,9:16,21,19,40,52.5,15,7,6,5,1,0,0,0,631.0,0:21,0,0,0,41.0,0:1,571667
8475248,Alexander,Urbom,1990-12-20,D,L,2011-12,5,1,0,1,0.2,1,3,33.33,9,4079.0,13:35,0,0,0,0.0,5,2,0,4,-4,0,0,0,8.0,0:1,0,0,0,172.0,0:34,563333
8475254,Gabriel,Dumont,1990-10-06,C,R,2011-12,3,0,0,0,0.0,-1,1,0.0,0,1541.0,8:33,3,15,18,16.67,7,1,1,1,0,0,0,0,0.0,0:0,0,0,0,104.0,0:34,571667
8475264,Roman,Horak,1991-05-21,C,L,2011-12,61,3,8,11,0.18,3,53,5.66,14,37322.0,10:11,183,258,441,41.5,28,20,14,11,3,0,0,0,1604.0,0:26,0,0,0,653.0,0:10,613333
8475266,Tomas,Vincour,1990-11-19,C,R,2011-12,47,4,6,10,0.21,-2,65,6.15,2,29129.0,10:19,1,8,9,11.11,52,16,19,8,11,0,0,0,1075.0,0:22,0,0,0,26.0,0:0,621667
8475268,Gabriel,Bourque,1990-09-23,LW,L,2011-12,43,7,12,19,0.44,-2,59,11.86,6,32995.0,12:47,0,1,1,0.0,66,19,20,9,11,0,0,0,196.0,0:4,0,0,0,287.0,0:6,618333
8475283,Lane,MacDermid,1989-08-25,LW,L,2011-12,5,0,0,0,0.0,-2,6,0.0,5,2671.0,8:54,0,0,0,0.0,10,3,1,0,1,0,0,0,17.0,0:3,0,0,0,23.0,0:4,576667
8475323,Marcus,Kruger,1990-05-27,C,L,2011-12,71,9,17,26,0.37,11,89,10.11,22,65602.0,15:23,284,335,619,45.88,26,36,25,22,3,0,3,3,6168.0,1:26,0,0,0,5710.0,1:20,735000
8475325,Jordan,Nolan,1989-06-23,C,L,2011-12,26,2,2,4,0.15,2,19,10.53,28,14583.0,9:20,1,0,1,100.0,59,4,3,4,-1,0,0,0,431.0,0:16,0,0,0,62.0,0:2,531667
8475372,Andreas,Engqvist,1987-12-23,C,R,2011-12,12,0,0,0,0.0,-1,3,0.0,4,4750.0,6:35,24,36,60,40.0,9,5,0,1,-1,0,0,0,0.0,0:0,0,0,0,728.0,1:0,-111
8475430,Brandon,Manning,1990-06-04,D,L,2011-12,4,0,0,0,0.0,1,6,0.0,0,3294.0,13:43,0,0,0,0.0,6,2,2,1,1,0,0,0,0.0,0:0,0,0,0,4.0,0:1,715000
8475455,Brenden,Dillon,1990-11-13,D,L,2011-12,1,0,0,0,0.0,0,6,0.0,0,1199.0,19:59,0,0,0,0.0,4,3,0,1,-1,0,0,0,127.0,2:7,0,0,0,161.0,2:41,743333
8475602,Casey,Wellman,1987-10-18,C,R,2011-12,14,2,5,7,0.5,-4,25,8.0,0,10698.0,12:44,6,3,9,66.67,6,7,5,7,-2,0,1,1,1168.0,1:23,0,0,0,0.0,0:0,850500
8475603,Ben,Holmstrom,1987-04-09,C,R,2011-12,5,0,0,0,0.0,0,3,0.0,2,2016.0,6:43,15,15,30,50.0,8,4,0,1,-1,0,0,0,0.0,0:0,0,0,0,195.0,0:39,600000
8475613,Nate,Prosser,1986-05-07,D,R,2011-12,51,1,11,12,0.24,-17,32,3.12,57,58897.0,19:14,0,0,0,0.0,34,124,12,13,-1,0,3,3,2683.0,0:52,0,0,0,6361.0,2:4,715000
8475619,Aaron,Volpatti,1985-05-30,LW,L,2011-12,23,1,0,1,0.04,-2,17,5.88,37,12377.0,8:58,4,0,4,100.0,61,8,1,4,-3,0,0,0,115.0,0:5,0,0,0,30.0,0:1,612500
8475637,Bobby,Butler,1987-04-26,RW,R,2011-12,56,6,10,16,0.29,8,86,6.98,12,38565.0,11:28,3,0,3,100.0,34,13,26,18,8,0,0,0,2958.0,0:52,0,0,0,0.0,0:0,1050000
8475640,Erik,Gustafsson,1988-12-15,D,L,2011-12,30,1,4,5,0.17,12,18,5.56,2,30239.0,16:47,0,0,0,0.0,9,35,6,14,-8,0,0,0,999.0,0:33,0,1,1,588.0,0:19,-111
8475650,Brandon,Bollig,1987-01-31,LW,L,2011-12,18,0,0,0,0.0,-2,16,0.0,58,6361.0,5:53,0,0,0,0.0,27,6,0,0,0,0,0,0,20.0,0:1,0,0,0,0.0,0:0,545000
8475671,Matt,Fraser,1990-05-20,RW,L,2011-12,1,0,0,0,0.0,0,1,0.0,0,237.0,3:57,0,0,0,0.0,0,1,0,0,0,0,0,0,0.0,0:0,0,0,0,0.0,0:0,560000
8475679,Jarod,Palmer,1986-02-10,C,R,2011-12,6,1,0,1,0.17,-2,14,7.14,4,4802.0,13:20,1,1,2,50.0,3,1,4,0,4,0,0,0,625.0,1:44,0,0,0,0.0,0:0,-111
8475690,Christopher,Tanev,1989-12-20,D,R,2011-12,25,0,2,2,0.08,10,15,0.0,2,25086.0,16:43,0,0,0,0.0,10,43,5,8,-3,0,0,0,153.0,0:6,0,0,0,1333.0,0:53,900000
8475692,Mats,Zuccarello,1987-09-01,RW,L,2011-12,10,2,1,3,0.3,0,10,20.0,6,6026.0,10:2,0,0,0,0.0,8,3,2,2,0,1,1,2,1806.0,3:0,0,0,0,38.0,0:3,900000
8475722,Jason,Zucker,1992-01-16,LW,L,2011-12,6,0,2,2,0.33,-2,10,0.0,2,3969.0,11:1,0,0,0,0.0,5,2,2,2,0,0,0,0,107.0,0:17,0,0,0,0.0,0:0,771667
8475753,Justin,Faulk,1992-03-20,D,R,2011-12,66,8,14,22,0.33,-16,101,7.92,29,90463.0,22:50,0,0,0,0.0,113,85,32,20,12,5,7,12,12031.0,3:2,0,0,0,7195.0,1:49,840000
8475757,Brett,Bulmer,1992-04-26,RW,R,2011-12,9,0,3,3,0.33,1,7,0.0,6,5957.0,11:1,0,0,0,0.0,17,2,0,0,0,0,0,0,268.0,0:29,0,0,0,0.0,0:0,810000
8475758,Devante,Smith-Pelly,1992-06-14,RW,R,2011-12,49,7,6,13,0.27,-7,66,10.61,16,35409.0,12:2,6,15,21,28.57,104,9,5,19,-14,1,1,2,2146.0,0:43,1,0,1,3547.0,1:12,720000
8475764,Cam,Fowler,1991-12-05,D,L,2011-12,82,5,24,29,0.35,-28,123,4.07,18,114442.0,23:15,1,0,1,100.0,43,94,23,42,-19,2,9,11,18072.0,3:40,0,0,0,3450.0,0:42,900000
8475768,Jaden,Schwartz,1992-06-25,LW,L,2011-12,7,2,1,3,0.43,1,6,33.33,0,4909.0,11:41,1,1,2,50.0,1,5,1,2,-1,1,0,1,348.0,0:49,0,0,0,0.0,0:0,830000
8475772,Riley,Sheahan,1991-12-07,C,L,2011-12,1,0,0,0,0.0,0,3,0.0,4,363.0,6:3,0,0,0,0.0,1,1,0,0,0,0,0,0,0.0,0:0,0,0,0,0.0,0:0,785000
8475784,Jeff,Skinner,1992-05-16,LW,L,2011-12,64,20,24,44,0.69,-8,210,9.52,56,71519.0,18:37,67,92,159,42.14,44,15,46,40,6,4,9,13,12909.0,3:21,0,0,0,876.0,0:13,900000
8475788,Alexander,Burmistrov,1991-10-21,C,L,2011-12,76,13,15,28,0.37,4,123,10.57,42,75981.0,16:39,248,316,564,43.97,118,15,42,31,11,1,2,3,5599.0,1:13,1,0,1,8152.0,1:47,900000
8475790,Erik,Gudbranson,1992-01-07,D,R,2011-12,72,2,6,8,0.11,-19,76,2.63,78,61335.0,14:11,0,0,0,0.0,154,73,3,17,-14,0,1,1,2157.0,0:29,0,0,0,1321.0,0:18,900000
8475791,Taylor,Hall,1991-11-14,LW,L,2011-12,61,27,26,53,0.87,-3,207,13.04,36,66680.0,18:13,23,34,57,40.35,44,34,35,62,-27,13,8,21,11206.0,3:3,0,0,0,160.0,0:2,900000
8475792,Brett,Connolly,1992-05-02,RW,R,2011-12,68,4,11,15,0.22,-9,94,4.26,30,46803.0,11:28,20,32,52,38.46,58,19,9,21,-12,1,2,3,4899.0,1:12,0,0,0,46.0,0:0,900000
8475793,Ryan,Johansen,1992-07-31,C,R,2011-12,67,9,12,21,0.31,-2,99,9.09,24,51196.0,12:44,97,118,215,45.12,68,24,20,11,9,3,1,4,6733.0,1:40,0,0,0,202.0,0:3,870000
8475794,Tyler,Seguin,1992-01-31,C,R,2011-12,81,29,38,67,0.83,34,242,11.98,30,82324.0,16:56,46,60,106,43.4,26,17,30,42,-12,5,10,15,11962.0,2:27,0,0,0,114.0,0:1,900000
8475799,Nino,Niederreiter,1992-09-08,RW,L,2011-12,55,1,0,1,0.02,-29,74,1.35,12,33381.0,10:6,0,2,2,0.0,129,14,21,13,8,0,0,0,1323.0,0:24,0,0,0,0.0,0:0,870000
8476116,Ryan,Garbutt,1985-08-12,C,L,2011-12,20,2,1,3,0.15,-1,28,7.14,22,9939.0,8:16,12,15,27,44.44,48,3,1,4,-3,0,0,0,22.0,0:1,0,0,0,136.0,0:6,590000
8476158,Harry,Zolnierczyk,1987-09-01,LW,L,2011-12,37,3,3,6,0.16,-11,49,6.12,35,17104.0,7:42,12,16,28,42.86,67,14,4,3,1,0,0,0,279.0,0:7,0,0,0,572.0,0:15,775000
8476177,Matt,Read,1986-06-14,RW,R,2011-12,79,24,23,47,0.59,13,155,15.48,12,80869.0,17:3,142,204,346,41.04,82,58,36,27,9,4,7,11,11458.0,2:25,2,1,3,12288.0,2:35,900000
8476205,Stephane,Da Costa,1989-07-11,C,R,2011-12,22,3,2,5,0.23,-9,31,9.68,8,16051.0,12:9,65,112,177,36.72,14,13,8,5,3,0,0,0,2107.0,1:35,0,0,0,14.0,0:0,900000
8476206,Andy,Miele,1988-04-15,C,L,2011-12,7,0,0,0,0.0,-3,4,0.0,6,3754.0,8:56,7,21,28,25.0,11,0,0,2,-2,0,0,0,404.0,0:57,0,0,0,5.0,0:0,900000
8476211,Carter,Camper,1988-07-06,C,R,2011-12,3,1,0,1,0.33,1,1,100.0,0,1206.0,6:42,6,8,14,42.86,1,2,0,1,-1,0,0,0,0.0,0:0,0,0,0,0.0,0:0,625000
8476224,Chay,Genoway,1986-12-20,D,L,2011-12,1,0,1,1,1.0,0,1,0.0,0,1096.0,18:16,0,0,0,0.0,0,1,2,1,1,0,0,0,130.0,2:10,0,0,0,41.0,0:41,-111
8476225,Mike,Connolly,1989-07-03,LW,L,2011-12,2,0,0,0,0.0,0,1,0.0,2,1481.0,12:20,0,0,0,0.0,2,1,1,0,1,0,0,0,0.0,0:0,0,0,0,0.0,0:0,-111
8476244,Raphael,Diaz,1986-01-09,D,R,2011-12,59,3,13,16,0.27,-7,61,4.92,30,63736.0,18:0,1,1,2,50.0,40,102,13,38,-25,0,4,4,5853.0,1:39,0,2,2,4749.0,1:20,900000
8476381,Andrew,Shaw,1991-07-20,RW,R,2011-12,37,12,11,23,0.62,-1,74,16.22,50,33761.0,15:12,41,47,88,46.59,82,21,16,5,11,0,4,4,3545.0,1:35,0,0,0,597.0,0:16,573333
8476438,Brandon,Saad,1992-10-27,LW,L,2011-12,2,0,0,0,0.0,0,3,0.0,0,1682.0,14:1,0,0,0,0.0,0,1,2,0,2,0,0,0,164.0,1:22,0,0,0,3.0,0:1,795000
8476454,Ryan,Nugent-Hopkins,1993-04-12,C,L,2011-12,62,18,34,52,0.84,-2,134,13.43,16,65493.0,17:36,227,378,605,37.52,38,33,34,32,2,3,20,23,11205.0,3:0,0,0,0,120.0,0:1,925000
8476455,Gabriel,Landeskog,1992-11-23,LW,L,2011-12,82,22,30,52,0.63,20,270,8.15,51,91571.0,18:36,8,28,36,22.22,219,58,58,35,23,6,6,12,10590.0,2:9,0,2,2,6605.0,1:20,925000
8476457,Adam,Larsson,1992-11-12,D,R,2011-12,65,2,16,18,0.28,-7,68,2.94,20,80420.0,20:37,0,0,0,0.0,94,67,12,44,-32,0,4,4,6405.0,1:38,0,1,1,1717.0,0:26,925000
8476459,Mika,Zibanejad,1993-04-18,C,R,2011-12,9,0,1,1,0.11,-3,12,0.0,2,6966.0,12:54,22,28,50,44.0,15,5,4,1,3,0,1,1,567.0,1:3,0,0,0,66.0,0:7,925000
8476460,Mark,Scheifele,1993-03-15,C,R,2011-12,7,1,0,1,0.14,0,5,20.0,0,4597.0,10:56,18,33,51,35.29,3,1,0,2,-2,1,0,1,499.0,1:11,0,0,0,170.0,0:24,925000
8476461,Sean,Couturier,1992-12-07,C,L,2011-12,77,13,14,27,0.35,18,116,11.21,14,65323.0,14:8,378,426,804,47.01,82,33,48,26,22,0,1,1,2072.0,0:26,2,0,2,12461.0,2:41,925000
8476466,Sven,Baertschi,1992-10-05,LW,L,2011-12,5,3,0,3,0.6,2,10,30.0,4,3341.0,11:8,0,0,0,0.0,5,0,3,0,3,0,0,0,173.0,0:34,0,0,0,0.0,0:0,925000
8476792,Torey,Krug,1991-04-12,D,L,2011-12,2,0,1,1,0.5,0,3,0.0,0,2055.0,17:7,0,0,0,0.0,0,4,0,0,0,0,0,0,129.0,1:4,0,0,0,46.0,0:23,916667
8476806,J.T.,Brown,1990-07-02,RW,R,2011-12,5,0,1,1,0.2,2,13,0.0,0,4157.0,13:51,0,0,0,0.0,2,3,1,2,-1,0,0,0,497.0,1:39,0,0,0,0.0,0:0,925000
