player_id,firstName,lastName,birthDate,primaryPosition,shootsCatches,season,gamesPlayed,goals,assists,points,pointsPerGame,plusMinus,shots,shootingPercentage,penaltyMinutes,timeOnIce,avgTimeOnIce,faceOffWins,faceOffLosses,faceOffTaken,faceOffPercentage,hits,blocks,takeaways,giveaways,turnoverDifferential,powerPlayGoals,powerPlayAssists,powerPlayPoints,powerPlayTimeOnIce,avgPowerPlayTimeOnIce,shortHandedGoals,shortHandedAssists,shortHandedPoints,shortHandedTimeOnIce,avgShortHandedTimeOnIce,salary
8448208,Jaromir,Jagr,1972-02-15,RW,L,2012-13,45,16,19,35,0.78,-2,115,13.91,22,49491.0,18:19,0,1,1,0.0,13,10,19,28,-9,6,5,11,8353.0,3:5,0,0,0,94.0,0:2,4500000
8457981,Teemu,Selanne,1970-07-03,RW,R,2012-13,46,12,12,24,0.52,-10,96,12.5,28,43311.0,15:41,85,83,168,50.6,8,10,23,31,-8,3,4,7,6010.0,2:10,0,0,0,53.0,0:1,4500000
8458529,Alex,Kovalev,1973-02-24,RW,L,2012-13,14,2,3,5,0.36,-1,21,9.52,6,13115.0,15:36,1,2,3,33.33,7,5,3,4,-1,1,1,2,2523.0,3:0,0,0,0,16.0,0:1,-111
8458537,Ray,Whitney,1972-05-08,LW,R,2012-13,32,11,18,29,0.91,1,62,17.74,4,37240.0,19:23,16,35,51,31.37,10,14,29,41,-12,4,8,12,7105.0,3:42,0,0,0,142.0,0:4,4500000
8458590,Mike,Knuble,1972-07-04,RW,R,2012-13,28,4,4,8,0.29,-4,31,12.9,20,21705.0,12:55,4,3,7,57.14,25,11,3,3,0,1,1,2,2791.0,1:39,0,0,0,520.0,0:18,-111
8458938,Roman,Hamrlik,1974-04-12,D,L,2012-13,16,0,1,1,0.06,-4,7,0.0,8,11020.0,11:28,0,0,0,0.0,8,14,1,3,-2,0,0,0,42.0,0:2,0,0,0,351.0,0:21,-111
8458951,Sergei,Gonchar,1974-04-13,D,L,2012-13,45,3,24,27,0.6,4,85,3.53,26,64781.0,23:59,0,0,0,0.0,25,65,10,28,-18,2,10,12,10043.0,3:43,0,0,0,6030.0,2:14,5500000
8459053,Adrian,Aucoin,1973-07-03,D,R,2012-13,36,0,4,4,0.11,-8,26,0.0,16,35280.0,16:20,0,0,0,0.0,43,13,4,8,-4,0,0,0,18.0,0:0,0,0,0,3252.0,1:30,-111
8459442,Saku,Koivu,1974-11-23,C,L,2012-13,47,8,19,27,0.57,4,55,14.55,18,49633.0,17:36,437,414,851,51.35,31,15,14,21,-7,4,4,8,4975.0,1:45,0,0,0,5908.0,2:5,-111
8459444,Todd,Bertuzzi,1975-02-02,RW,L,2012-13,7,2,1,3,0.43,3,10,20.0,2,6518.0,15:31,0,0,0,0.0,6,1,0,4,-4,0,0,0,1361.0,3:14,0,0,0,3.0,0:0,2075000
8459454,Jay,Pandolfo,1974-12-27,LW,L,2012-13,18,0,0,0,0.0,-2,11,0.0,2,9799.0,9:4,2,3,5,40.0,25,8,1,3,-2,0,0,0,0.0,0:0,0,0,0,1321.0,1:13,600000
8459457,Jamie,Langenbrunner,1975-07-24,RW,R,2012-13,4,0,1,1,0.25,1,5,0.0,0,2347.0,9:46,0,4,4,0.0,4,0,0,1,-1,0,0,0,80.0,0:20,0,0,0,298.0,1:14,1250000
8459492,Vinny,Prospal,1975-02-17,LW,L,2012-13,48,12,18,30,0.62,3,85,14.12,32,47596.0,16:31,4,5,9,44.44,37,18,25,11,14,4,3,7,7641.0,2:39,0,0,0,49.0,0:1,-111
8459514,Jamal,Mayers,1974-10-24,RW,R,2012-13,19,0,2,2,0.11,2,10,0.0,16,7946.0,6:58,42,36,78,53.85,26,4,3,2,1,0,0,0,155.0,0:8,0,0,0,232.0,0:12,600000
8459628,Hal,Gill,1975-04-06,D,L,2012-13,32,0,0,0,0.0,-3,8,0.0,12,25699.0,13:23,0,0,0,0.0,28,38,7,12,-5,0,0,0,2.0,0:0,0,0,0,4998.0,2:36,2000000
8459670,Kimmo,Timonen,1975-03-18,D,L,2012-13,45,5,24,29,0.64,3,78,6.41,36,58769.0,21:45,0,0,0,0.0,31,79,13,21,-8,3,14,17,10282.0,3:48,0,0,0,7895.0,2:55,6333333
8459687,Scott,Nichol,1974-12-31,C,R,2012-13,30,1,0,1,0.03,-2,13,7.69,25,17601.0,9:46,132,86,218,60.55,27,13,6,1,5,0,0,0,56.0,0:1,0,0,0,3215.0,1:47,-111
8460492,Ed,Jovanovski,1976-06-26,D,L,2012-13,6,0,1,1,0.17,-4,6,0.0,0,5639.0,15:39,0,0,0,0.0,3,8,1,6,-5,0,0,0,287.0,0:47,0,0,0,967.0,2:41,4125000
8460496,Ryan,Smyth,1976-02-21,LW,L,2012-13,47,2,11,13,0.28,-5,69,2.9,40,43345.0,15:22,87,115,202,43.07,41,24,15,26,-11,0,1,1,3542.0,1:15,1,0,1,7132.0,2:31,2250000
8460542,Patrik,Elias,1976-04-13,C,L,2012-13,48,14,22,36,0.75,5,118,11.86,22,53912.0,18:43,71,92,163,43.56,20,14,26,21,5,5,9,14,10097.0,3:30,1,0,1,4798.0,1:39,6000000
8460561,Sheldon,Souray,1976-07-13,D,L,2012-13,44,7,10,17,0.39,19,80,8.75,52,55253.0,20:55,1,0,1,100.0,34,58,9,32,-23,2,3,5,4827.0,1:49,0,0,0,6585.0,2:29,3666667
8460577,Milan,Hejduk,1976-02-14,RW,R,2012-13,29,4,7,11,0.38,-7,41,9.76,0,22867.0,13:8,2,4,6,33.33,6,8,6,16,-10,2,1,3,3601.0,2:4,0,0,0,7.0,0:0,-111
8460621,Daniel,Alfredsson,1972-12-11,RW,R,2012-13,47,10,16,26,0.55,1,101,9.9,33,54566.0,19:20,16,22,38,42.11,28,30,37,36,1,3,8,11,8408.0,2:58,0,1,1,4507.0,1:35,4875000
8460626,Bryce,Salvador,1976-02-11,D,L,2012-13,39,0,2,2,0.05,-12,29,0.0,22,49909.0,21:19,0,0,0,0.0,36,79,11,22,-11,0,0,0,314.0,0:8,0,0,0,8097.0,3:27,3166667
8460719,Steve,Sullivan,1974-07-06,LW,R,2012-13,42,7,10,17,0.4,-12,61,11.48,24,36676.0,14:33,3,3,6,50.0,12,3,15,15,0,4,4,8,7041.0,2:47,0,0,0,55.0,0:1,1850000
8460720,Eric,Boulton,1976-08-17,LW,L,2012-13,15,0,0,0,0.0,-4,5,0.0,36,5106.0,5:40,0,0,0,0.0,23,6,1,1,0,0,0,0,19.0,0:1,0,0,0,44.0,0:2,540000
8462033,Wade,Redden,1977-06-12,D,L,2012-13,29,3,4,7,0.24,-2,28,10.71,11,26228.0,15:4,0,0,0,0.0,16,30,7,5,2,0,1,1,1352.0,0:46,0,0,0,332.0,0:11,6500000
8462038,Shane,Doan,1976-10-10,RW,R,2012-13,48,13,14,27,0.56,6,129,10.08,37,51998.0,18:3,4,11,15,26.67,118,10,23,20,3,0,3,3,7907.0,2:44,0,0,0,568.0,0:11,5300000
8462041,Radek,Dvorak,1977-03-09,RW,R,2012-13,9,4,0,4,0.44,2,17,23.53,2,7092.0,13:8,0,2,2,0.0,2,1,4,4,0,0,0,0,39.0,0:4,0,0,0,564.0,1:2,-111
8462042,Jarome,Iginla,1977-07-01,RW,R,2012-13,44,14,19,33,0.75,-5,134,10.45,31,49668.0,18:48,123,124,247,49.8,65,13,18,17,1,6,6,12,9002.0,3:24,0,0,0,513.0,0:11,7000000
8462077,Jochen,Hecht,1977-06-21,C,L,2012-13,47,5,9,14,0.3,6,69,7.25,18,38628.0,13:41,147,206,353,41.64,24,27,22,13,9,0,0,0,426.0,0:9,1,0,1,4545.0,1:36,-111
8462129,Michal,Handzus,1977-03-11,C,L,2012-13,39,2,6,8,0.21,-2,41,4.88,16,30735.0,13:8,236,190,426,55.4,31,30,16,14,2,0,0,0,1248.0,0:32,0,0,0,4133.0,1:45,2500000
8462196,Stephane,Robidas,1977-03-03,D,R,2012-13,48,1,12,13,0.27,2,46,2.17,56,64047.0,22:14,0,0,0,0.0,136,93,9,18,-9,0,4,4,6152.0,2:8,0,0,0,8936.0,3:6,3300000
8462225,Filip,Kuba,1976-12-29,D,L,2012-13,44,1,9,10,0.23,-18,50,2.0,24,56030.0,21:13,0,0,0,0.0,37,69,14,17,-3,0,4,4,4282.0,1:37,0,0,0,6710.0,2:32,4000000
8462535,Jody,Shelley,1976-02-07,LW,L,2012-13,1,0,0,0,0.0,0,0,,0,478.0,7:58,0,0,0,0.0,3,0,0,0,0,0,0,0,0.0,0:0,0,0,0,0.0,0:0,1100000
8464956,Chris,Phillips,1978-03-09,D,L,2012-13,48,5,9,14,0.29,-5,89,5.62,43,60608.0,21:2,0,0,0,0.0,93,78,9,20,-11,1,0,1,4389.0,1:31,0,0,0,9011.0,3:7,3083333
8464966,Derek,Morris,1978-08-24,D,R,2012-13,39,0,11,11,0.28,-6,68,0.0,36,50067.0,21:23,0,0,0,0.0,92,69,10,15,-5,0,3,3,2584.0,1:6,0,0,0,5490.0,2:20,2750000
8464967,Marty,Reasoner,1977-02-26,C,L,2012-13,31,0,5,5,0.16,-3,34,0.0,4,20880.0,11:13,157,142,299,52.51,21,14,14,1,13,0,0,0,119.0,0:3,0,0,0,3449.0,1:51,1350000
8464975,Daniel,Briere,1977-10-06,C,R,2012-13,34,6,10,16,0.47,-13,87,6.9,10,32762.0,16:3,62,73,135,45.93,15,6,7,13,-6,3,3,6,5857.0,2:52,0,0,0,61.0,0:1,6500000
8464977,Dainius,Zubrus,1978-06-16,C,L,2012-13,22,2,7,9,0.41,-3,22,9.09,12,22156.0,16:47,11,17,28,39.29,31,9,6,6,0,0,0,0,1439.0,1:5,0,2,2,2341.0,1:46,3400000
8464981,Cory,Sarich,1978-08-16,D,R,2012-13,28,0,2,2,0.07,-8,14,0.0,16,24967.0,14:51,0,0,0,0.0,43,33,6,13,-7,0,0,0,37.0,0:1,0,0,0,1680.0,1:0,-111
8464989,Matt,Cullen,1976-11-02,C,L,2012-13,42,7,20,27,0.64,9,79,8.86,10,40046.0,15:53,245,203,448,54.69,18,18,14,24,-10,0,4,4,4906.0,1:56,0,0,0,3386.0,1:20,3500000
8464994,Steve,Begin,1978-06-14,LW,L,2012-13,36,4,4,8,0.22,-2,31,12.9,22,17266.0,7:59,57,60,117,48.72,62,21,4,7,-3,0,0,0,58.0,0:1,1,0,1,2839.0,1:18,525000
8465009,Zdeno,Chara,1977-03-18,D,L,2012-13,48,7,12,19,0.4,14,119,5.88,70,71816.0,24:56,0,1,1,0.0,101,64,12,34,-22,3,1,4,7081.0,2:27,0,1,1,9217.0,3:12,6916667
8465012,Tom,Poti,1977-03-22,D,L,2012-13,16,0,2,2,0.12,-2,8,0.0,2,14615.0,15:13,0,0,0,0.0,5,15,2,5,-3,0,1,1,317.0,0:19,0,0,0,1163.0,1:12,-111
8465025,Arron,Asham,1978-04-13,RW,R,2012-13,27,2,0,2,0.07,2,14,14.29,50,10745.0,6:37,5,5,10,50.0,39,4,5,3,2,0,0,0,226.0,0:8,0,0,0,6.0,0:0,-111
8465042,Toni,Lydman,1977-09-25,D,L,2012-13,35,0,6,6,0.17,-1,28,0.0,12,40713.0,19:23,0,0,0,0.0,83,76,6,19,-13,0,0,0,345.0,0:9,0,1,1,4536.0,2:9,3000000
8465050,Eric,Belanger,1977-12-16,C,L,2012-13,26,0,3,3,0.12,-1,31,0.0,10,22034.0,14:7,203,175,378,53.7,19,15,12,9,3,0,0,0,310.0,0:11,0,0,0,4893.0,3:8,1750000
8465058,Michal,Rozsival,1978-09-03,D,R,2012-13,27,0,12,12,0.44,18,13,0.0,14,29341.0,18:6,0,2,2,0.0,44,28,10,13,-3,0,0,0,1610.0,0:59,0,1,1,804.0,0:29,2000000
8465122,Brett,Clark,1976-12-23,D,L,2012-13,8,0,1,1,0.12,-9,6,0.0,0,6752.0,14:4,0,0,0,0.0,5,11,1,4,-3,0,0,0,11.0,0:1,0,0,0,282.0,0:35,-111
8465166,Craig,Adams,1977-04-26,RW,R,2012-13,48,3,6,9,0.19,-1,46,6.52,28,32146.0,11:9,51,47,98,52.04,107,37,5,7,-2,0,0,0,88.0,0:1,1,0,1,7654.0,2:39,675000
8465200,Tomas,Kaberle,1978-03-02,D,L,2012-13,10,0,3,3,0.3,4,11,0.0,0,8127.0,13:32,0,0,0,0.0,2,11,1,1,0,0,0,0,1435.0,2:23,0,0,0,39.0,0:3,4250000
8465202,Sami,Salo,1974-09-02,D,R,2012-13,46,2,15,17,0.37,5,48,4.17,16,57919.0,20:59,0,0,0,0.0,40,65,13,16,-3,1,6,7,6619.0,2:23,0,0,0,6862.0,2:29,3750000
8465914,Francis,Bouillon,1975-10-17,D,L,2012-13,48,1,8,9,0.19,4,46,2.17,21,52059.0,18:4,0,0,0,0.0,78,50,9,34,-25,0,0,0,4463.0,1:32,0,0,0,2948.0,1:1,1500000
8465951,Matt,Cooke,1978-09-07,LW,L,2012-13,48,8,13,21,0.44,-2,61,13.11,36,42373.0,14:42,3,11,14,21.43,97,41,11,13,-2,0,0,0,226.0,0:4,0,0,0,6333.0,2:11,1800000
8465978,Shawn,Thornton,1977-07-23,LW,R,2012-13,45,3,4,7,0.16,1,55,5.45,60,21886.0,8:6,7,10,17,41.18,77,13,11,3,8,0,0,0,28.0,0:0,0,0,0,0.0,0:0,1100000
8466138,Joe,Thornton,1979-07-02,C,L,2012-13,48,7,33,40,0.83,6,85,8.24,26,52929.0,18:22,410,291,701,58.49,23,21,37,42,-5,2,19,21,9501.0,3:17,0,0,0,1391.0,0:28,7000000
8466139,Patrick,Marleau,1979-09-15,C,L,2012-13,48,17,14,31,0.65,-2,150,11.33,24,55039.0,19:6,71,79,150,47.33,38,13,25,26,-1,6,8,14,9321.0,3:14,1,0,1,4252.0,1:28,6900000
8466140,Olli,Jokinen,1978-12-05,C,L,2012-13,45,7,7,14,0.31,-19,85,8.24,14,46243.0,17:7,300,330,630,47.62,91,27,14,17,-3,0,1,1,6317.0,2:20,0,0,0,39.0,0:0,4500000
8466142,Eric,Brewer,1979-04-17,D,L,2012-13,48,4,8,12,0.25,3,56,7.14,30,59078.0,20:30,0,0,0,0.0,88,94,13,30,-17,1,0,1,719.0,0:14,0,0,0,5843.0,2:1,3875000
8466148,Marian,Hossa,1979-01-12,RW,L,2012-13,40,17,14,31,0.78,20,116,14.66,16,43299.0,18:2,1,2,3,33.33,12,13,48,14,34,4,2,6,6334.0,2:38,1,1,2,3345.0,1:23,5275000
8466149,Daniel,Cleary,1978-12-18,RW,L,2012-13,48,9,6,15,0.31,-6,93,9.68,40,47357.0,16:26,11,12,23,47.83,56,21,11,19,-8,5,0,5,7241.0,2:30,1,0,1,3308.0,1:8,2800000
8466158,Scott,Hannan,1979-01-23,D,L,2012-13,33,0,1,1,0.03,-14,25,0.0,22,38310.0,19:20,0,0,0,0.0,35,54,9,10,-1,0,0,0,33.0,0:1,0,0,0,4847.0,2:26,1000000
8466160,Brenden,Morrow,1979-01-16,LW,L,2012-13,44,12,13,25,0.57,-3,55,21.82,37,39236.0,14:51,13,11,24,54.17,85,20,11,15,-4,2,2,4,6066.0,2:17,0,0,0,292.0,0:6,4100000
8466182,Henrik,Tallinder,1979-01-10,D,L,2012-13,25,1,3,4,0.16,0,22,4.55,10,26356.0,17:34,0,0,0,0.0,15,15,6,7,-1,0,1,1,782.0,0:31,0,0,0,1560.0,1:2,-111
8466215,Joe,Corvo,1977-06-20,D,R,2012-13,40,6,11,17,0.42,-3,71,8.45,14,45022.0,18:45,0,0,0,0.0,27,38,15,20,-5,3,5,8,5429.0,2:15,0,0,0,1734.0,0:43,2000000
8466251,Jason,Chimera,1979-05-02,LW,L,2012-13,47,3,11,14,0.3,-5,92,3.26,48,35743.0,12:40,21,15,36,58.33,73,12,10,20,-10,0,0,0,676.0,0:14,0,0,0,330.0,0:7,1750000
8466285,Brian,Campbell,1979-05-23,D,L,2012-13,48,8,19,27,0.56,-22,70,11.43,12,76080.0,26:25,0,0,0,0.0,14,65,14,27,-13,6,11,17,11091.0,3:51,0,0,0,5608.0,1:56,7142875
8466333,Andrew,Ference,1979-03-17,D,L,2012-13,48,4,9,13,0.27,9,66,6.06,35,56130.0,19:29,0,0,0,0.0,89,60,5,31,-26,0,0,0,448.0,0:9,0,1,1,6420.0,2:13,2250000
8466378,Martin,St. Louis,1975-06-18,RW,L,2012-13,48,17,43,60,1.25,0,112,15.18,14,63312.0,21:59,12,16,28,42.86,23,32,43,40,3,3,17,20,10395.0,3:36,0,0,0,2270.0,0:47,5625000
8466393,Pascal,Dupuis,1979-04-07,RW,L,2012-13,48,20,18,38,0.79,31,140,14.29,26,50420.0,17:30,27,30,57,47.37,83,36,29,13,16,2,1,3,2350.0,0:48,1,0,1,5521.0,1:55,1500000
8466398,Tom,Kostopoulos,1979-01-24,RW,R,2012-13,15,1,0,1,0.07,0,13,7.69,18,8187.0,9:5,3,2,5,60.0,23,3,2,1,1,0,0,0,62.0,0:4,0,0,0,220.0,0:14,600000
8467096,Dan,Boyle,1976-07-12,D,R,2012-13,46,7,13,20,0.43,3,97,7.22,27,62922.0,22:47,0,0,0,0.0,29,81,16,42,-26,5,8,13,9572.0,3:28,0,1,1,3112.0,1:7,6666666
8467329,Vincent,Lecavalier,1980-04-21,C,L,2012-13,39,10,22,32,0.82,-5,86,11.63,29,41846.0,17:52,404,338,742,54.45,74,13,12,7,5,5,4,9,7152.0,3:3,0,0,0,437.0,0:11,7727272
8467330,David,Legwand,1980-08-17,C,L,2012-13,48,12,13,25,0.52,-6,78,15.38,20,53066.0,18:25,362,359,721,50.21,20,20,31,32,-1,2,2,4,5672.0,1:58,0,0,0,3084.0,1:4,4500000
8467331,Brad,Stuart,1979-11-06,D,L,2012-13,48,0,6,6,0.12,4,39,0.0,25,58918.0,20:27,0,0,0,0.0,87,89,15,27,-12,0,0,0,423.0,0:8,0,1,1,7606.0,2:38,3600000
8467332,Bryan,Allen,1980-08-21,D,L,2012-13,41,0,6,6,0.15,1,25,0.0,34,46097.0,18:44,0,0,0,0.0,63,66,4,22,-18,0,0,0,135.0,0:3,0,0,0,4578.0,1:51,3500000
8467334,Manny,Malhotra,1980-05-18,C,L,2012-13,9,0,0,0,0.0,-3,2,0.0,0,6010.0,11:7,64,34,98,65.31,8,4,3,0,3,0,0,0,105.0,0:11,0,0,0,1503.0,2:47,2500000
8467336,Mike,Rupp,1980-01-13,LW,L,2012-13,40,1,3,4,0.1,-2,29,3.45,79,20056.0,8:21,16,11,27,59.26,48,9,6,5,1,0,0,0,18.0,0:0,0,0,0,0.0,0:0,1333333
8467338,Alex,Tanguay,1979-11-21,LW,L,2012-13,40,11,16,27,0.68,-13,44,25.0,22,46462.0,19:21,68,105,173,39.31,24,28,19,33,-14,2,7,9,7242.0,3:1,1,0,1,3154.0,1:18,3500000
8467344,Robyn,Regehr,1980-04-19,D,L,2012-13,41,0,4,4,0.1,-4,27,0.0,23,47776.0,19:25,0,0,0,0.0,100,69,1,21,-20,0,0,0,291.0,0:7,0,0,0,7233.0,2:56,4020000
8467346,Simon,Gagne,1980-02-29,LW,L,2012-13,38,5,11,16,0.42,-1,76,6.58,8,32234.0,14:8,2,0,2,100.0,24,15,17,10,7,2,2,4,3605.0,1:34,0,1,1,850.0,0:22,3500000
8467351,Scott,Gomez,1979-12-23,C,L,2012-13,39,2,13,15,0.38,-10,58,3.45,22,31669.0,13:32,181,143,324,55.86,4,11,20,21,-1,0,8,8,5213.0,2:13,0,0,0,7.0,0:0,7357143
8467353,Nik,Antropov,1980-02-18,C,L,2012-13,40,6,12,18,0.45,6,56,10.71,16,38296.0,15:57,128,176,304,42.11,76,27,15,19,-4,2,1,3,4548.0,1:53,0,0,0,1121.0,0:28,-111
8467365,John,Erskine,1980-06-26,D,L,2012-13,30,3,3,6,0.2,10,32,9.38,34,33232.0,18:27,0,0,0,0.0,91,62,4,28,-24,0,0,0,203.0,0:6,0,0,0,3815.0,2:7,1500000
8467370,Mike,Fisher,1980-06-05,C,R,2012-13,38,10,11,21,0.55,6,68,14.71,27,44373.0,19:27,275,288,563,48.85,67,46,23,13,10,1,5,6,5944.0,2:36,0,0,0,3552.0,1:33,4200000
8467371,Mike,Ribeiro,1980-02-10,C,L,2012-13,48,13,36,49,1.02,-4,63,20.63,53,51360.0,17:50,226,279,505,44.75,55,29,22,22,0,6,21,27,9845.0,3:25,0,0,0,503.0,0:10,5000000
8467389,Brad,Richards,1980-05-02,C,L,2012-13,46,11,23,34,0.74,8,110,10.0,14,51924.0,18:48,391,382,773,50.58,25,43,31,24,7,3,6,9,9050.0,3:16,0,0,0,298.0,0:6,6666666
8467396,Erik,Cole,1978-11-06,LW,L,2012-13,47,9,4,13,0.28,-6,86,10.47,20,46226.0,16:23,22,45,67,32.84,101,27,18,17,1,1,2,3,8275.0,2:56,0,0,0,2388.0,0:50,4500000
8467400,Francois,Beauchemin,1980-06-04,D,L,2012-13,48,6,18,24,0.5,19,74,8.11,22,67559.0,23:27,0,0,0,0.0,81,111,17,35,-18,1,7,8,6229.0,2:9,0,0,0,9199.0,3:11,3500000
8467407,Brian,Gionta,1979-01-18,RW,R,2012-13,48,14,12,26,0.54,3,112,12.5,8,52195.0,18:7,14,28,42,33.33,37,23,23,15,8,5,2,7,8502.0,2:57,0,0,0,2052.0,0:42,5000000
8467412,Alexei,Ponikarovsky,1980-04-09,LW,L,2012-13,42,4,5,9,0.21,-1,51,7.84,14,33160.0,13:9,2,5,7,28.57,81,15,4,7,-3,0,0,0,867.0,0:20,0,0,0,1153.0,0:27,1800000
8467423,Shawn,Horcoff,1978-09-17,C,L,2012-13,31,7,5,12,0.39,8,41,17.07,24,31350.0,16:51,245,255,500,49.0,24,20,6,19,-13,3,1,4,4690.0,2:31,0,0,0,4633.0,2:29,5500000
8467428,Krys,Barch,1980-03-26,RW,L,2012-13,22,0,0,0,0.0,1,4,0.0,44,7727.0,5:51,1,1,2,50.0,25,3,0,2,-2,0,0,0,7.0,0:0,0,0,0,0.0,0:0,750000
8467452,Rob,Scuderi,1978-12-30,D,L,2012-13,48,1,11,12,0.25,-6,33,3.03,4,62759.0,21:47,0,1,1,0.0,30,66,6,41,-35,0,0,0,390.0,0:8,0,1,1,9306.0,3:13,3400000
8467463,Mikael,Samuelsson,1976-12-23,RW,R,2012-13,4,0,1,1,0.25,-3,4,0.0,0,3087.0,12:51,0,0,0,0.0,6,1,1,1,0,0,0,0,538.0,2:14,0,0,0,0.0,0:0,3000000
8467478,Kent,Huskins,1979-05-04,D,L,2012-13,19,0,1,1,0.05,-3,4,0.0,4,17858.0,15:39,0,0,0,0.0,18,37,0,5,-5,0,0,0,133.0,0:7,0,0,0,2345.0,2:3,750000
8467493,Chris,Neil,1979-06-18,RW,R,2012-13,48,4,8,12,0.25,0,87,4.6,144,39925.0,13:51,3,3,6,50.0,206,10,13,9,4,0,3,3,4161.0,1:26,0,0,0,64.0,0:1,2000000
8467496,Andrei,Markov,1978-12-20,D,L,2012-13,48,10,20,30,0.62,-9,79,12.66,14,69493.0,24:7,0,0,0,0.0,22,60,18,50,-32,8,15,23,13734.0,4:46,0,0,0,6446.0,2:14,5750000
8467514,Pavel,Datsyuk,1978-07-20,C,L,2012-13,47,15,34,49,1.04,21,107,14.02,14,56911.0,20:10,488,399,887,55.02,31,30,56,38,18,8,8,16,10029.0,3:33,0,3,3,4056.0,1:26,6700000
8467543,Toby,Petersen,1978-10-27,C,L,2012-13,1,0,0,0,0.0,0,0,,0,400.0,6:40,1,1,2,50.0,1,0,0,0,0,0,0,0,0.0,0:0,0,0,0,0.0,0:0,-111
8467545,Michael,Ryder,1980-03-31,RW,R,2012-13,46,16,19,35,0.76,2,101,15.84,16,44294.0,16:2,3,6,9,33.33,35,16,19,15,4,8,9,17,8228.0,2:58,0,0,0,120.0,0:2,3500000
8467580,Mark,Eaton,1977-05-06,D,L,2012-13,23,0,0,0,0.0,9,8,0.0,4,24811.0,17:58,0,0,0,0.0,9,33,2,3,-1,0,0,0,276.0,0:12,0,0,0,2314.0,1:40,-111
8467831,Jeff,Halpern,1976-05-03,C,R,2012-13,46,1,2,3,0.07,-8,26,3.85,10,28109.0,10:11,208,163,371,56.06,56,22,15,4,11,0,0,0,79.0,0:1,0,0,0,5846.0,2:7,700000
8467875,Daniel,Sedin,1980-09-26,LW,L,2012-13,47,12,28,40,0.85,12,138,8.7,18,53640.0,19:1,3,4,7,42.86,15,7,16,21,-5,3,9,12,10353.0,3:40,0,0,0,201.0,0:4,6100000
8467876,Henrik,Sedin,1980-09-26,C,L,2012-13,48,11,34,45,0.94,19,70,15.71,24,55721.0,19:20,440,451,891,49.38,22,9,21,19,2,1,12,13,10256.0,3:33,1,0,1,477.0,0:9,6100000
8467881,Taylor,Pyatt,1981-08-19,LW,L,2012-13,48,6,5,11,0.23,5,56,10.71,6,37729.0,13:6,4,6,10,40.0,85,28,11,10,1,1,1,2,2404.0,0:50,0,0,0,59.0,0:1,-111
8467890,Barret,Jackman,1981-03-05,D,L,2012-13,46,3,9,12,0.26,6,39,7.69,39,53327.0,19:19,0,0,0,0.0,70,89,11,12,-1,0,0,0,109.0,0:2,0,0,0,7672.0,2:46,3166667
8467899,Martin,Havlat,1981-04-19,RW,L,2012-13,40,8,10,18,0.45,7,89,8.99,30,38024.0,15:50,1,5,6,16.67,6,13,8,20,-12,1,3,4,5349.0,2:13,0,0,0,524.0,0:13,4250000
8467910,Nolan,Yonkman,1981-04-01,D,R,2012-13,7,0,0,0,0.0,-1,4,0.0,11,4103.0,9:46,0,0,0,0.0,12,2,0,1,-1,0,0,0,0.0,0:0,0,0,0,131.0,0:18,-111
8467917,Jordan,Leopold,1980-08-03,D,L,2012-13,39,2,8,10,0.26,-8,60,3.33,14,46970.0,20:4,0,0,0,0.0,39,57,7,14,-7,0,4,4,5108.0,2:10,0,0,0,3319.0,1:25,3000000
8467925,Adam,Hall,1980-08-14,RW,R,2012-13,37,0,4,4,0.11,0,34,0.0,23,23381.0,10:31,141,110,251,56.18,59,26,11,6,5,0,0,0,135.0,0:3,0,0,0,4528.0,2:2,650000
8467931,Matt,Carkner,1980-11-03,D,R,2012-13,22,0,2,2,0.09,-2,19,0.0,46,16620.0,12:35,0,0,0,0.0,27,19,3,7,-4,0,0,0,24.0,0:1,0,0,0,508.0,0:23,1500000
8467967,Chris,Kelly,1980-11-11,C,L,2012-13,34,3,6,9,0.26,-8,40,7.5,16,30538.0,14:58,216,157,373,57.91,43,20,19,9,10,1,0,1,225.0,0:6,0,0,0,4684.0,2:17,3000000
8467977,Brian,McGrattan,1981-09-02,RW,R,2012-13,21,3,0,3,0.14,-4,18,16.67,49,8951.0,7:6,0,1,1,0.0,32,6,3,2,1,0,0,0,14.0,0:0,0,0,0,0.0,0:0,600000
8467988,Ryan,Malone,1979-12-01,LW,L,2012-13,24,6,2,8,0.33,-3,37,16.22,22,22663.0,15:44,9,14,23,39.13,49,9,14,7,7,2,0,2,3733.0,2:35,0,0,0,1128.0,0:47,4500000
8468001,Derek,MacKenzie,1981-06-11,C,L,2012-13,43,3,5,8,0.19,1,33,9.09,36,26674.0,10:20,192,131,323,59.44,122,19,12,5,7,0,0,0,106.0,0:2,0,0,0,3796.0,1:28,1000000
8468064,Martin,Erat,1981-08-29,RW,L,2012-13,45,5,19,24,0.53,-7,69,7.25,30,48388.0,17:55,32,30,62,51.61,48,12,18,35,-17,1,7,8,6424.0,2:22,0,0,0,2484.0,0:55,4500000
8468083,Henrik,Zetterberg,1980-10-09,C,L,2012-13,46,11,37,48,1.04,2,173,6.36,18,56643.0,20:31,263,281,544,48.35,20,10,29,27,2,4,19,23,10554.0,3:49,2,0,2,3741.0,1:21,6083333
8468085,Radim,Vrbata,1981-06-13,RW,R,2012-13,34,12,16,28,0.82,6,106,11.32,14,37351.0,18:18,10,22,32,31.25,26,14,18,11,7,2,10,12,6624.0,3:14,1,0,1,593.0,0:17,3000000
8468095,George,Parros,1979-12-29,RW,R,2012-13,39,1,1,2,0.05,-15,16,6.25,57,15468.0,6:36,0,0,0,0.0,53,13,5,3,2,0,0,0,19.0,0:0,0,0,0,44.0,0:1,937500
8468101,Radek,Martinek,1976-08-31,D,R,2012-13,13,3,0,3,0.23,-2,12,25.0,4,12594.0,16:8,0,0,0,0.0,15,19,2,6,-4,0,0,0,3.0,0:0,0,0,0,468.0,0:36,600000
8468114,Douglas,Murray,1980-03-12,D,L,2012-13,43,1,5,6,0.14,-9,27,3.7,35,45373.0,17:35,0,0,0,0.0,89,98,10,10,0,0,0,0,99.0,0:2,0,0,0,7255.0,2:48,2500000
8468162,Jerred,Smithson,1979-02-04,C,R,2012-13,45,3,3,6,0.13,-4,29,10.34,12,28784.0,10:39,265,213,478,55.44,96,30,8,7,1,0,0,0,108.0,0:2,0,0,0,5876.0,2:10,800000
8468172,Ruslan,Fedotenko,1979-01-18,LW,L,2012-13,47,4,9,13,0.28,8,43,9.3,12,35458.0,12:34,67,119,186,36.02,52,34,13,12,1,0,0,0,330.0,0:7,0,1,1,8049.0,2:51,-111
8468208,Joel,Ward,1980-12-02,RW,R,2012-13,39,8,12,20,0.51,7,52,15.38,12,35401.0,15:7,38,27,65,58.46,37,28,16,7,9,1,2,3,4487.0,1:55,1,0,1,2960.0,1:15,3000000
8468309,Mark,Streit,1977-12-11,D,L,2012-13,48,6,21,27,0.56,-14,83,7.23,22,67240.0,23:20,0,0,0,0.0,34,86,20,37,-17,3,8,11,10818.0,3:45,0,0,0,3859.0,1:20,4100000
8468434,Andy,McDonald,1977-08-25,LW,L,2012-13,37,7,14,21,0.57,-2,86,8.14,16,38304.0,17:15,95,103,198,47.98,10,13,13,18,-5,1,6,7,5604.0,2:31,0,0,0,1246.0,0:33,4700000
8468478,Mike,Weaver,1978-05-02,D,R,2012-13,27,1,8,9,0.33,-3,21,4.76,8,32624.0,20:8,0,0,0,0.0,49,51,4,10,-6,0,0,0,175.0,0:6,0,0,0,5385.0,3:19,1100000
8468482,Dany,Heatley,1981-01-21,LW,L,2012-13,36,11,10,21,0.58,-12,83,13.25,8,40033.0,18:32,12,19,31,38.71,26,22,8,8,0,3,4,7,6561.0,3:2,0,0,0,100.0,0:2,7500000
8468483,Marian,Gaborik,1982-02-14,RW,L,2012-13,47,12,15,27,0.57,-3,151,7.95,14,52225.0,18:31,1,2,3,33.33,21,18,19,18,1,1,8,9,7768.0,2:45,0,0,0,114.0,0:2,7500000
8468484,Rostislav,Klesla,1982-03-21,D,L,2012-13,38,2,6,8,0.21,0,44,4.55,22,40190.0,17:37,0,0,0,0.0,40,60,4,5,-1,0,0,0,69.0,0:1,0,0,0,5350.0,2:20,2975000
8468485,Raffi,Torres,1981-10-08,LW,L,2012-13,39,7,11,18,0.46,0,60,11.67,17,31051.0,13:16,6,7,13,46.15,87,15,12,16,-4,1,0,1,2525.0,1:4,0,0,0,3.0,0:0,1750000
8468486,Scott,Hartnell,1982-04-18,LW,L,2012-13,32,8,3,11,0.34,-5,74,10.81,70,30472.0,15:52,3,1,4,75.0,68,21,11,21,-10,4,1,5,5676.0,2:57,0,0,0,93.0,0:2,4200000
8468493,Ron,Hainsey,1981-03-24,D,L,2012-13,47,0,13,13,0.28,-8,52,0.0,10,64465.0,22:51,0,0,0,0.0,36,123,8,32,-24,0,1,1,1676.0,0:35,0,0,0,8334.0,2:57,4500000
8468498,Brooks,Orpik,1980-09-26,D,L,2012-13,46,0,8,8,0.17,17,32,0.0,32,61519.0,22:17,0,0,0,0.0,119,114,5,19,-14,0,0,0,344.0,0:7,0,0,0,8758.0,3:10,3750000
8468501,Anton,Volchenkov,1982-02-25,D,L,2012-13,37,1,4,5,0.14,-1,38,2.63,37,35637.0,16:3,0,0,0,0.0,51,50,7,10,-3,0,0,0,72.0,0:1,0,0,0,6529.0,2:56,4250000
8468504,Brad,Boyes,1982-04-17,RW,R,2012-13,48,10,25,35,0.73,-6,97,10.31,16,52447.0,18:12,4,12,16,25.0,44,20,19,40,-21,1,12,13,9292.0,3:13,0,0,0,58.0,0:1,1000000
8468505,Steve,Ott,1982-08-19,C,L,2012-13,48,9,15,24,0.5,3,73,12.33,93,53447.0,18:33,298,237,535,55.7,187,21,10,24,-14,2,1,3,7634.0,2:39,0,2,2,5690.0,1:58,2950000
8468508,Justin,Williams,1981-10-04,RW,R,2012-13,48,11,22,33,0.69,15,142,7.75,22,48931.0,16:59,2,4,6,33.33,29,12,15,28,-13,1,5,6,6184.0,2:8,0,0,0,892.0,0:18,3825000
8468509,Niklas,Kronwall,1981-01-12,D,L,2012-13,48,5,24,29,0.6,-5,67,7.46,44,70162.0,24:21,0,0,0,0.0,42,83,11,21,-10,2,14,16,10685.0,3:42,0,0,0,7589.0,2:38,4750000
8468513,Nick,Schultz,1982-08-25,D,L,2012-13,48,1,8,9,0.19,-13,33,3.03,24,53661.0,18:37,0,2,2,0.0,52,107,9,27,-18,0,0,0,159.0,0:3,0,0,0,7148.0,2:28,3500000
8468518,Tomas,Kopecky,1982-02-05,RW,L,2012-13,47,15,12,27,0.57,-8,92,16.3,28,49873.0,17:41,42,44,86,48.84,23,25,24,11,13,4,5,9,5904.0,2:5,1,0,1,5282.0,1:52,3000000
8468520,Kurtis,Foster,1981-11-24,D,R,2012-13,23,1,4,5,0.22,0,21,4.76,25,18066.0,13:5,0,0,0,0.0,16,16,3,3,0,1,0,1,1855.0,1:20,0,0,0,152.0,0:6,950000
8468526,Jarret,Stoll,1982-06-24,C,R,2012-13,48,7,11,18,0.38,1,73,9.59,28,47573.0,16:31,418,328,746,56.03,107,44,8,12,-4,1,4,5,5091.0,1:46,1,1,2,5980.0,2:4,3250000
8468534,Andreas,Lilja,1975-07-13,D,L,2012-13,4,0,0,0,0.0,-1,2,0.0,0,4027.0,16:46,0,0,0,0.0,12,7,1,3,-2,0,0,0,4.0,0:1,0,0,0,404.0,1:41,737500
8468535,Antoine,Vermette,1982-07-20,C,L,2012-13,48,13,8,21,0.44,-3,91,14.29,36,52548.0,18:14,482,357,839,57.45,63,35,24,7,17,3,0,3,7185.0,2:29,0,0,0,5046.0,1:45,3750000
8468542,Paul,Martin,1981-03-05,D,L,2012-13,34,6,17,23,0.68,14,38,15.79,16,51663.0,25:19,0,0,0,0.0,17,50,14,12,2,2,7,9,6502.0,3:11,0,0,0,6409.0,3:8,5000000
8468598,Lubomir,Visnovsky,1976-08-11,D,L,2012-13,35,3,11,14,0.4,12,69,4.35,20,47891.0,22:48,0,0,0,0.0,20,52,13,30,-17,1,7,8,6745.0,3:12,0,0,0,1952.0,0:55,5600000
8468611,Matt,Hendricks,1981-06-17,C,L,2012-13,48,5,3,8,0.17,-6,54,9.26,73,33761.0,11:43,147,112,259,56.76,93,31,15,12,3,0,0,0,182.0,0:3,0,0,0,5012.0,1:44,825000
8468635,Travis,Moen,1982-04-06,LW,L,2012-13,45,2,4,6,0.13,-4,32,6.25,32,31468.0,11:39,4,6,10,40.0,82,22,2,11,-9,0,0,0,441.0,0:9,0,0,0,6071.0,2:14,1850000
8468636,Greg,Zanon,1980-06-05,D,L,2012-13,44,0,6,6,0.14,-16,40,0.0,28,51032.0,19:19,0,0,0,0.0,65,124,14,16,-2,0,0,0,284.0,0:6,0,1,1,7081.0,2:40,2250000
8468639,John-Michael,Liles,1980-11-25,D,L,2012-13,32,2,9,11,0.34,-1,47,4.26,4,36034.0,18:46,0,1,1,0.0,45,52,8,22,-14,0,1,1,4196.0,2:11,0,0,0,1173.0,0:36,3875000
8468660,Darcy,Hordichuk,1980-08-10,LW,L,2012-13,4,0,0,0,0.0,-1,0,,2,488.0,2:2,0,0,0,0.0,6,0,0,0,0,0,0,0,0.0,0:0,0,0,0,0.0,0:0,850000
8468674,Deryk,Engelland,1982-04-03,D,R,2012-13,42,0,6,6,0.14,5,31,0.0,54,35078.0,13:55,0,0,0,0.0,70,57,7,16,-9,0,0,0,24.0,0:0,0,0,0,2307.0,0:54,566667
8468695,Matthew,Lombardi,1982-03-18,C,L,2012-13,28,4,4,8,0.29,-2,44,9.09,8,23456.0,13:57,105,131,236,44.49,24,14,7,8,-1,1,1,2,2444.0,1:27,0,0,0,584.0,0:20,3500000
8468700,Paul,Gaustad,1982-02-03,C,L,2012-13,23,2,3,5,0.22,-1,35,5.71,20,21006.0,15:13,268,181,449,59.69,40,19,10,5,5,0,0,0,743.0,0:32,0,0,0,3329.0,2:24,3250000
8468704,Antti,Miettinen,1980-07-03,RW,R,2012-13,22,3,2,5,0.23,-3,26,11.54,2,16697.0,12:38,0,4,4,0.0,29,7,2,2,0,0,0,0,119.0,0:5,0,0,0,538.0,0:24,1300000
8468778,Colton,Orr,1982-03-03,RW,R,2012-13,44,1,3,4,0.09,4,13,7.69,155,16870.0,6:23,0,1,1,0.0,78,17,4,5,-1,0,0,0,107.0,0:2,0,0,0,11.0,0:0,1000000
8469454,Ilya,Kovalchuk,1983-04-15,RW,R,2012-13,37,11,20,31,0.84,-6,123,8.94,18,54917.0,24:44,7,15,22,31.82,13,12,10,41,-31,2,12,14,12138.0,5:28,4,0,4,3788.0,1:42,6666666
8469455,Jason,Spezza,1983-06-13,C,R,2012-13,5,2,3,5,1.0,3,12,16.67,2,5753.0,19:10,68,51,119,57.14,0,2,5,3,2,1,1,2,744.0,2:28,0,0,0,562.0,1:52,7000000
8469457,Stephen,Weiss,1983-04-03,C,L,2012-13,17,1,3,4,0.24,-13,19,5.26,25,18830.0,18:27,141,135,276,51.09,6,10,13,2,11,1,1,2,2519.0,2:28,0,0,0,1791.0,1:45,3100000
8469459,Mikko,Koivu,1983-03-12,C,L,2012-13,48,11,26,37,0.77,2,127,8.66,26,60759.0,21:5,524,447,971,53.96,47,18,26,19,7,0,13,13,10045.0,3:29,0,0,0,4553.0,1:34,6750000
8469460,Mike,Komisarek,1982-01-19,D,R,2012-13,4,0,0,0,0.0,2,1,0.0,2,3683.0,15:20,0,0,0,0.0,11,6,1,1,0,0,0,0,0.0,0:0,0,0,0,577.0,2:24,4300000
8469462,Tuomo,Ruutu,1983-02-16,LW,L,2012-13,17,4,5,9,0.53,-6,30,13.33,8,15544.0,15:14,1,7,8,12.5,51,7,12,8,4,0,0,0,1360.0,1:20,0,0,0,21.0,0:1,4750000
8469465,Dan,Hamhuis,1982-12-13,D,L,2012-13,47,4,20,24,0.51,9,61,6.56,12,65960.0,23:23,0,0,0,0.0,47,63,20,31,-11,0,6,6,6231.0,2:12,1,0,1,8646.0,3:3,4500000
8469466,Ales,Hemsky,1983-08-13,RW,R,2012-13,38,9,11,20,0.53,-6,82,10.98,16,35804.0,15:42,12,12,24,50.0,11,9,16,17,-1,5,4,9,6004.0,2:38,0,0,0,158.0,0:4,5000000
8469467,Chuck,Kobasew,1982-04-17,RW,R,2012-13,37,5,4,9,0.24,6,43,11.63,21,25019.0,11:16,18,31,49,36.73,34,17,14,4,10,0,0,0,324.0,0:8,0,0,0,3945.0,1:46,1250000
8469469,R.J.,Umberger,1982-05-03,C,L,2012-13,48,8,10,18,0.38,3,96,8.33,16,53248.0,18:29,54,54,108,50.0,51,45,22,11,11,2,3,5,7730.0,2:41,0,0,0,2974.0,1:1,4600000
8469470,Carlo,Colaiacovo,1983-01-27,D,L,2012-13,6,0,1,1,0.17,-4,12,0.0,2,6807.0,18:54,0,0,0,0.0,12,10,0,0,0,0,1,1,880.0,2:26,0,0,0,222.0,0:37,2500000
8469473,Marcel,Goc,1983-08-24,C,L,2012-13,42,9,10,19,0.45,-6,92,9.78,8,46039.0,18:16,410,376,786,52.16,73,20,21,11,10,4,2,6,4338.0,1:43,0,0,0,5367.0,2:7,1700000
8469474,Colby,Armstrong,1982-11-23,RW,R,2012-13,37,2,3,5,0.14,1,33,6.06,12,24869.0,11:12,9,12,21,42.86,36,21,10,8,2,0,0,0,145.0,0:3,0,0,0,3991.0,1:47,3000000
8469476,Tim,Gleason,1983-01-29,D,L,2012-13,42,0,9,9,0.21,-3,36,0.0,40,49310.0,19:34,0,0,0,0.0,90,64,10,11,-1,0,1,1,284.0,0:6,0,0,0,7062.0,2:48,4000000
8469483,David,Steckel,1982-03-15,C,L,2012-13,34,1,6,7,0.21,0,23,4.35,4,18901.0,9:15,175,146,321,54.52,41,21,6,5,1,0,0,0,89.0,0:2,0,0,0,2463.0,1:12,1100000
8469485,Derek,Roy,1983-05-04,C,L,2012-13,42,7,21,28,0.67,4,85,8.24,6,46858.0,18:35,295,352,647,45.6,15,30,31,24,7,2,6,8,6476.0,2:34,0,1,1,4276.0,1:41,4000000
8469490,Tim,Jackman,1981-11-14,RW,R,2012-13,42,1,4,5,0.12,-9,42,2.38,76,19151.0,7:35,11,13,24,45.83,98,17,6,7,-1,0,1,1,240.0,0:5,0,0,0,11.0,0:0,612500
8469492,Fedor,Tyutin,1983-07-19,D,L,2012-13,48,4,18,22,0.46,9,56,7.14,28,69395.0,24:5,1,0,1,100.0,58,58,9,19,-10,0,5,5,7977.0,2:46,0,1,1,7311.0,2:32,4500000
8469500,Michael,Cammalleri,1982-06-08,LW,L,2012-13,44,13,19,32,0.73,-15,102,12.75,25,47667.0,18:3,253,243,496,51.01,20,9,22,15,7,5,10,15,7556.0,2:51,0,0,0,1787.0,0:40,6000000
8469501,Chris,Thorburn,1983-06-03,RW,R,2012-13,42,2,2,4,0.1,-5,13,15.38,70,15936.0,6:19,20,26,46,43.48,65,19,3,1,2,0,0,0,61.0,0:1,0,0,0,693.0,0:16,866667
8469506,Jason,Pominville,1982-11-30,RW,R,2012-13,47,14,20,34,0.72,1,118,11.86,8,56907.0,20:10,51,54,105,48.57,21,35,38,13,25,2,7,9,9908.0,3:30,1,0,1,4887.0,1:43,5300000
8469508,Jay,McClement,1983-03-02,C,L,2012-13,48,8,9,17,0.35,0,48,16.67,11,43917.0,15:14,203,190,393,51.65,76,39,30,17,13,0,0,0,180.0,0:3,0,0,0,10559.0,3:39,1500000
8469521,Tomas,Plekanec,1982-10-31,C,L,2012-13,47,14,19,33,0.7,3,133,10.53,24,54175.0,19:12,486,475,961,50.57,26,17,15,22,-7,4,11,15,8380.0,2:58,0,0,0,5922.0,2:6,5000000
8469531,Jay,Harrison,1982-11-03,D,L,2012-13,47,3,7,10,0.21,-10,54,5.56,51,56140.0,19:54,0,0,0,0.0,83,110,12,24,-12,0,1,1,1419.0,0:30,0,0,0,6028.0,2:8,700000
8469534,Aaron,Johnson,1983-04-30,D,L,2012-13,10,0,0,0,0.0,0,8,0.0,10,8922.0,14:52,0,0,0,0.0,18,5,0,7,-7,0,0,0,6.0,0:0,0,0,0,570.0,0:57,650000
8469544,Patrick,Sharp,1981-12-27,LW,R,2012-13,28,6,14,20,0.71,8,88,6.82,14,31632.0,18:49,40,22,62,64.52,26,12,14,14,0,1,6,7,5222.0,3:6,0,0,0,1489.0,0:53,5900000
8469547,Jordin,Tootoo,1983-02-02,RW,R,2012-13,42,3,5,8,0.19,0,45,6.67,78,22889.0,9:4,0,0,0,0.0,68,7,11,8,3,0,1,1,249.0,0:5,0,0,0,0.0,0:0,1900000
8469555,Christian,Ehrhoff,1982-07-06,D,L,2012-13,47,5,17,22,0.47,6,102,4.9,34,71040.0,25:11,0,0,0,0.0,38,81,22,24,-2,1,8,9,9871.0,3:30,0,0,0,5611.0,1:59,4000000
8469581,Kyle,Wellwood,1983-05-16,C,R,2012-13,39,6,9,15,0.38,0,37,16.22,2,30365.0,12:58,43,35,78,55.13,10,10,18,15,3,0,2,2,2214.0,0:56,0,0,0,0.0,0:0,1600000
8469591,Cody,McCormick,1983-04-18,C,R,2012-13,8,0,0,0,0.0,-2,6,0.0,10,3099.0,6:27,12,13,25,48.0,17,5,0,1,-1,0,0,0,2.0,0:0,0,0,0,54.0,0:6,1200000
8469598,Kevin,Bieksa,1981-06-16,D,R,2012-13,36,6,6,12,0.33,6,77,7.79,48,47392.0,21:56,0,0,0,0.0,60,50,21,23,-2,2,1,3,4534.0,2:5,0,0,0,4270.0,1:58,4600000
8469619,Dennis,Seidenberg,1981-07-18,D,L,2012-13,46,4,13,17,0.37,18,83,4.82,10,65668.0,23:47,0,0,0,0.0,115,115,10,16,-6,0,2,2,3004.0,1:5,0,0,0,8759.0,3:10,3250000
8469622,Ryane,Clowe,1982-09-30,LW,L,2012-13,40,3,16,19,0.48,1,87,3.45,93,39919.0,16:37,5,10,15,33.33,99,19,13,26,-13,1,3,4,5703.0,2:22,0,0,0,21.0,0:0,3625000
8469623,Marek,Zidlicky,1977-02-03,D,R,2012-13,48,4,15,19,0.4,-12,101,3.96,38,60464.0,20:59,0,0,0,0.0,52,42,10,31,-21,1,10,11,10425.0,3:37,0,0,0,574.0,0:11,4000000
8469626,Andrew,Alberts,1981-06-30,D,L,2012-13,24,0,1,1,0.04,-7,15,0.0,32,21858.0,15:10,0,0,0,0.0,39,31,5,7,-2,0,0,0,20.0,0:0,0,0,0,1939.0,1:20,1225000
8469638,Jussi,Jokinen,1983-04-01,LW,L,2012-13,43,13,9,22,0.51,-5,74,17.57,24,39813.0,15:25,250,182,432,57.87,17,22,26,14,12,3,4,7,6280.0,2:26,0,0,0,3241.0,1:15,3000000
8469639,Brooks,Laich,1983-06-23,C,L,2012-13,9,1,3,4,0.44,2,10,10.0,6,8930.0,16:32,41,40,81,50.62,14,6,2,5,-3,0,1,1,451.0,0:50,0,0,0,1200.0,2:13,4500000
8469664,David,Moss,1981-12-28,RW,R,2012-13,45,5,15,20,0.44,3,82,6.1,21,41986.0,15:33,9,22,31,29.03,73,34,15,6,9,1,1,2,1110.0,0:24,1,0,1,6079.0,2:15,2100000
8469665,Johnny,Oduya,1981-10-01,D,L,2012-13,48,3,9,12,0.25,12,52,5.77,10,59100.0,20:31,0,0,0,0.0,24,79,19,24,-5,0,1,1,1480.0,0:30,0,1,1,6932.0,2:24,3375000
8469685,Andrew,Murray,1981-11-06,C,L,2012-13,1,0,0,0,0.0,0,2,0.0,0,469.0,7:49,0,0,0,0.0,1,0,0,0,0,0,0,0,0.0,0:0,0,0,0,0.0,0:0,600000
8469707,PA,Parenteau,1983-03-24,RW,R,2012-13,48,18,25,43,0.9,-11,105,17.14,38,55142.0,19:8,1,12,13,7.69,50,14,40,29,11,6,7,13,8301.0,2:52,0,0,0,107.0,0:2,4000000
8469755,Brandon,Segal,1983-07-12,RW,R,2012-13,1,0,0,0,0.0,0,0,,2,321.0,5:21,0,0,0,0.0,0,1,0,0,0,0,0,0,0.0,0:0,0,0,0,58.0,0:58,-111
8469759,Vernon,Fiddler,1980-05-09,C,L,2012-13,46,4,13,17,0.37,3,56,7.14,48,35478.0,12:51,319,300,619,51.53,34,28,18,8,10,1,1,2,1219.0,0:26,0,1,1,6585.0,2:23,1800000
8469760,Zbynek,Michalek,1982-12-23,D,R,2012-13,34,0,2,2,0.06,4,42,0.0,14,43464.0,21:18,0,0,0,0.0,42,87,6,12,-6,0,0,0,367.0,0:10,0,0,0,6039.0,2:57,4000000
8469765,Marc-Andre,Bergeron,1980-10-13,D,L,2012-13,25,1,8,9,0.36,-4,43,2.33,9,20648.0,13:45,0,0,0,0.0,16,19,7,11,-4,0,5,5,4259.0,2:50,0,0,0,132.0,0:5,1000000
8469770,Dennis,Wideman,1983-03-20,D,R,2012-13,46,6,16,22,0.48,-9,94,6.38,12,69067.0,25:1,0,1,1,0.0,40,100,16,37,-21,4,9,13,9636.0,3:29,0,1,1,5991.0,2:10,5250000
8469779,Keith,Aucoin,1978-11-06,C,L,2012-13,41,6,6,12,0.29,-1,50,12.0,4,30732.0,12:29,167,177,344,48.55,33,21,21,18,3,1,0,1,2137.0,0:52,0,0,0,116.0,0:2,-111
8469812,Chad,LaRose,1982-03-27,RW,R,2012-13,35,2,2,4,0.11,-8,65,3.08,29,26980.0,12:50,9,13,22,40.91,59,6,8,6,2,0,0,0,2414.0,1:8,0,0,0,341.0,0:9,1700000
8469820,Zenon,Konopka,1981-01-02,C,L,2012-13,37,0,0,0,0.0,-4,18,0.0,117,18728.0,8:26,162,105,267,60.67,23,9,5,8,-3,0,0,0,34.0,0:0,0,0,0,360.0,0:9,-111
8469992,Sheldon,Brookbank,1980-10-03,D,R,2012-13,26,1,0,1,0.04,-2,25,4.0,21,19890.0,12:45,0,1,1,0.0,28,34,8,15,-7,0,0,0,14.0,0:0,1,0,1,976.0,0:37,-111
8470018,Matt,Ellis,1981-08-31,LW,L,2012-13,6,0,0,0,0.0,0,8,0.0,0,2231.0,6:11,15,21,36,41.67,0,3,0,2,-2,0,0,0,0.0,0:0,0,0,0,158.0,0:26,525000
8470039,Tomas,Fleischmann,1984-05-16,LW,L,2012-13,48,12,23,35,0.73,-10,121,9.92,16,53954.0,18:44,10,10,20,50.0,29,10,27,26,1,2,11,13,7064.0,2:27,1,0,1,2509.0,0:52,4500000
8470041,Rick,Nash,1984-06-16,LW,L,2012-13,44,21,21,42,0.95,16,176,11.93,26,52722.0,19:58,5,7,12,41.67,46,25,19,32,-13,3,6,9,8343.0,3:9,1,0,1,1380.0,0:31,7800000
8470047,Valtteri,Filppula,1984-03-20,C,L,2012-13,41,9,8,17,0.41,-4,78,11.54,6,43729.0,17:46,179,144,323,55.42,16,12,18,19,-1,3,0,3,6691.0,2:43,0,0,0,1499.0,0:36,3000000
8470054,Keith,Ballard,1982-11-26,D,L,2012-13,36,0,2,2,0.06,-2,35,0.0,29,33415.0,15:28,0,0,0,0.0,45,34,16,13,3,0,0,0,584.0,0:16,0,0,0,2301.0,1:3,3300000
8470061,Derek,Meech,1984-04-21,D,L,2012-13,16,0,1,1,0.06,0,5,0.0,2,14109.0,14:41,0,0,0,0.0,24,12,1,7,-6,0,0,0,347.0,0:21,0,0,0,153.0,0:9,700000
8470063,Adam,Burish,1983-01-06,RW,R,2012-13,46,1,2,3,0.07,-7,39,2.56,25,29172.0,10:34,122,106,228,53.51,65,33,4,10,-6,0,0,0,161.0,0:3,1,0,1,3577.0,1:17,1850000
8470104,Tom,Gilbert,1983-01-10,D,R,2012-13,43,3,10,13,0.3,-11,36,8.33,18,49847.0,19:19,0,0,0,0.0,24,57,9,15,-6,1,3,4,4170.0,1:36,0,0,0,3818.0,1:28,4000000
8470105,Scottie,Upshall,1983-10-07,RW,L,2012-13,27,4,1,5,0.19,-8,54,7.41,25,21869.0,13:29,9,5,14,64.29,38,6,13,8,5,1,0,1,1321.0,0:48,0,0,0,2000.0,1:14,3500000
8470110,Trevor,Daley,1983-10-09,D,L,2012-13,44,4,9,13,0.3,1,58,6.9,14,56528.0,21:24,0,0,0,0.0,27,69,10,20,-10,2,1,3,5792.0,2:11,0,1,1,6826.0,2:35,3300000
8470120,Alexander,Semin,1984-03-03,RW,R,2012-13,44,13,31,44,1.0,14,150,8.67,46,55289.0,20:56,5,16,21,23.81,14,21,46,35,11,4,5,9,9407.0,3:33,0,1,1,2090.0,0:47,7000000
8470121,Matt,Greene,1983-05-13,D,R,2012-13,5,0,1,1,0.2,-1,3,0.0,8,4586.0,15:17,0,0,0,0.0,22,5,0,3,-3,0,0,0,71.0,0:14,0,0,0,639.0,2:7,2950000
8470123,Cam,Janssen,1984-04-15,RW,R,2012-13,4,0,0,0,0.0,-1,0,,2,953.0,3:58,0,0,0,0.0,5,0,0,0,0,0,0,0,0.0,0:0,0,0,0,0.0,0:0,575000
8470137,Joni,Pitkanen,1983-09-19,D,L,2012-13,22,1,8,9,0.41,2,34,2.94,12,30119.0,22:49,0,0,0,0.0,16,34,11,12,-1,0,2,2,4209.0,3:11,0,0,0,2265.0,1:42,4500000
8470144,Frans,Nielsen,1984-04-24,C,L,2012-13,48,6,23,29,0.6,-3,93,6.45,12,51889.0,18:1,268,290,558,48.03,23,47,29,24,5,2,8,10,6016.0,2:5,1,0,1,7018.0,2:26,2750000
8470151,Jay,Bouwmeester,1983-09-27,D,L,2012-13,47,7,15,22,0.47,-6,79,8.86,22,69468.0,24:38,0,0,0,0.0,41,61,11,28,-17,1,6,7,5014.0,1:46,0,2,2,8238.0,2:55,6680000
8470153,Pierre-Marc,Bouchard,1984-04-27,C,L,2012-13,43,8,12,20,0.47,3,71,11.27,8,35972.0,13:56,1,6,7,14.29,12,6,10,15,-5,0,2,2,4470.0,1:43,0,0,0,12.0,0:0,4080000
8470156,Joey,Crabb,1983-04-03,RW,R,2012-13,26,2,0,2,0.08,-1,20,10.0,8,14693.0,9:25,7,27,34,20.59,24,17,6,4,2,0,0,0,46.0,0:1,0,0,0,1636.0,1:2,950000
8470159,Boyd,Gordon,1983-10-19,C,R,2012-13,48,4,10,14,0.29,0,59,6.78,8,43232.0,15:0,452,337,789,57.29,22,44,18,7,11,0,2,2,439.0,0:9,0,1,1,8227.0,2:51,1325000
8470162,Matt,Stajan,1983-12-19,C,L,2012-13,43,5,18,23,0.53,7,44,11.36,26,44278.0,17:9,356,414,770,46.23,47,30,24,17,7,0,0,0,648.0,0:15,0,0,0,5072.0,1:57,3500000
8470169,Gregory,Campbell,1983-12-17,C,L,2012-13,48,4,9,13,0.27,2,52,7.69,41,39494.0,13:42,189,212,401,47.13,71,28,15,8,7,0,1,1,1029.0,0:21,1,0,1,6209.0,2:9,1600000
8470171,Max,Talbot,1984-02-11,C,L,2012-13,35,5,5,10,0.29,2,41,12.2,23,32407.0,15:25,92,100,192,47.92,57,27,9,9,0,0,0,0,367.0,0:10,1,0,1,7280.0,3:28,1800000
8470180,Eric,Nystrom,1983-02-14,LW,L,2012-13,48,7,4,11,0.23,-3,49,14.29,61,41328.0,14:21,15,11,26,57.69,122,26,19,12,7,0,0,0,1595.0,0:33,1,0,1,6285.0,2:10,1400000
8470187,Johnny,Boychuk,1984-01-19,D,R,2012-13,44,1,5,6,0.14,5,75,1.33,12,53873.0,20:24,0,0,0,0.0,79,87,4,15,-11,0,0,0,491.0,0:11,0,0,0,6664.0,2:31,3366667
8470189,David,Van Der Gulik,1983-04-20,LW,L,2012-13,9,0,2,2,0.22,2,10,0.0,6,5098.0,9:26,4,4,8,50.0,10,5,3,1,2,0,0,0,26.0,0:2,0,0,0,886.0,1:38,575000
8470192,Steve,Eminger,1983-10-31,D,R,2012-13,35,0,3,3,0.09,9,22,0.0,8,27387.0,13:2,0,0,0,0.0,53,41,4,7,-3,0,0,0,168.0,0:4,0,0,0,1096.0,0:31,750000
8470201,Jiri,Hudler,1984-01-04,RW,L,2012-13,42,10,17,27,0.64,-13,56,17.86,22,43241.0,17:9,10,21,31,32.26,16,5,22,17,5,5,3,8,6590.0,2:36,0,0,0,638.0,0:15,4000000
8470207,Joffrey,Lupul,1983-09-23,LW,R,2012-13,16,11,7,18,1.12,8,42,26.19,12,15478.0,16:7,3,5,8,37.5,31,7,9,5,4,3,0,3,2547.0,2:39,0,0,0,0.0,0:0,4250000
8470222,James,Wisniewski,1984-02-21,D,R,2012-13,30,5,9,14,0.47,-1,62,8.06,15,41095.0,22:49,0,0,0,0.0,53,48,11,15,-4,4,1,5,5906.0,3:16,0,1,1,2718.0,1:30,5500000
8470230,Daniel,Paille,1984-04-15,LW,L,2012-13,46,10,7,17,0.37,3,70,14.29,8,35004.0,12:40,2,8,10,20.0,45,15,25,11,14,0,1,1,90.0,0:1,2,0,2,4919.0,1:46,1300000
8470232,Kris,Newbury,1982-02-19,C,L,2012-13,6,0,1,1,0.17,1,4,0.0,9,2839.0,7:53,16,16,32,50.0,9,0,1,0,1,0,0,0,145.0,0:24,0,0,0,0.0,0:0,-111
8470257,Alexander,Steen,1984-03-01,LW,L,2012-13,40,8,19,27,0.68,5,129,6.2,14,45581.0,18:59,94,110,204,46.08,28,22,13,13,0,3,6,9,6146.0,2:33,0,0,0,3897.0,1:37,3362500
8470265,Anton,Babchuk,1984-05-06,D,R,2012-13,7,0,1,1,0.14,-1,5,0.0,0,4977.0,11:51,0,0,0,0.0,1,9,0,5,-5,0,0,0,203.0,0:29,0,0,0,0.0,0:0,2500000
8470273,Ian,White,1984-06-04,D,R,2012-13,25,2,2,4,0.16,5,27,7.41,4,29375.0,19:35,1,0,1,100.0,14,32,1,8,-7,0,0,0,3845.0,2:33,0,0,0,43.0,0:1,2875000
8470274,Chris,Higgins,1983-06-02,LW,L,2012-13,41,10,5,15,0.37,-4,77,12.99,10,40383.0,16:24,33,58,91,36.26,46,22,36,12,24,0,0,0,1995.0,0:48,0,0,0,4814.0,1:57,1900000
8470280,Ben,Eager,1984-01-22,LW,L,2012-13,14,1,1,2,0.14,-4,14,7.14,25,8114.0,9:39,0,0,0,0.0,40,6,3,2,1,0,0,0,46.0,0:3,0,0,0,18.0,0:1,1100000
8470281,Duncan,Keith,1983-07-16,D,L,2012-13,47,3,24,27,0.57,16,91,3.3,31,67986.0,24:6,0,0,0,0.0,19,66,26,29,-3,2,8,10,7730.0,2:44,0,1,1,6420.0,2:16,5538462
8470283,Tim,Brent,1984-03-10,C,R,2012-13,30,0,3,3,0.1,-3,23,0.0,8,17628.0,9:47,124,116,240,51.67,31,15,3,3,0,0,2,2,3004.0,1:40,0,0,0,1308.0,0:43,750000
8470289,Jim,Slater,1982-12-09,C,L,2012-13,26,1,1,2,0.08,-3,22,4.55,19,16305.0,10:27,145,122,267,54.31,41,12,10,3,7,0,0,0,42.0,0:1,0,0,0,2884.0,1:50,1600000
8470302,Patrick,Dwyer,1983-06-22,RW,R,2012-13,46,8,8,16,0.35,-7,93,8.6,12,42591.0,15:25,17,30,47,36.17,57,28,16,10,6,1,0,1,960.0,0:20,1,0,1,5876.0,2:7,625000
8470309,Ryan,Whitney,1983-02-19,D,L,2012-13,34,4,9,13,0.38,-7,30,13.33,23,37694.0,18:28,0,0,0,0.0,16,55,9,35,-26,0,7,7,5271.0,2:35,0,0,0,730.0,0:21,4000000
8470310,Aaron,Rome,1983-09-27,D,L,2012-13,27,0,5,5,0.19,-2,15,0.0,18,24841.0,15:20,0,0,0,0.0,43,32,2,9,-7,0,0,0,129.0,0:4,0,0,0,2506.0,1:32,1500000
8470318,Jonathan,Ericsson,1984-03-02,D,L,2012-13,45,3,10,13,0.29,6,34,8.82,29,57576.0,21:19,0,0,0,0.0,67,40,8,30,-22,0,0,0,694.0,0:15,0,0,0,8473.0,3:8,3250000
8470324,Josh,Gorges,1984-08-14,D,L,2012-13,48,2,7,9,0.19,4,40,5.0,15,61597.0,21:23,0,0,0,0.0,68,116,8,18,-10,0,0,0,1304.0,0:27,0,0,0,9301.0,3:13,3900000
8470358,Alexandre,Burrows,1981-04-11,RW,L,2012-13,47,13,11,24,0.51,15,140,9.29,54,53318.0,18:54,48,60,108,44.44,52,15,19,15,4,1,2,3,7811.0,2:46,0,0,0,5708.0,2:1,2000000
8470378,Andre,Benoit,1984-01-06,D,L,2012-13,33,3,7,10,0.3,-3,50,6.0,8,32507.0,16:25,0,0,0,0.0,29,54,7,17,-10,1,1,2,3204.0,1:37,0,0,0,1241.0,0:37,650000
8470543,Chris,Kunitz,1979-09-26,LW,L,2012-13,48,22,30,52,1.08,30,113,19.47,39,51904.0,18:1,4,5,9,44.44,104,13,13,17,-4,9,7,16,11016.0,3:49,0,0,0,405.0,0:8,3725000
8470595,Eric,Staal,1984-10-29,C,L,2012-13,48,18,35,53,1.1,5,152,11.84,54,60468.0,20:59,527,487,1014,51.97,35,24,48,24,24,3,6,9,10249.0,3:33,1,0,1,3464.0,1:12,8250000
8470596,Nathan,Horton,1985-05-29,RW,R,2012-13,43,13,9,22,0.51,1,114,11.4,22,43487.0,16:51,5,5,10,50.0,41,10,9,13,-4,0,1,1,5314.0,2:3,0,0,0,229.0,0:5,4000000
8470598,Thomas,Vanek,1984-01-19,LW,R,2012-13,38,20,21,41,1.08,-1,119,16.81,20,41965.0,18:24,8,4,12,66.67,13,4,34,30,4,9,5,14,7576.0,3:19,1,0,1,462.0,0:12,7142857
8470599,Milan,Michalek,1984-12-07,LW,L,2012-13,23,4,10,14,0.61,8,58,6.9,17,25104.0,18:11,2,2,4,50.0,6,13,9,6,3,0,2,2,3574.0,2:35,0,1,1,1778.0,1:17,4333333
8470600,Ryan,Suter,1985-01-21,D,L,2012-13,48,4,28,32,0.67,2,91,4.4,24,78565.0,27:16,0,0,0,0.0,33,74,9,19,-10,3,12,15,10886.0,3:46,0,0,0,6134.0,2:7,7538462
8470601,Braydon,Coburn,1985-02-27,D,L,2012-13,33,1,4,5,0.15,-10,38,2.63,41,44780.0,22:36,0,0,0,0.0,76,61,12,31,-19,0,0,0,773.0,0:23,0,0,0,6869.0,3:28,4500000
8470602,Dion,Phaneuf,1985-04-10,D,L,2012-13,48,9,19,28,0.58,-4,88,10.23,65,72513.0,25:10,0,0,0,0.0,131,91,15,53,-38,3,13,16,9822.0,3:24,0,0,0,8967.0,3:6,6500000
8470604,Jeff,Carter,1985-01-01,C,R,2012-13,48,26,7,33,0.69,0,133,19.55,16,50625.0,17:34,202,182,384,52.6,25,23,23,31,-8,8,2,10,7689.0,2:40,0,0,0,3503.0,1:12,5272727
8470606,Dustin,Brown,1984-11-04,RW,R,2012-13,46,18,11,29,0.63,6,142,12.68,22,53824.0,19:30,15,26,41,36.59,156,8,17,27,-10,8,5,13,7790.0,2:49,0,0,0,3537.0,1:16,3175000
8470607,Brent,Seabrook,1985-04-20,D,R,2012-13,47,8,12,20,0.43,12,65,12.31,23,62037.0,21:59,0,0,0,0.0,106,103,15,40,-25,3,4,7,6614.0,2:20,0,0,0,5989.0,2:7,5800000
8470609,Steve,Bernier,1985-03-31,RW,R,2012-13,47,8,7,15,0.32,-7,88,9.09,17,38810.0,13:45,5,5,10,50.0,64,15,11,13,-2,2,2,4,5508.0,1:57,0,0,0,115.0,0:2,775000
8470610,Zach,Parise,1984-07-28,LW,L,2012-13,48,18,20,38,0.79,2,182,9.89,16,59520.0,20:40,3,6,9,33.33,59,41,24,16,8,7,6,13,9879.0,3:25,0,0,0,4189.0,1:27,7538462
8470611,Eric,Fehr,1985-09-07,C,R,2012-13,41,9,8,17,0.41,14,72,12.5,10,32893.0,13:22,0,4,4,0.0,36,22,23,9,14,2,1,3,2021.0,0:49,1,0,1,1792.0,0:43,600000
8470612,Ryan,Getzlaf,1985-05-10,C,R,2012-13,44,15,34,49,1.11,14,99,15.15,41,53311.0,20:11,355,384,739,48.04,89,42,27,31,-4,4,11,15,7330.0,2:46,3,0,3,3946.0,1:29,5325000
8470613,Brent,Burns,1985-03-09,D,R,2012-13,30,9,11,20,0.67,0,81,11.11,20,29307.0,16:16,4,9,13,30.77,54,13,5,19,-14,2,1,3,3436.0,1:54,0,0,0,34.0,0:1,5760000
8470614,Mark,Stuart,1984-04-27,D,L,2012-13,42,2,2,4,0.1,5,40,5.0,53,42093.0,16:42,0,0,0,0.0,111,81,5,16,-11,0,0,0,44.0,0:1,0,0,0,5846.0,2:19,1700000
8470616,Ryan,Kesler,1984-08-31,C,R,2012-13,17,4,9,13,0.76,-5,36,11.11,12,19330.0,18:57,174,129,303,57.43,30,13,9,12,-3,2,3,5,3358.0,3:17,0,0,0,1889.0,1:51,5000000
8470617,Mike,Richards,1985-02-11,C,L,2012-13,48,12,20,32,0.67,-8,82,14.63,42,47096.0,16:21,216,225,441,48.98,58,19,21,19,2,6,9,15,7550.0,2:37,0,0,0,3734.0,1:17,5750000
8470619,Brian,Boyle,1984-12-18,C,L,2012-13,38,2,3,5,0.13,-13,56,3.57,29,32413.0,14:12,215,166,381,56.43,145,30,12,7,5,0,1,1,1296.0,0:34,0,0,0,4298.0,1:53,1700000
8470621,Corey,Perry,1985-05-16,RW,R,2012-13,44,15,21,36,0.82,10,128,11.72,72,50344.0,19:4,6,23,29,20.69,49,18,18,21,-3,5,5,10,7445.0,2:49,0,1,1,2429.0,0:55,5325000
8470622,Patrick,Eaves,1984-05-01,RW,R,2012-13,34,2,6,8,0.24,-1,42,4.76,4,21588.0,10:34,7,4,11,63.64,40,11,7,4,3,0,1,1,551.0,0:16,0,0,0,1864.0,0:54,1200000
8470626,Loui,Eriksson,1985-07-17,LW,L,2012-13,48,12,17,29,0.6,-9,104,11.54,8,57945.0,20:7,9,25,34,26.47,6,18,29,21,8,2,8,10,9351.0,3:14,1,0,1,4699.0,1:37,4250000
8470630,Kevin,Klein,1984-12-13,D,R,2012-13,47,3,11,14,0.3,-1,54,5.56,9,57580.0,20:25,0,0,0,0.0,66,89,23,32,-9,0,0,0,463.0,0:9,0,0,0,7721.0,2:44,1350000
8470638,Patrice,Bergeron,1985-07-24,C,R,2012-13,42,10,22,32,0.76,24,125,8.0,18,48622.0,19:17,549,335,884,62.1,28,25,23,28,-5,2,2,4,5469.0,2:10,0,1,1,5577.0,2:12,5000000
8470640,Matt,Carle,1984-09-25,D,L,2012-13,48,5,17,22,0.46,1,66,7.58,4,68394.0,23:44,0,0,0,0.0,32,87,22,34,-12,2,3,5,7364.0,2:33,0,0,0,7511.0,2:36,5500000
8470642,Shea,Weber,1985-08-14,D,R,2012-13,48,9,19,28,0.58,-2,124,7.26,48,74654.0,25:55,0,0,0,0.0,112,90,14,36,-22,3,9,12,10608.0,3:41,0,0,0,5548.0,1:55,7857143
8470644,Colin,McDonald,1984-09-30,RW,R,2012-13,45,7,10,17,0.38,-1,82,8.54,32,30709.0,11:22,4,4,8,50.0,120,9,6,13,-7,1,0,1,160.0,0:3,0,0,0,534.0,0:11,700000
8470647,B.J.,Crombeen,1985-07-10,RW,R,2012-13,44,1,7,8,0.18,4,50,2.0,112,29258.0,11:4,4,16,20,20.0,44,15,11,7,4,0,0,0,44.0,0:1,0,0,0,4556.0,1:43,1000000
8470654,Maxim,Lapierre,1985-03-29,C,R,2012-13,48,4,6,10,0.21,-6,54,7.41,45,36275.0,12:35,274,268,542,50.55,116,18,14,13,1,0,0,0,253.0,0:5,0,0,0,4718.0,1:38,1000000
8470655,David,Backes,1984-05-01,RW,R,2012-13,48,6,22,28,0.58,5,100,6.0,62,56480.0,19:36,477,435,912,52.3,158,41,30,10,20,1,4,5,6417.0,2:13,0,1,1,5064.0,1:45,4500000
8470662,Colin,Fraser,1985-01-28,C,L,2012-13,34,2,5,7,0.21,-4,19,10.53,25,19116.0,9:22,78,90,168,46.43,71,11,7,1,6,0,0,0,237.0,0:6,0,0,0,1231.0,0:36,825000
8470666,Daniel,Carcillo,1985-01-28,LW,L,2012-13,23,2,1,3,0.13,1,23,8.7,11,12414.0,8:59,0,1,1,0.0,37,6,6,2,4,0,0,0,52.0,0:2,0,0,0,17.0,0:0,825000
8470667,Clarke,MacArthur,1985-04-06,LW,L,2012-13,40,8,12,20,0.5,3,62,12.9,26,35782.0,14:54,5,1,6,83.33,44,15,15,29,-14,2,2,4,3943.0,1:38,0,0,0,70.0,0:1,3250000
8470672,Ryan,O'Byrne,1984-07-19,D,R,2012-13,42,2,4,6,0.14,-4,26,7.69,60,46699.0,18:31,0,0,0,0.0,104,69,10,20,-10,0,0,0,156.0,0:3,0,0,0,6501.0,2:34,1800000
8470685,Alexander,Sulzer,1984-05-30,D,L,2012-13,17,3,1,4,0.24,3,15,20.0,10,16855.0,16:31,0,0,0,0.0,5,19,2,8,-6,0,0,0,60.0,0:3,0,0,0,1089.0,1:4,-111
8470699,Jan,Hejda,1978-06-18,D,L,2012-13,46,1,9,10,0.22,-3,50,2.0,28,54370.0,19:41,0,1,1,0.0,96,102,18,29,-11,0,0,0,160.0,0:3,0,0,0,8011.0,2:54,3250000
8470704,Jamie,Tardif,1985-01-23,RW,R,2012-13,2,0,0,0,0.0,0,1,0.0,0,591.0,4:55,0,0,0,0.0,4,2,1,0,1,0,0,0,2.0,0:1,0,0,0,0.0,0:0,-111
8470713,Paul,Bissonnette,1985-03-11,LW,L,2012-13,28,0,6,6,0.21,2,13,0.0,36,9113.0,5:25,0,0,0,0.0,36,8,1,1,0,0,0,0,2.0,0:0,0,0,0,0.0,0:0,737500
8470714,Corey,Potter,1984-01-05,D,R,2012-13,33,3,1,4,0.12,8,36,8.33,6,34559.0,17:27,0,0,0,0.0,50,36,8,20,-12,0,1,1,2182.0,1:6,0,0,0,3303.0,1:40,775000
8470719,Alexandre,Bolduc,1985-06-26,C,L,2012-13,14,0,0,0,0.0,-4,17,0.0,2,6406.0,7:37,7,14,21,33.33,21,3,2,1,1,0,0,0,29.0,0:2,0,0,0,0.0,0:0,650000
8470724,Kyle,Quincey,1985-08-12,D,L,2012-13,36,1,2,3,0.08,7,36,2.78,18,41520.0,19:13,0,0,0,0.0,29,46,6,18,-12,0,1,1,2718.0,1:15,0,0,0,4771.0,2:12,3775000
8470729,Tyson,Strachan,1984-10-30,D,R,2012-13,38,0,4,4,0.11,-13,42,0.0,40,43227.0,18:57,0,0,0,0.0,110,62,11,8,3,0,0,0,245.0,0:6,0,0,0,4313.0,1:53,600000
8470740,Lee,Stempniak,1983-02-04,RW,R,2012-13,47,9,23,32,0.68,2,113,7.96,12,50495.0,17:54,3,20,23,13.04,47,17,32,24,8,4,2,6,4769.0,1:41,0,4,4,5411.0,1:55,2500000
8470750,John,Mitchell,1985-01-22,C,L,2012-13,47,10,10,20,0.43,5,72,13.89,18,47234.0,16:44,171,173,344,49.71,99,43,28,21,7,1,2,3,5159.0,1:49,0,0,0,3342.0,1:11,1100000
8470755,Brad,Richardson,1985-02-04,C,L,2012-13,16,1,5,6,0.38,2,27,3.7,10,10463.0,10:53,27,29,56,48.21,22,3,6,3,3,0,0,0,216.0,0:13,0,0,0,331.0,0:20,1175000
8470760,Marc,Methot,1985-06-21,D,L,2012-13,47,2,9,11,0.23,2,53,3.77,31,62683.0,22:13,0,0,0,0.0,130,81,7,20,-13,0,1,1,489.0,0:10,0,0,0,8910.0,3:9,3000000
8470774,Bruno,Gervais,1984-10-03,D,R,2012-13,37,1,5,6,0.16,-17,49,2.04,10,38024.0,17:7,0,0,0,0.0,25,41,7,22,-15,0,0,0,563.0,0:15,0,0,0,2026.0,0:54,825000
8470775,Nate,Thompson,1984-10-05,C,L,2012-13,45,7,8,15,0.33,-2,58,12.07,17,38711.0,14:20,310,295,605,51.24,85,31,21,12,9,0,0,0,278.0,0:6,0,0,0,6539.0,2:25,900000
8470777,Francis,Wathier,1984-12-07,LW,L,2012-13,1,0,0,0,0.0,0,0,,0,340.0,5:40,0,2,2,0.0,5,0,1,2,-1,0,0,0,0.0,0:0,0,0,0,0.0,0:0,-111
8470778,Drew,Miller,1984-02-17,LW,L,2012-13,44,4,4,8,0.18,-8,54,7.41,2,36477.0,13:49,1,3,4,25.0,81,41,12,8,4,1,0,1,422.0,0:9,0,0,0,6136.0,2:19,837500
8470794,Joe,Pavelski,1984-07-11,C,R,2012-13,48,16,15,31,0.65,2,130,12.31,10,54460.0,18:54,342,318,660,51.82,48,44,38,28,10,5,6,11,8651.0,3:0,0,1,1,4508.0,1:33,4000000
8470798,Dylan,Reese,1984-08-29,D,R,2012-13,3,0,0,0,0.0,0,1,0.0,0,2747.0,15:15,0,0,0,0.0,0,4,1,0,1,0,0,0,184.0,1:1,0,0,0,74.0,0:24,600000
8470803,Kyle,Brodziak,1984-05-25,C,R,2012-13,48,8,4,12,0.25,-18,88,9.09,20,49982.0,17:21,377,386,763,49.41,54,18,22,22,0,1,1,2,3660.0,1:16,1,0,1,5503.0,1:54,2833333
8470804,Mathieu,Roy,1983-08-10,D,R,2012-13,1,0,0,0,0.0,-1,0,,0,847.0,14:7,0,0,0,0.0,0,0,0,0,0,0,0,0,0.0,0:0,0,0,0,0.0,0:0,-111
8470816,Jay,Rosehill,1985-07-16,LW,L,2012-13,11,1,0,1,0.09,-4,7,14.29,64,4483.0,6:47,0,0,0,0.0,18,5,1,2,-1,0,0,0,15.0,0:1,0,0,0,0.0,0:0,550000
8470828,Toby,Enstrom,1984-11-05,D,L,2012-13,22,4,11,15,0.68,-8,21,19.05,8,29732.0,22:31,0,0,0,0.0,9,38,2,8,-6,1,6,7,4848.0,3:40,0,1,1,2212.0,1:40,3750000
8470834,Dustin,Byfuglien,1985-03-27,D,R,2012-13,43,8,20,28,0.65,-1,142,5.63,34,62960.0,24:24,0,0,0,0.0,80,47,26,50,-24,4,6,10,9247.0,3:35,0,0,0,1322.0,0:30,5200000
8470839,Shane,O'Brien,1983-08-09,D,L,2012-13,28,0,4,4,0.14,0,28,0.0,60,26045.0,15:30,0,0,0,0.0,42,36,9,11,-2,0,0,0,468.0,0:16,0,0,0,268.0,0:9,2000000
8470852,Matt,Moulson,1983-11-01,LW,L,2012-13,47,15,29,44,0.94,-3,154,9.74,4,54019.0,19:9,1,0,1,100.0,24,28,20,15,5,8,7,15,9361.0,3:19,0,0,0,99.0,0:2,3133333
8470854,Tanner,Glass,1983-11-29,LW,L,2012-13,48,1,1,2,0.04,-11,38,2.63,62,29008.0,10:4,22,29,51,43.14,125,21,1,2,-1,1,0,1,43.0,0:0,0,0,0,3726.0,1:17,1100000
8470871,Chris,Porter,1984-05-29,LW,L,2012-13,29,2,6,8,0.28,5,46,4.35,0,20246.0,11:38,25,33,58,43.1,65,5,5,2,3,0,0,0,222.0,0:7,0,0,0,1558.0,0:53,650000
8470877,David,Jones,1984-08-10,RW,R,2012-13,33,3,6,9,0.27,-11,62,4.84,6,33306.0,16:49,6,15,21,28.57,45,20,9,11,-2,1,0,1,3498.0,1:46,0,0,0,3149.0,1:35,4000000
8470886,Clayton,Stoner,1985-02-19,D,L,2012-13,48,0,10,10,0.21,0,40,0.0,42,52458.0,18:12,0,0,0,0.0,87,57,12,21,-9,0,0,0,119.0,0:2,0,1,1,4438.0,1:32,1050000
8470896,Steve,MacIntyre,1980-08-08,LW,L,2012-13,1,0,0,0,0.0,0,0,,12,271.0,4:31,0,0,0,0.0,2,0,0,0,0,0,0,0,0.0,0:0,0,0,0,0.0,0:0,-111
8470920,David,Clarkson,1984-03-31,RW,R,2012-13,48,15,9,24,0.5,-6,180,8.33,78,50667.0,17:35,6,19,25,24.0,84,6,8,16,-8,6,2,8,10230.0,3:33,0,0,0,64.0,0:1,2666667
8470966,Mark,Giordano,1983-10-03,D,L,2012-13,47,4,11,15,0.32,-7,58,6.9,40,65311.0,23:9,0,0,0,0.0,65,93,34,31,3,1,2,3,6145.0,2:10,1,1,2,7688.0,2:43,4020000
8471185,Curtis,Glencross,1982-12-28,LW,L,2012-13,40,15,11,26,0.65,-8,92,16.3,18,43765.0,18:14,20,26,46,43.48,49,14,19,24,-5,3,3,6,6345.0,2:38,1,0,1,2926.0,1:13,2550000
8471208,Dustin,Penner,1982-09-28,RW,L,2012-13,33,2,12,14,0.42,-2,61,3.28,18,25142.0,12:41,2,3,5,40.0,59,7,15,16,-1,0,1,1,1768.0,0:53,0,0,0,30.0,0:0,3250000
8471214,Alex,Ovechkin,1985-09-17,LW,R,2012-13,48,32,24,56,1.17,2,220,14.55,36,60147.0,20:53,0,1,1,0.0,120,18,30,25,5,16,11,27,13230.0,4:35,0,0,0,204.0,0:4,9538462
8471215,Evgeni,Malkin,1986-07-31,C,L,2012-13,31,9,24,33,1.06,5,99,9.09,36,36647.0,19:42,195,218,413,47.22,12,11,23,21,2,4,14,18,8316.0,4:28,0,0,0,60.0,0:1,8700000
8471216,Cam,Barker,1986-04-04,D,L,2012-13,14,0,2,2,0.14,-3,19,0.0,4,11927.0,14:11,0,0,0,0.0,16,16,0,4,-4,0,0,0,295.0,0:21,0,0,0,275.0,0:19,700000
8471217,Andrew,Ladd,1985-12-12,LW,L,2012-13,48,18,28,46,0.96,10,121,14.88,22,56680.0,19:40,29,25,54,53.7,98,26,25,16,9,3,3,6,7673.0,2:39,0,0,0,4034.0,1:24,4400000
8471218,Blake,Wheeler,1986-08-31,RW,R,2012-13,48,19,22,41,0.85,-3,129,14.73,28,54145.0,18:48,4,14,18,22.22,90,39,28,20,8,2,5,7,7491.0,2:36,0,0,0,983.0,0:20,2550000
8471222,Ladislav,Smid,1986-02-01,D,L,2012-13,48,1,3,4,0.08,-1,30,3.33,55,58518.0,20:19,0,0,0,0.0,151,119,8,23,-15,0,0,0,156.0,0:3,0,1,1,9249.0,3:12,2250000
8471226,Drew,Stafford,1985-10-30,RW,R,2012-13,46,6,12,18,0.39,-16,121,4.96,21,46972.0,17:1,37,47,84,44.05,46,9,21,19,2,0,3,3,6009.0,2:10,0,0,0,3996.0,1:26,4000000
8471231,Kyle,Chipchura,1986-02-19,C,L,2012-13,46,5,9,14,0.3,1,37,13.51,50,26759.0,9:41,126,135,261,48.28,61,7,14,10,4,0,0,0,442.0,0:9,0,0,0,81.0,0:1,675000
8471232,Lauri,Korpikoski,1986-07-28,LW,L,2012-13,36,6,5,11,0.31,-3,83,7.23,12,36986.0,17:7,6,10,16,37.5,71,27,18,5,13,1,1,2,2985.0,1:22,0,0,0,4791.0,2:13,1800000
8471233,Travis,Zajac,1985-05-13,C,R,2012-13,48,7,13,20,0.42,-5,82,8.54,22,56255.0,19:31,506,375,881,57.43,33,10,29,15,14,1,3,4,8840.0,3:4,1,0,1,5074.0,1:45,3887500
8471234,Wojtek,Wolski,1986-02-24,LW,L,2012-13,27,4,5,9,0.33,1,49,8.16,6,21627.0,13:21,1,4,5,20.0,5,9,12,13,-1,0,1,1,1845.0,1:8,0,0,0,3.0,0:0,600000
8471236,Andrej,Meszaros,1985-10-13,D,L,2012-13,11,0,2,2,0.18,-9,18,0.0,2,12185.0,18:27,0,0,0,0.0,18,24,2,6,-4,0,1,1,1344.0,2:2,0,0,0,858.0,1:18,4000000
8471240,Jeff,Schultz,1986-02-25,D,L,2012-13,26,0,3,3,0.12,-6,12,0.0,12,22240.0,14:15,0,0,0,0.0,17,25,3,5,-2,0,0,0,0.0,0:0,0,0,0,2293.0,1:28,2750000
8471241,Mark,Fistric,1986-06-01,D,L,2012-13,25,0,6,6,0.24,6,9,0.0,32,23000.0,15:20,0,0,0,0.0,88,53,6,14,-8,0,0,0,91.0,0:3,0,0,0,3135.0,2:5,1475000
8471242,Mike,Green,1985-10-12,D,R,2012-13,35,12,14,26,0.74,-3,96,12.5,20,52193.0,24:51,0,0,0,0.0,36,61,14,25,-11,4,10,14,8483.0,4:2,0,0,0,2187.0,1:2,6083333
8471245,Dave,Bolland,1986-06-05,C,R,2012-13,35,7,7,14,0.4,-7,46,15.22,22,34308.0,16:20,239,279,518,46.14,43,18,21,16,5,1,2,3,5210.0,2:28,0,1,1,1854.0,0:52,3375000
8471246,Chris,Bourque,1986-01-29,LW,L,2012-13,18,1,3,4,0.22,-6,24,4.17,6,13042.0,12:4,0,1,1,0.0,25,7,6,4,2,0,3,3,2252.0,2:5,0,0,0,0.0,0:0,550000
8471254,Bryan,Bickell,1986-03-09,LW,L,2012-13,48,9,14,23,0.48,12,82,10.98,25,36880.0,12:48,2,4,6,33.33,108,13,23,11,12,0,0,0,836.0,0:17,0,0,0,0.0,0:0,541667
8471260,Blake,Comeau,1986-02-18,LW,R,2012-13,42,6,6,12,0.29,-4,48,12.5,20,30641.0,12:9,40,46,86,46.51,95,12,7,10,-3,0,0,0,146.0,0:3,1,0,1,3094.0,1:13,1250000
8471262,Carl,Soderberg,1985-10-12,C,L,2012-13,6,0,2,2,0.33,-2,6,0.0,6,5301.0,14:43,7,6,13,53.85,3,3,2,3,-1,0,0,0,888.0,2:28,0,0,0,0.0,0:0,1008333
8471266,David,Booth,1984-11-24,LW,L,2012-13,12,1,2,3,0.25,-3,27,3.7,4,9183.0,12:45,1,0,1,100.0,24,1,2,0,2,0,0,0,216.0,0:18,0,0,0,66.0,0:5,4250000
8471269,Nicklas,Grossmann,1985-01-22,D,L,2012-13,30,1,3,4,0.13,-1,21,4.76,21,32999.0,18:19,0,0,0,0.0,81,82,6,17,-11,0,0,0,96.0,0:3,0,0,0,5636.0,3:7,3500000
8471273,Brandon,Dubinsky,1986-04-29,C,L,2012-13,29,2,18,20,0.69,2,50,4.0,76,32026.0,18:24,256,183,439,58.31,64,17,13,6,7,1,6,7,4176.0,2:24,0,1,1,4345.0,2:29,4200000
8471274,Alex,Goligoski,1985-07-30,D,L,2012-13,47,3,24,27,0.57,4,80,3.75,18,63127.0,22:23,0,0,0,0.0,56,66,5,38,-33,0,11,11,8146.0,2:53,0,1,1,4063.0,1:26,4600000
8471276,David,Krejci,1986-04-28,C,R,2012-13,47,10,23,33,0.7,1,93,10.75,20,52182.0,18:30,361,293,654,55.2,41,27,20,25,-5,0,7,7,6203.0,2:11,0,0,0,897.0,0:19,5250000
8471280,Nick,Johnson,1985-12-24,RW,R,2012-13,17,4,2,6,0.35,3,23,17.39,0,10155.0,9:57,0,3,3,0.0,13,1,6,1,5,1,0,1,55.0,0:3,0,0,0,0.0,0:0,-111
8471283,Brandon,Prust,1984-03-16,LW,L,2012-13,38,5,9,14,0.37,11,39,12.82,110,31087.0,13:38,25,30,55,45.45,87,26,11,9,2,0,0,0,966.0,0:25,0,0,0,4410.0,1:56,2500000
8471284,Andrej,Sekera,1986-06-08,D,L,2012-13,37,2,10,12,0.32,-2,33,6.06,4,47082.0,21:12,0,0,0,0.0,30,73,10,19,-9,0,0,0,2350.0,1:3,0,1,1,4141.0,1:51,2750000
8471296,Alexei,Emelin,1986-04-25,D,L,2012-13,38,3,9,12,0.32,2,33,9.09,33,44840.0,19:40,0,0,0,0.0,110,47,8,32,-24,0,0,0,307.0,0:8,0,0,0,4999.0,2:11,2000000
8471299,Peter,Regin,1986-04-16,C,L,2012-13,27,0,3,3,0.11,-4,37,0.0,8,18659.0,11:31,92,118,210,43.81,12,8,10,4,6,0,0,0,578.0,0:21,0,0,0,2496.0,1:32,800000
8471303,Alexander,Edler,1986-04-21,D,L,2012-13,45,8,14,22,0.49,-5,113,7.08,37,64390.0,23:50,1,0,1,100.0,77,81,19,26,-7,5,5,10,9671.0,3:34,0,0,0,5366.0,1:59,3250000
8471309,Johan,Franzen,1979-12-23,RW,L,2012-13,41,14,17,31,0.76,13,116,12.07,41,44494.0,18:5,30,32,62,48.39,43,17,16,21,-5,6,6,12,8625.0,3:30,0,0,0,995.0,0:24,3954545
8471311,Tyler,Kennedy,1986-07-15,C,R,2012-13,46,6,5,11,0.24,-6,100,6.0,19,34393.0,12:27,13,16,29,44.83,41,9,9,9,0,1,2,3,3117.0,1:7,0,0,0,52.0,0:1,2000000
8471312,JT,Wyman,1986-02-27,RW,R,2012-13,1,0,0,0,0.0,-1,0,,0,811.0,13:31,7,4,11,63.64,0,0,0,1,-1,0,0,0,0.0,0:0,0,0,0,93.0,1:33,-111
8471314,Mike,Lundin,1984-09-24,D,L,2012-13,11,0,1,1,0.09,-2,13,0.0,0,10235.0,15:30,0,0,0,0.0,2,7,2,5,-3,0,0,0,332.0,0:30,0,0,0,594.0,0:54,1150000
8471321,Brett,Carson,1985-11-29,D,R,2012-13,10,0,1,1,0.1,-1,8,0.0,0,6557.0,10:55,0,0,0,0.0,4,12,0,3,-3,0,0,0,134.0,0:13,0,0,0,44.0,0:4,575000
8471323,Ryan,Jones,1984-06-14,LW,L,2012-13,27,2,5,7,0.26,0,38,5.26,17,21023.0,12:58,2,7,9,22.22,55,13,10,12,-2,0,0,0,538.0,0:19,0,0,0,2257.0,1:23,1500000
8471326,Patrick,Bordeleau,1986-03-23,LW,L,2012-13,46,2,3,5,0.11,-7,24,8.33,70,17173.0,6:13,0,2,2,0.0,116,3,4,2,2,0,0,0,82.0,0:1,0,0,0,35.0,0:0,525000
8471331,Kevin,Porter,1986-03-12,C,L,2012-13,31,4,5,9,0.29,-1,37,10.81,10,28325.0,15:13,109,162,271,40.22,56,18,21,9,12,0,0,0,932.0,0:30,1,1,2,2727.0,1:27,537500
8471338,Torrey,Mitchell,1985-01-30,C,R,2012-13,45,4,4,8,0.18,-8,39,10.26,21,28346.0,10:29,21,21,42,50.0,47,22,14,8,6,0,0,0,76.0,0:1,0,0,0,3453.0,1:16,1900000
8471339,Ryan,Callahan,1985-03-21,RW,R,2012-13,45,16,15,31,0.69,9,144,11.11,12,58074.0,21:30,14,16,30,46.67,154,66,23,18,5,6,2,8,8657.0,3:12,2,1,3,6918.0,2:33,4275000
8471346,Kris,Versteeg,1986-05-13,RW,R,2012-13,10,2,2,4,0.4,-8,20,10.0,8,10130.0,16:53,0,5,5,0.0,5,3,7,6,1,0,1,1,1503.0,2:30,0,0,0,253.0,0:25,4400000
8471348,Nikita,Nikitin,1986-06-16,D,L,2012-13,38,3,6,9,0.24,2,60,5.0,17,48330.0,21:11,0,0,0,0.0,31,56,11,18,-7,1,1,2,4271.0,1:52,0,0,0,5369.0,2:21,2150000
8471352,Jake,Dowell,1985-03-04,C,L,2012-13,2,0,0,0,0.0,0,3,0.0,0,1025.0,8:32,2,1,3,66.67,2,0,0,1,-1,0,0,0,0.0,0:0,0,0,0,46.0,0:23,-111
8471362,Mikhail,Grabovski,1984-01-31,C,L,2012-13,48,9,7,16,0.33,-10,80,11.25,24,44842.0,15:34,323,315,638,50.63,34,20,19,32,-13,0,3,3,4909.0,1:42,0,0,0,79.0,0:1,5500000
8471371,Mike,Brown,1985-06-24,RW,R,2012-13,39,1,1,2,0.05,-7,18,5.56,123,17597.0,7:31,5,3,8,62.5,87,13,6,7,-1,0,0,0,122.0,0:3,0,0,0,236.0,0:6,736667
8471385,Adam,Pardy,1984-03-29,D,L,2012-13,17,0,4,4,0.24,4,6,0.0,14,16837.0,16:30,0,0,0,0.0,24,16,3,13,-10,0,0,0,51.0,0:3,0,0,0,1201.0,1:10,2000000
8471388,Patrick,Kaleta,1986-06-08,RW,R,2012-13,34,1,0,1,0.03,-4,34,2.94,67,22016.0,10:47,5,6,11,45.45,86,34,2,9,-7,0,0,0,154.0,0:4,0,0,0,4382.0,2:8,1250000
8471390,Mike,Santorelli,1985-12-14,C,R,2012-13,34,2,2,4,0.12,-12,35,5.71,2,24206.0,11:51,56,38,94,59.57,12,3,6,3,3,0,0,0,512.0,0:15,0,0,0,42.0,0:1,1600000
8471392,Roman,Polak,1986-04-28,D,R,2012-13,48,1,5,6,0.12,-2,39,2.56,48,53051.0,18:25,0,0,0,0.0,110,78,8,8,0,0,0,0,114.0,0:2,0,0,0,5677.0,1:58,2750000
8471402,Lennart,Petrell,1984-04-13,LW,L,2012-13,35,3,6,9,0.26,-4,23,13.04,4,24215.0,11:31,3,10,13,23.08,63,22,5,8,-3,0,0,0,120.0,0:3,1,1,2,5443.0,2:35,-111
8471409,Andrew,Gordon,1985-12-13,RW,R,2012-13,6,0,0,0,0.0,-1,2,0.0,0,3032.0,8:25,2,3,5,40.0,4,1,1,2,-1,0,0,0,0.0,0:0,0,0,0,0.0,0:0,537500
8471426,Troy,Brouwer,1985-08-17,RW,R,2012-13,47,19,14,33,0.7,-5,111,17.12,28,52276.0,18:32,111,121,232,47.84,108,23,24,22,2,7,9,16,9531.0,3:22,1,0,1,4292.0,1:31,2350000
8471436,Matt,Hunwick,1985-05-21,D,L,2012-13,43,0,6,6,0.14,4,57,0.0,16,55523.0,21:31,0,0,0,0.0,40,59,30,22,8,0,0,0,2881.0,1:7,0,0,0,6720.0,2:36,1600000
8471450,Brandon,Yip,1985-04-25,RW,R,2012-13,34,3,5,8,0.24,-3,35,8.57,26,24562.0,12:2,8,13,21,38.1,46,7,6,12,-6,0,0,0,237.0,0:6,0,0,0,1023.0,0:30,-111
8471451,Aaron,Gagnon,1986-04-24,C,R,2012-13,10,3,0,3,0.3,2,11,27.27,2,4892.0,8:9,30,27,57,52.63,7,4,4,2,2,0,0,0,111.0,0:11,0,0,0,346.0,0:34,-111
8471476,Daniel,Winnik,1985-03-06,LW,L,2012-13,48,6,13,19,0.4,13,95,6.32,16,48461.0,16:49,16,37,53,30.19,63,37,24,10,14,0,0,0,503.0,0:10,0,0,0,7341.0,2:32,1800000
8471482,Grant,Clitsome,1985-04-14,D,L,2012-13,44,4,12,16,0.36,10,56,7.14,18,49726.0,18:50,0,0,0,0.0,82,54,8,27,-19,2,1,3,2751.0,1:2,0,0,0,3856.0,1:27,1250000
8471490,Adam,Cracknell,1985-07-15,RW,R,2012-13,20,2,4,6,0.3,3,21,9.52,4,10337.0,8:36,6,19,25,24.0,22,7,6,1,5,0,0,0,10.0,0:0,0,0,0,14.0,0:0,550000
8471498,Jannik,Hansen,1986-03-15,RW,R,2012-13,47,10,17,27,0.57,12,99,10.1,8,49504.0,17:33,3,28,31,9.68,55,10,21,17,4,1,2,3,4713.0,1:40,0,0,0,6121.0,2:10,1350000
8471504,Rene,Bourque,1981-12-10,RW,L,2012-13,27,7,6,13,0.48,-1,63,11.11,32,26455.0,16:19,0,1,1,0.0,37,11,8,6,2,2,1,3,4420.0,2:43,0,0,0,808.0,0:29,3333333
8471514,Rich,Peverley,1982-07-08,C,R,2012-13,47,6,12,18,0.38,-9,95,6.32,16,43027.0,15:15,211,150,361,58.45,23,21,23,24,-1,2,4,6,4781.0,1:41,0,2,2,5364.0,1:54,3250000
8471521,Brad,Staubitz,1984-07-28,RW,R,2012-13,15,1,1,2,0.13,0,5,20.0,41,5593.0,6:12,0,0,0,0.0,31,7,0,3,-3,0,0,0,13.0,0:0,0,0,0,0.0,0:0,637500
8471636,Tim,Sestito,1984-08-28,LW,L,2012-13,6,0,0,0,0.0,1,4,0.0,2,2834.0,7:52,14,12,26,53.85,10,2,0,1,-1,0,0,0,5.0,0:0,0,0,0,0.0,0:0,525000
8471657,Cody,McLeod,1984-06-26,LW,L,2012-13,48,8,4,12,0.25,4,79,10.13,83,37695.0,13:5,7,10,17,41.18,106,17,9,2,7,0,1,1,1412.0,0:29,0,0,0,4327.0,1:30,1150000
8471663,Mike,Blunden,1986-12-15,RW,R,2012-13,5,0,0,0,0.0,-1,5,0.0,4,2504.0,8:20,0,0,0,0.0,2,3,0,1,-1,0,0,0,0.0,0:0,0,0,0,17.0,0:3,575000
8471664,Mason,Raymond,1985-09-17,LW,L,2012-13,46,10,12,22,0.48,2,79,12.66,16,43676.0,15:49,17,33,50,34.0,18,8,17,18,-1,4,2,6,5885.0,2:7,0,0,0,2992.0,1:5,2275000
8471669,Paul,Stastny,1985-12-27,C,L,2012-13,40,9,15,24,0.6,-7,87,10.34,14,46456.0,19:21,409,372,781,52.37,21,29,23,15,8,2,8,10,6487.0,2:42,0,0,0,5044.0,2:6,6600000
8471670,Guillaume,Latendresse,1987-05-24,LW,L,2012-13,27,6,4,10,0.37,-2,53,11.32,8,23977.0,14:48,0,4,4,0.0,42,8,14,7,7,1,0,1,3342.0,2:3,0,0,0,0.0,0:0,1250000
8471675,Sidney,Crosby,1987-08-07,C,L,2012-13,36,15,41,56,1.56,26,124,12.1,16,45585.0,21:6,453,381,834,54.32,21,18,15,28,-13,3,14,17,9425.0,4:21,0,0,0,1501.0,0:41,8700000
8471676,Bobby,Ryan,1987-03-17,RW,R,2012-13,46,11,19,30,0.65,3,101,10.89,17,45775.0,16:35,25,56,81,30.86,80,29,24,23,1,2,4,6,5388.0,1:57,0,0,0,139.0,0:3,5100000
8471677,Jack,Johnson,1987-01-13,D,L,2012-13,44,5,14,19,0.43,-5,96,5.21,12,68571.0,25:58,0,0,0,0.0,66,90,9,20,-11,3,5,8,9567.0,3:37,0,0,0,7351.0,2:47,4357143
8471678,Benoit,Pouliot,1986-09-29,LW,L,2012-13,34,8,12,20,0.59,8,60,13.33,15,27002.0,13:14,10,21,31,32.26,35,6,18,16,2,0,3,3,3636.0,1:46,0,0,0,53.0,0:1,1800000
8471681,Jack,Skille,1987-05-19,RW,R,2012-13,40,3,9,12,0.3,-9,69,4.35,11,31977.0,13:19,8,8,16,50.0,96,15,12,3,9,0,0,0,584.0,0:14,0,0,0,2629.0,1:5,825000
8471682,Devin,Setoguchi,1987-01-01,RW,R,2012-13,48,13,14,27,0.56,5,97,13.4,20,41583.0,14:26,7,10,17,41.18,92,19,18,18,0,5,1,6,5692.0,1:58,0,0,0,14.0,0:0,3000000
8471683,Brian,Lee,1987-03-26,D,R,2012-13,22,0,0,0,0.0,-13,13,0.0,16,18376.0,13:55,0,0,0,0.0,49,28,1,8,-7,0,0,0,19.0,0:0,0,0,0,415.0,0:18,1150000
8471685,Anze,Kopitar,1987-08-24,C,L,2012-13,47,10,32,42,0.89,14,98,10.2,16,57751.0,20:28,473,415,888,53.27,70,25,27,35,-8,0,16,16,7823.0,2:46,0,0,0,4209.0,1:29,6800000
8471686,Marc,Staal,1987-01-13,D,L,2012-13,21,2,9,11,0.52,4,20,10.0,14,30807.0,24:27,0,0,0,0.0,47,36,4,12,-8,1,2,3,1316.0,1:2,0,0,0,3950.0,3:8,3975000
8471691,Martin,Hanzal,1987-02-20,C,L,2012-13,39,11,12,23,0.59,2,93,11.83,24,43385.0,18:32,298,339,637,46.78,100,17,24,17,7,4,3,7,6907.0,2:57,0,1,1,1810.0,0:46,3100000
8471693,Jakub,Kindl,1987-02-10,D,L,2012-13,41,4,9,13,0.32,15,76,5.26,28,45648.0,18:33,0,0,0,0.0,46,33,8,30,-22,1,2,3,6434.0,2:36,0,0,0,655.0,0:15,883333
8471698,T.J.,Oshie,1986-12-23,RW,R,2012-13,30,7,13,20,0.67,-5,65,10.77,15,34368.0,19:5,5,8,13,38.46,33,24,18,12,6,2,8,10,4488.0,2:29,1,1,2,2948.0,1:38,4175000
8471699,Andrew,Cogliano,1987-06-14,LW,L,2012-13,48,13,10,23,0.48,14,79,16.46,6,44261.0,15:22,32,60,92,34.78,40,24,13,15,-2,0,0,0,432.0,0:9,2,0,2,4594.0,1:35,2390000
8471700,Matt,Pelech,1987-09-04,RW,R,2012-13,2,0,0,0,0.0,0,0,,7,1086.0,9:3,0,0,0,0.0,6,0,0,0,0,0,0,0,0.0,0:0,0,0,0,7.0,0:3,577500
8471701,Joe,Finley,1987-06-29,D,L,2012-13,16,0,1,1,0.06,-5,2,0.0,20,11479.0,11:57,0,1,1,0.0,24,15,3,6,-3,0,0,0,6.0,0:0,0,0,0,230.0,0:14,533333
8471702,Matt,Niskanen,1986-12-06,D,R,2012-13,40,4,10,14,0.35,4,67,5.97,12,48858.0,20:21,0,0,0,0.0,49,47,15,17,-2,0,2,2,4825.0,2:0,0,0,0,2700.0,1:7,2300000
8471703,Steve,Downie,1987-04-03,RW,R,2012-13,2,0,1,1,0.5,1,2,0.0,6,1067.0,8:53,1,0,1,100.0,5,1,0,1,-1,0,0,0,143.0,1:11,0,0,0,0.0,0:0,2650000
8471705,Brendan,Mikkelson,1987-06-22,D,L,2012-13,4,0,1,1,0.25,1,0,,6,2342.0,9:45,0,0,0,0.0,3,5,1,2,-1,0,0,0,45.0,0:11,0,0,0,0.0,0:0,600000
8471707,James,Neal,1987-09-03,LW,L,2012-13,40,21,15,36,0.9,5,136,15.44,26,41925.0,17:28,1,5,6,16.67,56,17,11,7,4,9,7,16,9591.0,3:59,0,0,0,31.0,0:0,5000000
8471709,Marc-Edouard,Vlasic,1987-03-30,D,L,2012-13,48,3,4,7,0.15,5,59,5.08,29,59975.0,20:49,0,0,0,0.0,27,81,10,34,-24,0,0,0,1524.0,0:31,0,0,0,6205.0,2:9,3100000
8471716,Justin,Abdelkader,1987-02-25,LW,L,2012-13,48,10,3,13,0.27,6,96,10.42,34,42657.0,14:48,65,60,125,52.0,120,13,10,10,0,0,0,0,1885.0,0:39,0,0,0,1471.0,0:30,1800000
8471717,Adam,McQuaid,1986-10-12,D,R,2012-13,32,1,3,4,0.12,0,26,3.85,60,27441.0,14:17,0,0,0,0.0,62,43,3,8,-5,0,0,0,6.0,0:0,0,1,1,1196.0,0:37,1566667
8471719,Matt,Kassian,1986-10-28,LW,L,2012-13,15,1,0,1,0.07,0,6,16.67,47,5743.0,6:22,0,0,0,0.0,38,4,1,3,-2,0,0,0,0.0,0:0,0,0,0,0.0,0:0,575000
8471724,Kris,Letang,1987-04-24,D,R,2012-13,35,5,33,38,1.09,16,95,5.26,8,53836.0,25:38,0,0,0,0.0,45,59,12,34,-22,1,12,13,9714.0,4:37,0,0,0,4631.0,2:12,3500000
8471729,Kris,Russell,1987-05-02,D,L,2012-13,33,1,6,7,0.21,6,41,2.44,9,31776.0,16:2,0,0,0,0.0,26,57,10,8,2,1,1,2,1188.0,0:36,0,0,0,1150.0,0:34,1300000
8471733,Rich,Clune,1987-04-25,LW,L,2012-13,47,4,5,9,0.19,3,46,8.7,113,26524.0,9:24,0,2,2,0.0,159,6,4,6,-2,0,0,0,240.0,0:5,0,0,0,99.0,0:2,537500
8471735,Keith,Yandle,1986-09-09,D,L,2012-13,48,10,20,30,0.62,4,130,7.69,54,64072.0,22:14,0,0,0,0.0,18,40,20,30,-10,5,5,10,10112.0,3:30,0,0,0,238.0,0:4,5250000
8471742,Cody,Franson,1987-08-08,D,R,2012-13,45,4,25,29,0.64,4,70,5.71,8,50729.0,18:47,0,0,0,0.0,124,59,21,40,-19,3,10,13,7619.0,2:49,0,0,0,2439.0,0:54,1200000
8471743,Vladimir,Sobotka,1987-07-02,LW,L,2012-13,48,8,11,19,0.4,-4,69,11.59,35,44514.0,15:27,286,220,506,56.52,98,16,15,4,11,1,3,4,2161.0,0:45,0,0,0,5736.0,1:59,1300000
8471748,Mark,Fraser,1986-09-29,D,L,2012-13,45,0,8,8,0.18,18,33,0.0,85,45785.0,16:57,0,0,0,0.0,153,102,13,26,-13,0,0,0,117.0,0:2,0,0,0,5446.0,2:1,600000
8471752,Marc-Andre,Gragnani,1987-03-11,D,L,2012-13,1,0,0,0,0.0,0,0,,0,473.0,7:53,0,0,0,0.0,0,0,0,1,-1,0,0,0,0.0,0:0,0,0,0,0.0,0:0,800000
8471761,Chris,Butler,1986-10-27,D,L,2012-13,44,1,7,8,0.18,-10,40,2.5,19,44981.0,17:2,0,0,0,0.0,53,74,8,21,-13,0,0,0,135.0,0:3,1,0,1,5060.0,1:55,1250000
8471762,Chris,VandeVelde,1987-03-15,C,L,2012-13,11,0,0,0,0.0,-3,7,0.0,4,4652.0,7:2,21,23,44,47.73,12,3,2,2,0,0,0,0,0.0,0:0,0,0,0,660.0,1:0,714000
8471766,Jared,Boll,1986-05-13,RW,R,2012-13,43,2,4,6,0.14,1,19,10.53,100,20853.0,8:4,4,5,9,44.44,80,7,1,6,-5,0,0,0,134.0,0:3,0,0,0,0.0,0:0,1050000
8471767,Blair,Jones,1986-09-27,C,R,2012-13,15,0,1,1,0.07,-6,22,0.0,10,9668.0,10:44,58,51,109,53.21,22,9,4,0,4,0,0,0,13.0,0:0,0,0,0,583.0,0:38,650000
8471768,Tom,Pyatt,1987-02-14,LW,L,2012-13,43,8,8,16,0.37,5,60,13.33,12,35041.0,13:34,145,145,290,50.0,22,36,16,5,11,0,0,0,523.0,0:12,0,0,0,4744.0,1:50,600000
8471769,Niklas,Hjalmarsson,1987-06-06,D,L,2012-13,46,2,8,10,0.22,15,43,4.65,22,57705.0,20:54,0,0,0,0.0,26,94,29,40,-11,0,0,0,260.0,0:5,0,0,0,7469.0,2:42,3500000
8471794,Darren,Helm,1987-01-21,LW,L,2012-13,1,0,0,0,0.0,0,1,0.0,2,747.0,12:27,6,8,14,42.86,4,0,1,1,0,0,0,0,0.0,0:0,0,0,0,330.0,5:30,2125000
8471804,Nathan,Gerbe,1987-07-24,C,L,2012-13,42,5,5,10,0.24,-3,64,7.81,14,31510.0,12:30,0,1,1,0.0,32,8,12,17,-5,0,0,0,2300.0,0:54,1,0,1,333.0,0:7,1450000
8471807,Tom,Wandell,1987-01-29,C,L,2012-13,18,1,0,1,0.06,0,14,7.14,4,9117.0,8:26,46,65,111,41.44,15,9,8,6,2,0,0,0,104.0,0:5,0,0,0,366.0,0:20,892500
8471810,Derek,Joslin,1987-03-17,D,L,2012-13,2,0,0,0,0.0,-2,2,0.0,0,2039.0,16:59,0,0,0,0.0,4,4,0,1,-1,0,0,0,0.0,0:0,0,0,0,136.0,1:8,700000
8471816,Mark,Fayne,1987-05-15,D,R,2012-13,31,1,5,6,0.19,6,34,2.94,16,33662.0,18:5,0,0,0,0.0,25,40,6,10,-4,0,0,0,241.0,0:7,1,0,1,4583.0,2:27,1300000
8471817,Ryan,Reaves,1987-01-20,RW,R,2012-13,43,4,2,6,0.14,3,24,16.67,79,19216.0,7:26,3,0,3,100.0,135,7,9,5,4,0,0,0,70.0,0:1,0,0,0,0.0,0:0,600000
8471832,Nick,Drazenovic,1987-01-14,C,L,2012-13,8,0,0,0,0.0,-2,5,0.0,4,4765.0,9:55,29,25,54,53.7,8,1,3,1,2,0,0,0,32.0,0:4,0,0,0,459.0,0:57,600000
8471840,Brett,Sutter,1987-06-02,LW,L,2012-13,3,0,0,0,0.0,-1,2,0.0,4,1502.0,8:20,8,6,14,57.14,7,0,1,0,1,0,0,0,19.0,0:6,0,0,0,0.0,0:0,550000
8471842,Tim,Kennedy,1986-04-30,LW,L,2012-13,13,2,0,2,0.15,-3,24,8.33,2,10601.0,13:35,3,7,10,30.0,22,4,9,6,3,0,0,0,851.0,1:5,0,0,0,21.0,0:1,675000
8471851,Matt,D'Agostini,1986-10-23,RW,R,2012-13,29,3,3,6,0.21,-5,33,9.09,8,21428.0,12:18,5,13,18,27.78,21,12,6,6,0,0,1,1,1890.0,1:5,0,0,0,0.0,0:0,1650000
8471853,Nicolas,Blanchard,1987-05-31,LW,L,2012-13,9,0,0,0,0.0,-2,6,0.0,20,4685.0,8:40,1,0,1,100.0,22,2,1,0,1,0,0,0,9.0,0:1,0,0,0,124.0,0:13,-111
8471856,Joe,Vitale,1985-08-20,C,R,2012-13,33,2,3,5,0.15,-7,26,7.69,17,18843.0,9:31,157,100,257,61.09,45,19,8,1,7,0,0,0,77.0,0:2,0,0,0,260.0,0:7,550000
8471859,Sergei,Kostitsyn,1987-03-20,LW,L,2012-13,46,3,12,15,0.33,-5,42,7.14,11,46146.0,16:43,3,1,4,75.0,27,25,15,20,-5,1,2,3,4768.0,1:43,0,0,0,3409.0,1:14,3000000
8471862,Colin,Greening,1986-03-09,C,L,2012-13,47,8,11,19,0.4,5,80,10.0,11,41538.0,14:43,22,25,47,46.81,122,24,19,18,1,2,2,4,2818.0,0:59,0,0,0,2141.0,0:45,816666
8471873,Anton,Stralman,1986-08-01,D,R,2012-13,48,4,3,7,0.15,14,66,6.06,16,51978.0,18:2,0,1,1,0.0,75,42,8,19,-11,0,0,0,3095.0,1:4,0,0,0,2753.0,0:57,1700000
8471887,Patric,Hornqvist,1987-01-01,RW,R,2012-13,24,4,10,14,0.58,-1,87,4.6,14,23364.0,16:13,1,1,2,50.0,29,9,7,6,1,4,3,7,4044.0,2:48,0,0,0,0.0,0:0,3083333
8471912,Kevin,Henderson,1986-12-03,LW,L,2012-13,4,1,0,1,0.25,-1,3,33.33,0,3526.0,14:41,0,0,0,0.0,3,1,1,1,0,0,0,0,86.0,0:21,0,0,0,97.0,0:24,550000
8471916,Mike,Angelidis,1985-06-27,LW,L,2012-13,1,0,0,0,0.0,0,0,,0,442.0,7:22,3,4,7,42.86,0,0,0,0,0,0,0,0,0.0,0:0,0,0,0,26.0,0:26,525000
8471956,Andrew,Desjardins,1986-07-27,LW,L,2012-13,42,2,1,3,0.07,-6,51,3.92,61,25512.0,10:7,39,33,72,54.17,53,27,5,11,-6,0,0,0,57.0,0:1,0,0,0,2902.0,1:9,640000
8471958,Dan,Girardi,1984-04-29,D,R,2012-13,46,2,12,14,0.3,-1,81,2.47,16,70145.0,25:24,0,0,0,0.0,102,125,15,32,-17,0,2,2,5917.0,2:8,0,0,0,8394.0,3:2,3325000
8471976,David,Desharnais,1986-09-14,C,L,2012-13,48,10,18,28,0.58,-2,66,15.15,26,47423.0,16:27,382,382,764,50.0,26,18,23,15,8,2,5,7,8328.0,2:53,0,0,0,344.0,0:7,850000
8471996,Bracken,Kearns,1981-05-12,C,L,2012-13,1,0,0,0,0.0,0,0,,0,724.0,12:4,0,0,0,0.0,3,0,0,0,0,0,0,0,0.0,0:0,0,0,0,72.0,1:12,550000
8472368,Chris,Conner,1983-12-23,RW,L,2012-13,12,1,1,2,0.17,3,15,6.67,2,8190.0,11:22,0,2,2,0.0,15,5,7,0,7,0,0,0,163.0,0:13,0,0,0,0.0,0:0,650000
8472370,Jordan,Hendry,1984-02-23,D,L,2012-13,2,0,0,0,0.0,0,0,,0,2109.0,17:34,0,0,0,0.0,1,2,1,1,0,0,0,0,0.0,0:0,0,0,0,0.0,0:0,-111
8472382,Andy,Greene,1982-10-30,D,L,2012-13,48,4,12,16,0.33,12,63,6.35,20,66358.0,23:2,0,0,0,0.0,47,70,32,18,14,2,4,6,5575.0,1:56,1,0,1,7201.0,2:30,3000000
8472394,Peter,Harrold,1983-06-08,D,R,2012-13,23,2,3,5,0.22,-8,36,5.56,6,24332.0,17:37,0,0,0,0.0,21,10,5,7,-2,1,2,3,2252.0,1:37,0,0,0,797.0,0:34,525000
8472410,Stephen,Gionta,1983-10-09,RW,R,2012-13,48,4,10,14,0.29,2,58,6.9,14,37513.0,13:1,137,253,390,35.13,87,14,21,6,15,0,0,0,361.0,0:7,0,1,1,4789.0,1:39,562500
8472424,Ryan,Hamilton,1985-04-15,LW,L,2012-13,10,0,2,2,0.2,1,6,0.0,0,6512.0,10:51,4,14,18,22.22,22,7,1,1,0,0,0,0,82.0,0:8,0,0,0,755.0,1:15,600000
8473412,Bryan,Little,1987-11-12,C,R,2012-13,48,7,25,32,0.67,8,84,8.33,4,57021.0,19:47,431,411,842,51.19,32,19,29,11,18,2,3,5,7336.0,2:32,0,1,1,4453.0,1:32,2383333
8473416,Michael,Caruso,1988-07-05,D,L,2012-13,2,0,0,0,0.0,-1,0,,0,950.0,7:55,0,0,0,0.0,0,2,0,1,-1,0,0,0,0.0,0:0,0,0,0,240.0,2:0,-111
8473419,Brad,Marchand,1988-05-11,LW,L,2012-13,45,18,18,36,0.8,23,91,19.78,27,45804.0,16:57,6,6,12,50.0,38,20,28,32,-4,4,0,4,4700.0,1:44,2,0,2,3427.0,1:16,2500000
8473422,Nick,Foligno,1987-10-31,LW,L,2012-13,45,6,13,19,0.42,6,69,8.7,28,44616.0,16:31,3,6,9,33.33,99,33,17,8,9,1,2,3,5352.0,1:58,0,0,0,236.0,0:5,3083333
8473426,Mike,Weber,1987-12-16,D,L,2012-13,42,1,6,7,0.17,3,25,4.0,70,46276.0,18:21,0,0,0,0.0,122,92,5,25,-20,0,0,0,207.0,0:4,0,1,1,7035.0,2:47,950000
8473432,Derek,Dorsett,1986-12-20,RW,R,2012-13,24,3,6,9,0.38,-11,38,7.89,53,23025.0,15:59,13,10,23,56.52,55,10,5,1,4,0,0,0,497.0,0:20,0,0,0,2656.0,1:50,1633333
8473446,Erik,Johnson,1988-03-21,D,R,2012-13,31,0,4,4,0.13,-3,64,0.0,18,38602.0,20:45,0,0,0,0.0,44,58,19,26,-7,0,0,0,3508.0,1:53,0,0,0,4431.0,2:22,3750000
8473449,Kyle,Okposo,1988-04-16,RW,R,2012-13,48,4,20,24,0.5,-2,101,3.96,38,48833.0,16:57,104,82,186,55.91,48,21,35,35,0,0,3,3,4452.0,1:32,0,0,0,299.0,0:6,2800000
8473453,Trevor,Lewis,1987-01-08,C,R,2012-13,48,5,9,14,0.29,5,92,5.43,19,43785.0,15:12,31,33,64,48.44,83,31,11,9,2,0,0,0,2304.0,0:48,1,1,2,5292.0,1:50,725000
8473463,Leo,Komarov,1987-01-23,C,L,2012-13,42,4,5,9,0.21,-1,51,7.84,18,35118.0,13:56,29,28,57,50.88,176,24,16,15,1,0,0,0,422.0,0:10,0,0,0,4560.0,1:48,850000
8473465,Jamie,McGinn,1988-08-05,LW,L,2012-13,47,11,11,22,0.47,-13,128,8.59,26,48743.0,17:17,3,3,6,50.0,82,16,20,14,6,3,4,7,6550.0,2:19,0,0,0,2116.0,0:45,1750000
8473466,Ryan,White,1988-03-17,C,R,2012-13,26,1,0,1,0.04,1,16,6.25,67,14683.0,9:24,91,76,167,54.49,50,15,7,6,1,0,0,0,125.0,0:4,0,0,0,1540.0,0:59,687500
8473468,Eric,Gryba,1988-04-14,D,R,2012-13,33,2,4,6,0.18,-3,51,3.92,26,40149.0,20:16,0,0,0,0.0,89,37,10,32,-22,0,0,0,253.0,0:7,0,0,0,4657.0,2:21,562500
8473473,Milan,Lucic,1988-06-07,LW,L,2012-13,46,7,20,27,0.59,8,79,8.86,75,46677.0,16:54,17,18,35,48.57,139,16,20,37,-17,0,2,2,5461.0,1:58,0,0,0,91.0,0:1,4083333
8473482,Jiri,Tlusty,1988-03-16,LW,L,2012-13,48,23,15,38,0.79,15,117,19.66,18,52547.0,18:14,3,15,18,16.67,53,41,22,21,1,4,4,8,7583.0,2:37,0,0,0,2800.0,0:58,1600000
8473484,Kaspars,Daugavins,1988-05-18,LW,L,2012-13,25,1,3,4,0.16,-8,36,2.78,9,16522.0,11:0,9,9,18,50.0,23,10,13,10,3,0,1,1,112.0,0:4,0,0,0,2532.0,1:41,635000
8473485,Chris,Stewart,1987-10-30,RW,R,2012-13,48,18,18,36,0.75,0,97,18.56,40,45558.0,15:49,8,19,27,29.63,41,13,13,11,2,6,6,12,6698.0,2:19,0,0,0,42.0,0:0,3000000
8473492,Matt,Beleskey,1988-06-07,LW,L,2012-13,42,8,5,13,0.31,2,61,13.11,56,30281.0,12:0,6,13,19,31.58,103,16,8,11,-3,2,0,2,2081.0,0:49,0,0,0,192.0,0:4,737500
8473504,Cal,Clutterbuck,1987-11-18,RW,R,2012-13,42,4,6,10,0.24,-5,87,4.6,27,34611.0,13:44,1,1,2,50.0,155,17,13,10,3,0,0,0,130.0,0:3,0,1,1,4098.0,1:37,1400000
8473507,Jeff,Petry,1987-12-09,D,R,2012-13,48,3,9,12,0.25,1,66,4.55,29,63098.0,21:54,0,1,1,0.0,112,86,32,46,-14,0,0,0,1716.0,0:35,1,0,1,9661.0,3:21,1750000
8473512,Claude,Giroux,1988-01-12,C,R,2012-13,48,13,35,48,1.0,-7,137,9.49,22,60974.0,21:10,644,538,1182,54.48,57,29,17,30,-13,6,15,21,10605.0,3:40,1,0,1,4914.0,1:42,3750000
8473514,Jesse,Joensuu,1987-10-05,LW,L,2012-13,7,0,2,2,0.29,2,15,0.0,6,4258.0,10:8,0,0,0,0.0,12,0,5,3,2,0,0,0,7.0,0:1,0,0,0,0.0,0:0,600000
8473525,Theo,Peckham,1987-11-10,D,L,2012-13,4,0,0,0,0.0,-1,2,0.0,6,4233.0,17:38,0,0,0,0.0,14,5,1,2,-1,0,0,0,34.0,0:8,0,0,0,403.0,1:40,-111
8473526,Peter,Mueller,1988-04-14,C,R,2012-13,43,8,9,17,0.4,-11,131,6.11,18,41956.0,16:15,46,58,104,44.23,29,10,33,11,22,2,2,4,6069.0,2:21,0,0,0,107.0,0:2,1725000
8473533,Jordan,Staal,1988-09-10,C,L,2012-13,48,10,21,31,0.65,-18,114,8.77,32,57903.0,20:6,458,456,914,50.11,105,20,31,20,11,1,6,7,6636.0,2:18,0,1,1,6289.0,2:11,4000000
8473534,Patrik,Berglund,1988-06-02,C,L,2012-13,48,17,8,25,0.52,-2,74,22.97,12,48466.0,16:49,279,324,603,46.27,53,24,10,9,1,5,1,6,6755.0,2:20,2,0,2,3903.0,1:21,2250000
8473536,James,Sheppard,1988-04-25,C,L,2012-13,32,1,3,4,0.12,-9,40,2.5,12,22559.0,11:44,2,4,6,33.33,63,17,16,11,5,0,0,0,785.0,0:24,0,0,0,16.0,0:0,825000
8473537,Viktor,Stalberg,1986-01-17,LW,L,2012-13,47,9,14,23,0.49,16,113,7.96,25,39822.0,14:7,0,1,1,0.0,43,14,22,11,11,0,2,2,6186.0,2:11,0,0,0,142.0,0:3,875000
8473542,Tom,Sestito,1987-09-28,LW,L,2012-13,30,3,0,3,0.1,-2,14,21.43,65,11572.0,6:25,1,1,2,50.0,39,2,5,3,2,0,0,0,0.0,0:0,0,0,0,0.0,0:0,605000
8473544,Derick,Brassard,1987-09-22,C,L,2012-13,47,12,17,29,0.62,1,88,13.64,16,46687.0,16:33,215,231,446,48.21,83,8,19,17,2,3,8,11,7885.0,2:47,0,0,0,230.0,0:4,3200000
8473546,Michael,Grabner,1987-10-05,RW,L,2012-13,45,16,5,21,0.47,4,108,14.81,12,39943.0,14:47,10,12,22,45.45,16,19,30,19,11,2,1,3,1391.0,0:30,1,0,1,6275.0,2:19,3000000
8473548,Phil,Kessel,1987-10-02,RW,R,2012-13,48,20,32,52,1.08,-3,161,12.42,18,57053.0,19:48,5,3,8,62.5,16,23,25,45,-20,6,15,21,9551.0,3:18,0,0,0,86.0,0:1,5400000
8473558,Cory,Emmerton,1988-06-01,C,L,2012-13,48,5,3,8,0.17,-1,55,9.09,4,31137.0,10:48,187,226,413,45.28,28,26,10,2,8,0,1,1,161.0,0:3,0,0,0,5015.0,1:44,533333
8473560,Korbinian,Holzer,1988-02-16,D,R,2012-13,22,2,1,3,0.14,-12,16,12.5,28,24429.0,18:30,0,0,0,0.0,61,54,3,15,-12,0,0,0,170.0,0:7,0,0,0,3396.0,2:34,575000
8473563,Nicklas,Backstrom,1987-11-23,C,L,2012-13,48,8,40,48,1.0,8,82,9.76,20,57314.0,19:54,432,408,840,51.43,31,35,33,26,7,3,15,18,10275.0,3:34,0,0,0,4399.0,1:31,6700000
8473564,Michael,Frolik,1988-02-17,RW,L,2012-13,45,3,7,10,0.22,5,98,3.06,8,33798.0,12:31,15,25,40,37.5,32,23,42,6,36,0,0,0,547.0,0:12,0,0,0,6497.0,2:24,2333333
8473565,Brian,Strait,1988-01-04,D,L,2012-13,19,0,4,4,0.21,4,13,0.0,10,19556.0,17:9,0,0,0,0.0,33,21,2,6,-4,0,0,0,72.0,0:3,0,0,0,1807.0,1:35,605000
8473568,Andreas,Nodl,1987-02-28,RW,L,2012-13,8,0,1,1,0.12,-1,6,0.0,2,4065.0,8:28,1,2,3,33.33,13,3,3,0,3,0,0,0,9.0,0:1,0,0,0,93.0,0:11,-111
8473569,Jan,Mursak,1988-01-20,LW,R,2012-13,2,0,0,0,0.0,0,0,,4,677.0,5:38,1,1,2,50.0,0,0,0,1,-1,0,0,0,8.0,0:4,0,0,0,0.0,0:0,-111
8473571,Jamie,McBain,1988-02-25,D,R,2012-13,40,1,7,8,0.2,0,46,2.17,12,44218.0,18:25,0,0,0,0.0,22,63,8,18,-10,0,0,0,3206.0,1:20,0,0,0,1858.0,0:46,1800000
8473573,Artem,Anisimov,1988-05-24,C,L,2012-13,35,11,7,18,0.51,-6,68,16.18,12,34458.0,16:24,249,260,509,48.92,13,24,17,5,12,1,0,1,3592.0,1:42,0,0,0,3289.0,1:33,1875000
8473574,Shawn,Matthias,1988-02-19,LW,L,2012-13,48,14,7,21,0.44,-8,106,13.21,16,43747.0,15:11,153,194,347,44.09,66,21,16,4,12,2,1,3,2618.0,0:54,1,0,1,3031.0,1:3,851625
8473579,Nikolay,Kulemin,1986-07-14,LW,L,2012-13,48,7,16,23,0.48,-5,72,9.72,22,48205.0,16:44,10,10,20,50.0,122,47,30,13,17,0,0,0,1204.0,0:25,0,0,0,6302.0,2:11,2800000
8473584,Andrew,MacDonald,1986-09-07,D,L,2012-13,48,3,9,12,0.25,-2,45,6.67,20,67749.0,23:31,0,0,0,0.0,26,123,24,36,-12,1,2,3,4348.0,1:30,0,0,0,8035.0,2:47,550000
8473588,Erik,Condra,1986-08-06,RW,R,2012-13,48,4,8,12,0.25,3,73,5.48,34,37942.0,13:10,8,13,21,38.1,12,32,27,14,13,0,0,0,118.0,0:2,0,0,0,6095.0,2:6,625000
8473589,Chris,Summers,1988-02-05,D,L,2012-13,6,0,0,0,0.0,-3,5,0.0,9,4555.0,12:39,0,0,0,0.0,12,10,1,0,1,0,0,0,0.0,0:0,0,0,0,762.0,2:7,803250
8473600,Benn,Ferriero,1987-04-29,RW,R,2012-13,4,0,1,1,0.25,0,4,0.0,0,2306.0,9:36,2,7,9,22.22,4,2,2,1,1,0,0,0,105.0,0:26,0,0,0,45.0,0:11,700000
8473604,Jonathan,Toews,1988-04-29,C,L,2012-13,47,23,25,48,1.02,28,143,16.08,27,54545.0,19:20,559,374,933,59.91,24,16,56,16,40,2,4,6,7580.0,2:41,2,1,3,3995.0,1:25,6300000
8473610,Bobby,Sanguinetti,1988-02-29,D,R,2012-13,37,2,4,6,0.16,-6,48,4.17,4,32751.0,14:45,0,1,1,0.0,50,40,12,12,0,0,1,1,1287.0,0:34,0,0,0,2578.0,1:9,700000
8473616,Jonathan,Rheault,1986-08-01,RW,R,2012-13,5,0,0,0,0.0,0,5,0.0,0,3171.0,10:34,0,1,1,0.0,12,4,0,2,-2,0,0,0,41.0,0:8,0,0,0,11.0,0:2,-111
8473618,Mathieu,Perreault,1988-01-05,C,L,2012-13,39,6,11,17,0.44,7,47,12.77,20,27302.0,11:40,168,157,325,51.69,28,8,9,7,2,2,1,3,2785.0,1:11,0,0,0,85.0,0:2,1050000
8473646,Ryan,Carter,1983-08-03,LW,L,2012-13,44,6,9,15,0.34,-2,63,9.52,31,34459.0,13:3,43,40,83,51.81,50,15,17,9,8,0,0,0,140.0,0:3,1,2,3,2450.0,0:55,775000
8473658,Victor,Bartley,1988-02-17,D,L,2012-13,24,0,7,7,0.29,2,19,0.0,6,28141.0,19:32,0,0,0,0.0,35,28,11,15,-4,0,0,0,1035.0,0:43,0,0,0,1660.0,1:9,537500
8473673,David,Schlemko,1987-05-07,D,L,2012-13,30,1,5,6,0.2,8,35,2.86,12,30991.0,17:13,0,0,0,0.0,38,57,5,6,-1,0,0,0,3339.0,1:51,0,0,0,2591.0,1:26,550000
8473682,Andrew,Ebbett,1983-01-02,C,L,2012-13,28,1,5,6,0.21,-1,23,4.35,4,20704.0,12:19,106,161,267,39.7,17,15,7,8,-1,0,0,0,489.0,0:17,0,0,0,1715.0,1:1,600000
8473700,Ryan,Wilson,1987-02-03,D,L,2012-13,12,0,3,3,0.25,4,23,0.0,8,13322.0,18:30,0,0,0,0.0,17,12,5,6,-1,0,0,0,392.0,0:32,0,0,0,2187.0,3:2,2250000
8473712,Frazer,McLaren,1987-10-29,LW,L,2012-13,36,3,2,5,0.14,0,20,15.0,102,11241.0,5:12,4,7,11,36.36,53,9,1,5,-4,0,0,0,120.0,0:3,0,0,0,4.0,0:0,632500
8473722,John,Scott,1982-09-26,LW,L,2012-13,34,0,0,0,0.0,-1,15,0.0,69,11106.0,5:26,0,0,0,0.0,38,5,8,7,1,0,0,0,2.0,0:0,0,0,0,13.0,0:0,600000
8473734,Tim,Wallace,1984-08-06,RW,R,2012-13,28,1,1,2,0.07,-9,20,5.0,17,16848.0,10:1,9,21,30,30.0,69,4,4,3,1,0,0,0,47.0,0:1,0,0,0,1578.0,0:56,-111
8473867,Greg,Rallo,1981-08-26,C,R,2012-13,10,1,0,1,0.1,-5,10,10.0,2,5732.0,9:33,1,2,3,33.33,20,1,2,2,0,1,0,1,54.0,0:5,0,0,0,0.0,0:0,-111
8473908,Kevin,Westgarth,1984-02-07,RW,R,2012-13,31,2,2,4,0.13,1,16,12.5,45,10642.0,5:43,0,3,3,0.0,28,1,4,7,-3,0,0,0,74.0,0:2,0,0,0,0.0,0:0,725000
8473911,Steven,Pinizzotto,1984-04-26,RW,R,2012-13,12,0,0,0,0.0,-6,9,0.0,29,7194.0,9:59,0,0,0,0.0,29,4,0,1,-1,0,0,0,48.0,0:4,0,0,0,0.0,0:0,-111
8473914,Mark,Letestu,1985-02-04,C,R,2012-13,46,13,14,27,0.59,7,92,14.13,10,45583.0,16:30,244,243,487,50.1,36,12,27,7,20,3,2,5,3354.0,1:12,2,0,2,6101.0,2:12,625000
8473932,Darroll,Powe,1985-06-22,C,L,2012-13,42,0,0,0,0.0,-1,23,0.0,27,22675.0,8:59,56,48,104,53.85,82,22,5,3,2,0,0,0,280.0,0:6,0,0,0,4069.0,1:36,1066667
8473933,Ben,Lovejoy,1984-02-20,D,R,2012-13,35,0,10,10,0.29,4,58,0.0,29,37435.0,17:49,0,0,0,0.0,76,42,8,8,0,0,3,3,1119.0,0:31,0,1,1,1654.0,0:47,525000
8473942,Trevor,Smith,1985-02-08,C,L,2012-13,1,0,0,0,0.0,0,0,,0,624.0,10:24,0,0,0,0.0,0,1,0,0,0,0,0,0,0.0,0:0,0,0,0,0.0,0:0,575000
8473944,Matt,Anderson,1982-10-31,RW,R,2012-13,2,0,1,1,0.5,1,0,,0,693.0,5:46,0,0,0,0.0,0,1,0,0,0,0,0,0,5.0,0:2,0,0,0,0.0,0:0,-111
8473953,Derek,Smith,1984-10-13,D,L,2012-13,22,0,1,1,0.05,-5,18,0.0,10,16164.0,12:14,0,0,0,0.0,7,24,2,9,-7,0,0,0,21.0,0:0,0,0,0,492.0,0:22,775000
8473962,Teddy,Purcell,1985-09-08,LW,R,2012-13,48,11,25,36,0.75,-1,94,11.7,12,48219.0,16:44,2,4,6,33.33,11,7,20,25,-5,3,10,13,9736.0,3:22,0,0,0,115.0,0:2,2362500
8473970,Rob,Klinkhammer,1986-08-12,LW,L,2012-13,22,5,6,11,0.5,7,34,14.71,10,16144.0,12:13,2,0,2,100.0,65,6,5,1,4,1,0,1,263.0,0:11,0,0,0,157.0,0:7,650000
8473986,Alex,Killorn,1989-09-14,LW,L,2012-13,38,7,12,19,0.5,-6,82,8.54,14,38347.0,16:49,11,17,28,39.29,40,22,11,17,-6,1,2,3,4263.0,1:52,0,0,0,2590.0,1:8,875000
8473991,Karl,Alzner,1988-09-24,D,L,2012-13,48,1,4,5,0.1,-6,39,2.56,14,60352.0,20:57,0,0,0,0.0,45,85,10,23,-13,0,0,0,264.0,0:5,0,0,0,7413.0,2:34,1285000
8473992,Justin,Falk,1988-10-11,D,L,2012-13,36,0,3,3,0.08,-9,27,0.0,40,28543.0,13:12,0,0,0,0.0,53,39,7,6,1,0,0,0,127.0,0:3,0,0,0,2738.0,1:16,825000
8473994,Jamie,Benn,1989-07-18,LW,L,2012-13,41,12,21,33,0.8,-12,110,10.91,40,48979.0,19:54,327,382,709,46.12,71,32,41,31,10,3,7,10,8163.0,3:19,0,0,0,1086.0,0:26,5250000
8474001,TJ,Galiardi,1988-04-22,LW,L,2012-13,36,5,9,14,0.39,1,68,7.35,14,29960.0,13:52,5,14,19,26.32,36,15,18,14,4,1,1,2,1219.0,0:33,0,0,0,1750.0,0:48,950000
8474009,Nick,Bonino,1988-04-20,C,L,2012-13,27,5,8,13,0.48,-3,37,13.51,8,25736.0,15:53,138,157,295,46.78,11,49,16,8,8,1,2,3,2869.0,1:46,0,0,0,1981.0,1:13,700000
8474013,Ian,Cole,1989-02-21,D,L,2012-13,15,0,1,1,0.07,-4,10,0.0,10,15971.0,17:44,0,0,0,0.0,6,22,1,5,-4,0,0,0,220.0,0:14,0,0,0,236.0,0:15,875000
8474024,Jim,O'Brien,1989-01-29,C,R,2012-13,29,5,1,6,0.21,-2,38,13.16,8,19879.0,11:25,100,119,219,45.66,30,13,9,6,3,1,0,1,191.0,0:6,0,0,0,3596.0,2:4,637500
8474025,Eric,Tangradi,1989-02-10,LW,L,2012-13,41,1,3,4,0.1,-2,48,2.08,22,24808.0,10:5,0,2,2,0.0,87,22,8,8,0,0,0,0,411.0,0:10,0,0,0,7.0,0:0,726000
8474027,Justin,Braun,1987-02-10,D,R,2012-13,41,0,7,7,0.17,-5,48,0.0,6,46251.0,18:48,0,0,0,0.0,53,51,12,24,-12,0,1,1,3197.0,1:17,0,0,0,3793.0,1:32,1250000
8474030,Aaron,Palushaj,1989-09-07,RW,R,2012-13,25,2,7,9,0.36,-2,29,6.9,8,16973.0,11:18,2,6,8,25.0,32,13,8,5,3,0,0,0,1108.0,0:44,0,0,0,1.0,0:0,600000
8474031,Kevin,Shattenkirk,1989-01-29,D,R,2012-13,48,5,18,23,0.48,2,84,5.95,20,61348.0,21:18,0,0,0,0.0,55,59,22,22,0,2,7,9,7554.0,2:37,0,0,0,5110.0,1:46,875000
8474032,Nick,Petrecki,1989-07-11,D,L,2012-13,1,0,0,0,0.0,0,0,,0,718.0,11:58,0,0,0,0.0,1,2,1,2,-1,0,0,0,0.0,0:0,0,0,0,0.0,0:0,650000
8474034,Patrick,Maroon,1988-04-23,LW,L,2012-13,13,2,1,3,0.23,-1,21,9.52,10,7633.0,9:47,4,10,14,28.57,22,7,5,0,5,0,0,0,336.0,0:25,0,0,0,0.0,0:0,550000
8474035,Bill,Sweatt,1988-09-21,LW,L,2012-13,1,0,0,0,0.0,-1,0,,0,744.0,12:24,0,0,0,0.0,0,0,0,0,0,0,0,0,0.0,0:0,0,0,0,0.0,0:0,900000
8474037,James,van Riemsdyk,1989-05-04,LW,L,2012-13,48,18,14,32,0.67,-7,140,12.86,26,55317.0,19:12,24,19,43,55.81,55,15,17,31,-14,5,1,6,8135.0,2:49,0,0,0,3448.0,1:11,4250000
8474038,Paul,Byron,1989-04-27,LW,L,2012-13,4,0,1,1,0.25,-2,1,0.0,2,2509.0,10:27,7,10,17,41.18,3,1,0,1,-1,0,0,0,59.0,0:14,0,0,0,151.0,0:37,560000
8474040,Sam,Gagner,1989-08-10,C,R,2012-13,48,14,24,38,0.79,-6,113,12.39,23,55905.0,19:24,325,416,741,43.86,35,22,23,26,-3,4,11,15,8437.0,2:55,0,2,2,4596.0,1:35,3200000
8474048,Keith,Aulie,1989-06-11,D,L,2012-13,45,2,5,7,0.16,1,37,5.41,60,34611.0,12:49,0,0,0,0.0,91,42,5,8,-3,0,0,0,27.0,0:0,0,0,0,1738.0,0:38,577500
8474049,Akim,Aliu,1989-04-24,RW,R,2012-13,5,0,0,0,0.0,-2,2,0.0,14,3259.0,10:51,0,0,0,0.0,5,2,1,2,-1,0,0,0,205.0,0:41,0,0,0,0.0,0:0,695000
8474052,Chris,Terry,1989-04-07,LW,L,2012-13,3,1,0,1,0.33,0,1,100.0,0,1729.0,9:36,1,0,1,100.0,1,1,2,0,2,0,0,0,66.0,0:22,0,0,0,0.0,0:0,537500
8474053,Logan,Couture,1989-03-28,C,L,2012-13,48,21,16,37,0.77,7,151,13.91,4,52119.0,18:5,252,237,489,51.53,32,51,31,22,9,7,5,12,8977.0,3:7,0,1,1,2575.0,0:53,2875000
8474056,P.K.,Subban,1989-05-13,D,R,2012-13,42,11,27,38,0.9,12,126,8.73,57,58575.0,23:14,0,0,0,0.0,51,49,10,42,-32,7,19,26,11870.0,4:42,0,0,0,3654.0,1:27,3109375
8474061,Anthony,Peluso,1989-04-18,RW,R,2012-13,5,0,2,2,0.4,1,4,0.0,14,1499.0,4:59,0,0,0,0.0,7,0,0,1,-1,0,0,0,58.0,0:11,0,0,0,0.0,0:0,605000
8474062,Riley,Nash,1989-05-09,C,R,2012-13,32,4,5,9,0.28,-4,36,11.11,8,24577.0,12:48,128,161,289,44.29,36,10,31,3,28,0,0,0,1493.0,0:46,0,0,0,530.0,0:16,704166
8474066,Thomas,Hickey,1989-02-08,D,L,2012-13,39,1,3,4,0.1,9,40,2.5,8,39451.0,16:51,0,0,0,0.0,27,47,13,17,-4,0,0,0,111.0,0:2,0,0,0,2505.0,1:4,700000
8474068,Kyle,Turris,1989-08-14,C,R,2012-13,48,12,17,29,0.6,6,118,10.17,24,56561.0,19:38,451,469,920,49.02,30,20,28,27,1,3,6,9,7873.0,2:44,0,0,0,4126.0,1:25,1400000
8474074,Paul,Postma,1989-02-22,D,R,2012-13,34,4,5,9,0.26,-5,32,12.5,6,30658.0,15:1,0,0,0,0.0,17,27,9,16,-7,2,2,4,3439.0,1:41,0,0,0,106.0,0:3,550000
8474089,Brad,Malone,1989-05-20,C,L,2012-13,13,1,1,2,0.15,-7,10,10.0,16,6855.0,8:47,22,24,46,47.83,39,3,6,1,5,0,0,0,13.0,0:1,0,0,0,229.0,0:17,700000
8474090,Brendan,Smith,1989-02-08,D,L,2012-13,34,0,8,8,0.24,1,33,0.0,36,37538.0,18:24,0,0,0,0.0,20,35,10,27,-17,0,2,2,2352.0,1:9,0,0,0,2610.0,1:16,875000
8474091,Brandon,Sutter,1989-02-14,C,R,2012-13,48,11,8,19,0.4,3,82,13.41,4,47250.0,16:24,382,379,761,50.2,30,32,19,19,0,3,1,4,3397.0,1:10,0,0,0,5449.0,1:53,2066667
8474094,Matt,Halischuk,1988-06-01,RW,R,2012-13,36,5,6,11,0.31,1,51,9.8,10,25813.0,11:57,2,4,6,33.33,33,21,13,12,1,0,0,0,178.0,0:4,0,0,0,1868.0,0:51,712500
8474095,Dana,Tyrell,1989-04-23,C,L,2012-13,21,1,3,4,0.19,-3,19,5.26,4,13044.0,10:21,5,10,15,33.33,24,2,5,4,1,0,0,0,162.0,0:7,0,0,0,1511.0,1:11,600000
8474096,Nick,Spaling,1988-09-19,C,L,2012-13,47,9,4,13,0.28,-10,57,15.79,18,44726.0,15:51,223,259,482,46.27,38,21,22,7,15,1,1,2,675.0,0:14,0,1,1,5892.0,2:5,1050000
8474098,Colton,Sceviour,1989-04-20,C,R,2012-13,1,0,1,1,1.0,-1,0,,0,291.0,4:51,1,2,3,33.33,1,1,0,1,-1,0,0,0,0.0,0:0,0,0,0,0.0,0:0,525000
8474100,Dwight,King,1989-07-05,LW,L,2012-13,47,4,6,10,0.21,-3,60,6.67,11,35972.0,12:45,2,4,6,33.33,58,9,14,11,3,0,0,0,951.0,0:20,0,0,0,67.0,0:1,750000
8474102,David,Perron,1988-05-28,LW,R,2012-13,48,10,15,25,0.52,0,84,11.9,44,51860.0,18:0,8,14,22,36.36,48,11,26,14,12,2,4,6,7142.0,2:28,0,0,0,2121.0,0:44,3812500
8474113,TJ,Brennan,1989-04-03,D,L,2012-13,29,3,7,10,0.34,-9,42,7.14,8,29038.0,16:41,0,0,0,0.0,31,32,12,8,4,1,3,4,3816.0,2:11,0,0,0,263.0,0:9,550000
8474121,Colton,Gillies,1989-02-12,C,L,2012-13,27,1,1,2,0.07,1,17,5.88,17,13443.0,8:17,0,2,2,0.0,61,10,3,2,1,0,0,0,46.0,0:1,0,0,0,0.0,0:0,625000
8474125,Carl,Gunnarsson,1986-11-09,D,L,2012-13,37,1,14,15,0.41,5,28,3.57,14,47247.0,21:16,0,0,0,0.0,78,71,11,32,-21,0,0,0,1687.0,0:45,0,0,0,5758.0,2:35,1325000
8474134,Yannick,Weber,1988-09-23,D,R,2012-13,6,0,2,2,0.33,-1,3,0.0,2,4950.0,13:45,0,0,0,0.0,3,4,1,2,-1,0,1,1,605.0,1:40,0,0,0,113.0,0:18,850000
8474135,Brett,Bellemore,1988-06-25,D,R,2012-13,8,0,2,2,0.25,-2,3,0.0,7,6607.0,13:45,0,0,0,0.0,14,13,3,4,-1,0,0,0,39.0,0:4,0,0,0,934.0,1:56,525000
8474137,Drayson,Bowman,1989-03-08,LW,L,2012-13,37,3,2,5,0.14,-7,68,4.41,17,25984.0,11:42,4,6,10,40.0,55,14,21,7,14,0,0,0,614.0,0:16,0,0,0,1084.0,0:29,600000
8474138,Dustin,Jeffrey,1988-02-27,LW,L,2012-13,24,3,3,6,0.25,1,26,11.54,2,16579.0,11:30,94,106,200,47.0,6,5,2,5,-3,0,0,0,599.0,0:24,0,0,0,242.0,0:10,575000
8474141,Patrick,Kane,1988-11-19,RW,L,2012-13,47,23,32,55,1.17,11,138,16.67,8,56558.0,20:3,2,8,10,20.0,11,9,36,25,11,8,9,17,8345.0,2:57,0,0,0,24.0,0:0,6300000
8474145,Robert,Bortuzzo,1989-03-18,D,R,2012-13,15,2,2,4,0.27,3,10,20.0,27,11962.0,13:17,0,0,0,0.0,18,14,1,1,0,0,0,0,64.0,0:4,0,0,0,521.0,0:34,525000
8474150,Mikael,Backlund,1989-03-17,C,L,2012-13,32,8,8,16,0.5,-6,88,9.09,29,29039.0,15:7,194,213,407,47.67,31,19,28,17,11,2,2,4,2681.0,1:23,0,0,0,759.0,0:23,725000
8474151,Ryan,McDonagh,1989-06-13,D,L,2012-13,47,4,15,19,0.4,13,83,4.82,22,68690.0,24:21,0,1,1,0.0,69,78,27,26,1,0,1,1,1786.0,0:38,0,1,1,7609.0,2:41,875000
8474157,Max,Pacioretty,1988-11-20,LW,L,2012-13,44,15,24,39,0.89,8,163,9.2,28,43585.0,16:30,2,5,7,28.57,59,16,24,12,12,4,8,12,8147.0,3:5,0,0,0,272.0,0:6,1625000
8474161,Jakub,Voracek,1989-08-15,RW,L,2012-13,48,22,24,46,0.96,-7,129,17.05,35,49644.0,17:14,2,3,5,40.0,20,12,21,25,-4,8,9,17,10342.0,3:35,0,0,0,85.0,0:1,4250000
8474162,Jake,Muzzin,1989-02-21,D,L,2012-13,45,7,9,16,0.36,16,77,9.09,35,48317.0,17:53,0,0,0,0.0,70,29,7,23,-16,3,4,7,6080.0,2:15,0,0,0,126.0,0:2,577500
8474164,Jonathon,Blum,1989-01-30,D,R,2012-13,35,1,6,7,0.2,-1,26,3.85,6,30029.0,14:17,0,0,0,0.0,32,44,10,12,-2,0,0,0,2434.0,1:9,0,0,0,197.0,0:5,650000
8474166,Alec,Martinez,1987-07-26,D,L,2012-13,27,1,4,5,0.19,-2,30,3.33,10,25957.0,16:1,0,0,0,0.0,31,31,2,13,-11,0,1,1,2025.0,1:15,0,0,0,1187.0,0:43,737500
8474168,Joakim,Andersson,1989-02-05,C,L,2012-13,38,3,5,8,0.21,2,43,6.98,8,27555.0,12:5,144,166,310,46.45,17,12,4,16,-12,0,1,1,519.0,0:13,0,0,0,3013.0,1:19,612500
8474176,Carl,Hagelin,1988-08-23,LW,L,2012-13,48,10,14,24,0.5,10,132,7.58,18,49833.0,17:18,7,10,17,41.18,49,28,13,20,-7,1,0,1,2977.0,1:2,0,0,0,2057.0,0:42,637500
8474184,Keaton,Ellerby,1988-11-05,D,L,2012-13,44,0,3,3,0.07,3,23,0.0,52,38214.0,14:28,0,0,0,0.0,74,43,5,21,-16,0,0,0,300.0,0:6,0,0,0,4244.0,1:36,700000
8474189,Lars,Eller,1989-05-08,C,L,2012-13,46,8,22,30,0.65,8,84,9.52,45,40930.0,14:49,267,275,542,49.26,86,33,23,19,4,1,4,5,1947.0,0:42,0,0,0,4055.0,1:28,1150000
8474190,Wayne,Simmonds,1988-08-26,RW,R,2012-13,45,15,17,32,0.71,-7,110,13.64,82,42221.0,15:38,2,1,3,66.67,72,16,10,19,-9,6,10,16,8676.0,3:12,0,0,0,63.0,0:1,1750000
8474192,Matt,Frattin,1988-01-03,RW,R,2012-13,25,7,6,13,0.52,6,42,16.67,4,19839.0,13:13,5,3,8,62.5,55,11,10,13,-3,0,0,0,868.0,0:34,0,0,0,16.0,0:0,875000
8474201,Pierre-Cedric,Labrie,1986-12-06,LW,L,2012-13,19,2,1,3,0.16,2,16,12.5,30,9756.0,8:33,2,2,4,50.0,40,6,3,5,-2,0,0,0,12.0,0:0,0,0,0,2.0,0:0,525000
8474207,Nick,Holden,1987-05-15,D,L,2012-13,2,0,0,0,0.0,1,2,0.0,0,1029.0,8:34,0,0,0,0.0,3,0,0,2,-2,0,0,0,0.0,0:0,0,0,0,1.0,0:0,550000
8474218,Jason,Demers,1988-06-09,D,R,2012-13,22,1,2,3,0.14,-4,27,3.7,10,24589.0,18:37,0,0,0,0.0,32,24,6,12,-6,0,0,0,1730.0,1:18,0,0,0,1727.0,1:18,1250000
8474230,Micheal,Haley,1986-03-30,C,L,2012-13,9,0,0,0,0.0,-1,4,0.0,12,3579.0,6:37,2,1,3,66.67,21,5,0,1,-1,0,0,0,10.0,0:1,0,0,0,0.0,0:0,600000
8474250,Zack,Smith,1988-04-05,LW,L,2012-13,48,4,11,15,0.31,-9,94,4.26,56,43626.0,15:8,379,352,731,51.85,97,22,22,21,1,0,2,2,1926.0,0:40,0,0,0,1411.0,0:29,700000
8474291,Jay,Beagle,1985-10-16,C,R,2012-13,48,2,6,8,0.17,-1,56,3.57,14,34862.0,12:6,249,195,444,56.08,55,23,18,12,6,0,0,0,389.0,0:8,0,0,0,6109.0,2:7,900000
8474497,Michael,Kostka,1985-11-28,D,R,2012-13,35,0,8,8,0.23,-7,49,0.0,27,46367.0,22:4,0,0,0,0.0,49,66,12,31,-19,0,5,5,5457.0,2:35,0,0,0,3008.0,1:25,600000
8474518,Davis,Drewiske,1984-11-22,D,L,2012-13,29,2,5,7,0.24,3,28,7.14,14,26444.0,15:11,1,0,1,100.0,21,35,1,12,-11,1,0,1,473.0,0:16,0,0,0,4865.0,2:47,616667
8474519,Jack,Hillen,1986-01-24,D,L,2012-13,23,3,6,9,0.39,9,28,10.71,14,24305.0,17:36,0,0,0,0.0,10,35,2,13,-11,0,0,0,293.0,0:12,0,0,0,1239.0,0:53,650000
8474520,Jason,Garrison,1984-11-13,D,L,2012-13,47,8,8,16,0.34,18,94,8.51,28,61166.0,21:41,0,0,0,0.0,36,58,16,24,-8,3,3,6,6481.0,2:17,0,0,0,6522.0,2:18,4600000
8474535,Chris,Mueller,1986-03-06,C,R,2012-13,18,2,3,5,0.28,-4,22,9.09,6,11563.0,10:42,92,93,185,49.73,14,15,5,1,4,0,0,0,63.0,0:3,0,0,0,391.0,0:21,550000
8474551,Ville,Leino,1983-10-06,LW,L,2012-13,8,2,4,6,0.75,0,11,18.18,6,7586.0,15:48,4,6,10,40.0,5,2,1,2,-1,1,1,2,800.0,1:40,0,0,0,0.0,0:0,4500000
8474554,Eric,Selleck,1987-10-20,LW,L,2012-13,2,0,1,1,0.5,2,2,0.0,17,950.0,7:55,0,0,0,0.0,5,0,2,0,2,0,0,0,0.0,0:0,0,0,0,0.0,0:0,550000
8474563,Drew,Doughty,1989-12-08,D,R,2012-13,48,6,16,22,0.46,4,114,5.26,36,76016.0,26:23,0,0,0,0.0,128,46,9,36,-27,3,7,10,8802.0,3:3,0,0,0,6193.0,2:9,7000000
8474564,Steven,Stamkos,1990-02-07,C,R,2012-13,48,29,28,57,1.19,-4,157,18.47,32,63426.0,22:1,406,413,819,49.57,63,17,24,31,-7,10,8,18,10811.0,3:45,0,0,0,2096.0,0:43,7500000
8474565,Alex,Pietrangelo,1990-01-18,D,R,2012-13,47,5,19,24,0.51,0,93,5.38,10,70818.0,25:6,0,0,0,0.0,24,101,26,27,-1,2,4,6,8051.0,2:51,0,1,1,8525.0,3:1,816667
8474567,Zach,Bogosian,1990-07-15,D,R,2012-13,33,5,9,14,0.42,-5,85,5.88,29,45785.0,23:7,0,0,0,0.0,79,50,12,28,-16,0,3,3,3452.0,1:44,0,0,0,3945.0,1:59,2500000
8474568,Luke,Schenn,1989-11-02,D,R,2012-13,47,3,8,11,0.23,3,81,3.7,34,61653.0,21:51,0,0,0,0.0,187,102,14,31,-17,0,0,0,1022.0,0:21,0,0,0,7951.0,2:49,3600000
8474569,Colin,Wilson,1989-10-20,C,L,2012-13,25,7,12,19,0.76,1,26,26.92,4,24850.0,16:34,8,13,21,38.1,10,13,12,13,-1,2,4,6,3555.0,2:22,0,0,0,12.0,0:0,2000000
8474570,Cody,Hodgson,1990-02-18,C,R,2012-13,48,15,19,34,0.71,-4,114,13.16,20,52987.0,18:23,380,432,812,46.8,21,24,19,29,-10,3,2,5,7525.0,2:36,1,1,2,3716.0,1:17,816667
8474571,Mikkel,Boedker,1989-12-16,LW,L,2012-13,48,7,19,26,0.54,0,83,8.43,12,53213.0,18:28,1,10,11,9.09,77,17,27,13,14,3,4,7,8028.0,2:47,0,0,0,3118.0,1:4,1100000
8474573,Josh,Bailey,1989-10-02,RW,L,2012-13,38,11,8,19,0.5,7,76,14.47,6,37344.0,16:22,35,40,75,46.67,24,22,26,21,5,0,2,2,2937.0,1:17,0,0,0,2052.0,0:54,1050000
8474574,Tyler,Myers,1990-02-01,D,R,2012-13,39,3,5,8,0.21,-8,48,6.25,32,49874.0,21:18,0,0,0,0.0,58,56,11,30,-19,1,2,3,5161.0,2:12,0,0,0,5253.0,2:14,5500000
8474576,Zach,Boychuk,1989-10-04,LW,L,2012-13,13,1,1,2,0.15,-1,14,7.14,6,9603.0,12:18,0,0,0,0.0,10,2,2,3,-1,0,0,0,106.0,0:8,0,0,0,0.0,0:0,625000
8474577,Joe,Colborne,1990-01-30,C,L,2012-13,5,0,0,0,0.0,-1,4,0.0,2,2736.0,9:7,15,14,29,51.72,11,0,2,1,1,0,0,0,53.0,0:10,0,0,0,0.0,0:0,875000
8474578,Erik,Karlsson,1990-05-31,D,R,2012-13,17,6,8,14,0.82,8,79,7.59,8,27698.0,27:9,0,0,0,0.0,10,14,18,18,0,2,2,4,4602.0,4:30,1,0,1,1810.0,1:46,6500000
8474579,Luca,Sbisa,1990-01-30,D,L,2012-13,41,1,7,8,0.2,0,39,2.56,23,48792.0,19:50,0,0,0,0.0,99,57,10,13,-3,0,3,3,1692.0,0:41,0,0,0,4631.0,1:52,2175000
8474581,Jake,Gardiner,1990-07-04,D,L,2012-13,12,0,4,4,0.33,0,12,0.0,0,14746.0,20:28,0,0,0,0.0,13,15,6,12,-6,0,2,2,1764.0,2:27,0,0,0,164.0,0:13,875000
8474582,Mattias,Tedenby,1990-02-21,RW,L,2012-13,4,0,1,1,0.25,0,2,0.0,2,2158.0,8:59,0,0,0,0.0,1,1,0,1,-1,0,0,0,50.0,0:12,0,0,0,12.0,0:3,875000
8474584,Michael,Del Zotto,1990-06-24,D,L,2012-13,46,3,18,21,0.46,6,81,3.7,18,63962.0,23:10,0,0,0,0.0,77,64,10,26,-16,0,8,8,8006.0,2:54,1,0,1,4355.0,1:34,2550000
8474586,Jordan,Eberle,1990-05-15,C,R,2012-13,48,16,21,37,0.77,-4,133,12.03,16,54706.0,18:59,8,11,19,42.11,31,16,28,32,-4,3,6,9,9198.0,3:11,0,0,0,553.0,0:11,875000
8474589,Tyler,Ennis,1989-10-06,LW,L,2012-13,47,10,21,31,0.66,-14,108,9.26,16,50415.0,17:52,158,219,377,41.91,28,25,16,20,-4,2,12,14,9540.0,3:22,0,0,0,147.0,0:3,2812500
8474590,John,Carlson,1990-01-10,D,R,2012-13,48,6,16,22,0.46,11,97,6.19,18,66300.0,23:1,1,0,1,100.0,59,123,18,41,-23,0,5,5,6429.0,2:13,0,0,0,8321.0,2:53,3966667
8474594,Slava,Voynov,1990-01-15,D,R,2012-13,48,6,19,25,0.52,5,79,7.59,14,64230.0,22:18,2,0,2,100.0,83,48,8,38,-30,1,7,8,6043.0,2:5,0,0,0,4808.0,1:40,762500
8474597,Cody,Goloubef,1989-11-30,D,R,2012-13,11,1,0,1,0.09,-3,14,7.14,0,9777.0,14:48,0,0,0,0.0,10,7,0,1,-1,0,0,0,59.0,0:5,0,0,0,25.0,0:2,783333
8474600,Roman,Josi,1990-06-01,D,L,2012-13,48,5,13,18,0.38,-7,96,5.21,8,67765.0,23:31,0,0,0,0.0,31,73,16,20,-4,1,6,7,8307.0,2:53,0,0,0,2552.0,0:53,875000
8474602,Justin,Schultz,1990-07-06,D,R,2012-13,48,8,19,27,0.56,-17,85,9.41,8,61775.0,21:26,0,1,1,0.0,15,35,15,34,-19,4,11,15,9220.0,3:12,0,0,0,1676.0,0:34,925000
8474605,Patrick,Wiercioch,1990-09-12,D,L,2012-13,42,5,14,19,0.45,9,81,6.17,39,39548.0,15:41,0,0,0,0.0,28,29,1,18,-17,3,7,10,5842.0,2:19,0,0,0,159.0,0:3,875000
8474606,Colby,Robak,1990-04-24,D,L,2012-13,16,0,1,1,0.06,-1,15,0.0,17,14569.0,15:10,0,0,0,0.0,4,13,3,4,-1,0,0,0,1203.0,1:15,0,0,0,501.0,0:31,791667
8474609,Luke,Adam,1990-06-18,C,L,2012-13,4,1,0,1,0.25,1,2,50.0,2,2350.0,9:47,1,0,1,100.0,3,2,0,0,0,0,0,0,90.0,0:22,0,0,0,0.0,0:0,737500
8474610,Zac,Dalpe,1989-11-01,C,R,2012-13,10,1,2,3,0.3,-7,18,5.56,0,7381.0,12:18,1,2,3,33.33,14,4,4,0,4,0,0,0,523.0,0:52,0,0,0,0.0,0:0,704167
8474612,Travis,Hamonic,1990-08-16,D,R,2012-13,48,3,7,10,0.21,-8,83,3.61,28,65675.0,22:48,0,0,0,0.0,59,109,34,46,-12,1,2,3,3590.0,1:14,0,1,1,7882.0,2:44,875000
8474613,Derek,Stepan,1990-06-18,C,R,2012-13,48,18,26,44,0.92,25,108,16.67,12,60257.0,20:55,448,529,977,45.85,52,28,34,22,12,4,6,10,8141.0,2:49,1,3,4,6068.0,2:6,820833
8474615,Jared,Staal,1990-08-21,RW,R,2012-13,2,0,0,0,0.0,-2,3,0.0,2,1606.0,13:23,0,0,0,0.0,12,1,2,0,2,0,0,0,75.0,0:37,0,0,0,0.0,0:0,566666
8474616,Patrice,Cormier,1990-06-14,C,L,2012-13,10,0,0,0,0.0,-3,4,0.0,7,2332.0,3:53,1,5,6,16.67,15,2,0,0,0,0,0,0,22.0,0:2,0,0,0,0.0,0:0,575000
8474618,Marco,Scandella,1990-02-23,D,L,2012-13,6,1,0,1,0.17,-1,7,14.29,4,5193.0,14:25,0,0,0,0.0,8,4,0,1,-1,0,0,0,13.0,0:2,0,0,0,409.0,1:8,643333
8474625,Jimmy,Hayes,1989-11-21,RW,R,2012-13,10,1,3,4,0.4,0,13,7.69,0,8599.0,14:19,4,3,7,57.14,11,9,3,2,1,0,0,0,245.0,0:24,0,0,0,38.0,0:3,654167
8474628,Michael,Stone,1990-06-07,D,R,2012-13,40,5,4,9,0.22,2,50,10.0,16,40048.0,16:41,0,0,0,0.0,89,64,8,4,4,1,1,2,2616.0,1:5,0,0,0,2962.0,1:14,591667
8474629,Shawn,Lalonde,1990-03-10,D,R,2012-13,1,0,0,0,0.0,1,0,,0,887.0,14:47,0,0,0,0.0,3,0,1,0,1,0,0,0,28.0,0:28,0,0,0,0.0,0:0,570000
8474641,Adam,Henrique,1990-02-06,C,L,2012-13,42,11,5,16,0.38,-3,78,14.1,16,46162.0,18:19,333,347,680,48.97,27,21,26,13,13,3,1,4,6685.0,2:39,2,1,3,4430.0,1:45,575000
8474646,Brandon,McMillan,1990-03-22,LW,L,2012-13,6,0,1,1,0.17,-1,2,0.0,2,3147.0,8:44,12,14,26,46.15,4,1,0,0,0,0,0,0,0.0,0:0,0,0,0,308.0,0:51,687500
8474649,Tomas,Kundratek,1989-12-26,D,R,2012-13,25,1,6,7,0.28,-5,23,4.35,8,24218.0,16:8,0,0,0,0.0,21,23,5,10,-5,0,3,3,1283.0,0:51,0,0,0,2080.0,1:23,579167
8474661,Michal,Jordan,1990-07-17,D,L,2012-13,5,0,0,0,0.0,-2,2,0.0,2,3206.0,10:41,0,0,0,0.0,0,2,0,2,-2,0,0,0,0.0,0:0,0,0,0,6.0,0:1,606667
8474666,David,Ullstrom,1989-04-22,LW,L,2012-13,20,2,3,5,0.25,-2,28,7.14,6,11398.0,9:29,10,8,18,55.56,23,1,3,5,-2,0,0,0,221.0,0:11,0,0,0,13.0,0:0,637500
8474668,Dale,Weise,1988-08-05,RW,R,2012-13,40,3,3,6,0.15,-7,35,8.57,43,22933.0,9:33,1,7,8,12.5,84,13,8,5,3,0,0,0,143.0,0:3,0,0,0,2148.0,0:53,615000
8474673,TJ,Brodie,1990-06-07,D,L,2012-13,47,2,12,14,0.3,-9,44,4.55,8,57011.0,20:13,0,0,0,0.0,24,74,25,36,-11,0,6,6,5697.0,2:1,0,0,0,1688.0,0:35,566667
8474674,James,Wright,1990-03-24,C,L,2012-13,38,2,3,5,0.13,-5,32,6.25,31,26446.0,11:35,22,24,46,47.83,43,17,12,4,8,0,0,0,11.0,0:0,0,0,0,3284.0,1:26,650000
8474679,Gustav,Nyquist,1989-09-01,RW,L,2012-13,22,3,3,6,0.27,0,46,6.52,6,17212.0,13:2,1,3,4,25.0,2,3,19,3,16,0,2,2,2838.0,2:9,0,0,0,10.0,0:0,762500
8474681,Andrei,Loktionov,1990-05-30,C,L,2012-13,28,8,4,12,0.43,-2,47,17.02,4,23948.0,14:15,80,126,206,38.83,6,8,19,10,9,1,2,3,2450.0,1:27,0,0,0,82.0,0:2,604167
8474683,Derek,Grant,1990-04-20,C,L,2012-13,5,0,0,0,0.0,-1,5,0.0,0,2599.0,8:39,17,14,31,54.84,8,0,0,1,-1,0,0,0,0.0,0:0,0,0,0,471.0,1:34,605000
8474685,Matt,Calvert,1989-12-24,LW,L,2012-13,42,9,7,16,0.38,-9,63,14.29,32,35732.0,14:10,2,4,6,33.33,57,24,17,6,11,0,0,0,1150.0,0:27,1,0,1,3009.0,1:11,712500
8474688,Greg,Pateryn,1990-06-20,D,R,2012-13,3,0,0,0,0.0,0,0,,0,1728.0,9:36,0,0,0,0.0,2,1,0,1,-1,0,0,0,14.0,0:4,0,0,0,0.0,0:0,662500
8474697,Mark,Borowiecki,1989-07-12,D,L,2012-13,6,0,0,0,0.0,1,1,0.0,18,4679.0,12:59,0,0,0,0.0,26,5,0,4,-4,0,0,0,0.0,0:0,0,0,0,784.0,2:10,610000
8474705,Mark,Olver,1988-01-01,C,L,2012-13,32,4,2,6,0.19,-5,33,12.12,6,17361.0,9:2,59,83,142,41.55,28,17,9,10,-1,0,0,0,522.0,0:16,0,0,0,138.0,0:4,-111
8474707,Philip,Larsen,1989-12-07,D,R,2012-13,32,2,3,5,0.16,-10,30,6.67,18,28570.0,14:52,0,0,0,0.0,50,18,3,11,-8,1,0,1,1333.0,0:41,0,0,0,784.0,0:24,1025000
8474709,Matt,Martin,1989-05-08,LW,L,2012-13,48,4,7,11,0.23,-2,67,5.97,63,34291.0,11:54,6,12,18,33.33,234,22,10,12,-2,1,0,1,628.0,0:13,0,0,0,4607.0,1:35,1000000
8474715,Cam,Atkinson,1989-06-05,RW,R,2012-13,35,9,9,18,0.51,9,91,9.89,4,32731.0,15:35,0,0,0,0.0,24,16,19,6,13,1,1,2,2774.0,1:19,0,0,0,1445.0,0:41,775000
8474716,Jared,Spurgeon,1989-11-29,D,R,2012-13,39,5,10,15,0.38,1,67,7.46,4,50412.0,21:32,0,0,0,0.0,46,55,10,15,-5,4,3,7,7238.0,3:5,0,0,0,3097.0,1:19,526667
8474717,Mark,Barberio,1990-03-23,D,L,2012-13,2,0,0,0,0.0,-2,1,0.0,0,1859.0,15:29,0,0,0,0.0,0,1,0,5,-5,0,0,0,352.0,2:56,0,0,0,35.0,0:17,580000
8474719,Teemu,Hartikainen,1990-05-03,C,L,2012-13,23,1,2,3,0.13,-8,21,4.76,6,14584.0,10:34,1,3,4,25.0,22,3,6,2,4,1,2,3,2797.0,2:1,0,0,0,10.0,0:0,875000
8474727,Ben,Smith,1988-07-11,RW,R,2012-13,1,1,0,1,1.0,1,1,100.0,0,1101.0,18:21,0,2,2,0.0,1,0,0,0,0,0,0,0,102.0,1:42,0,0,0,91.0,1:31,562500
8474736,Zac,Rinaldo,1990-06-15,C,L,2012-13,32,3,2,5,0.16,-7,15,20.0,85,16089.0,8:22,1,1,2,50.0,143,12,4,2,2,0,0,0,76.0,0:2,0,0,0,50.0,0:1,540000
8474739,Tommy,Wingels,1988-04-12,C,R,2012-13,42,5,8,13,0.31,-9,69,7.25,26,35868.0,14:14,4,12,16,25.0,115,32,18,12,6,0,1,1,1669.0,0:39,1,0,1,2454.0,0:58,775000
8474743,Zach,Redmond,1988-07-26,D,R,2012-13,8,1,3,4,0.5,0,13,7.69,12,9398.0,19:34,0,0,0,0.0,12,8,1,5,-4,0,1,1,715.0,1:29,1,0,1,679.0,1:24,687500
8474744,Sean,Collins,1988-12-29,C,L,2012-13,5,0,0,0,0.0,-2,0,,6,3748.0,12:29,1,4,5,20.0,3,5,0,0,0,0,0,0,0.0,0:0,0,0,0,0.0,0:0,625000
8474749,Matt,Bartkowski,1988-06-04,D,L,2012-13,11,0,2,2,0.18,0,9,0.0,6,8899.0,13:29,0,0,0,0.0,11,3,1,5,-4,0,0,0,7.0,0:0,0,0,0,134.0,0:12,660000
8474772,Stu,Bickel,1986-10-02,D,R,2012-13,16,0,0,0,0.0,-2,2,0.0,49,5296.0,5:31,0,0,0,0.0,13,6,1,6,-5,0,0,0,15.0,0:0,0,0,0,0.0,0:0,750000
8474774,Dalton,Prout,1990-03-13,D,R,2012-13,28,1,6,7,0.25,15,16,6.25,25,31128.0,18:31,0,0,0,0.0,51,40,6,15,-9,0,1,1,67.0,0:2,0,0,0,1592.0,0:56,666667
8474818,Jordie,Benn,1987-07-26,D,L,2012-13,26,1,5,6,0.23,-4,31,3.23,10,27013.0,17:18,0,0,0,0.0,25,31,8,21,-13,1,0,1,2303.0,1:28,0,0,0,3081.0,1:58,525000
8474837,Mark,Cundari,1990-04-23,D,L,2012-13,4,1,2,3,0.75,-2,8,12.5,2,4745.0,19:46,0,0,0,0.0,15,4,1,4,-3,1,1,2,398.0,1:39,0,0,0,219.0,0:54,541667
8474844,Carter,Bancks,1989-08-09,LW,L,2012-13,2,0,0,0,0.0,0,0,,0,1762.0,14:41,0,0,0,0.0,6,3,1,0,1,0,0,0,0.0,0:0,0,0,0,135.0,1:7,-111
8474849,Antoine,Roussel,1989-11-21,LW,L,2012-13,39,7,7,14,0.36,3,46,15.22,85,21995.0,9:23,30,25,55,54.55,75,16,12,8,4,0,0,0,196.0,0:5,0,0,0,1687.0,0:43,612500
8474850,Brandon,Mashinter,1988-09-20,LW,L,2012-13,4,0,0,0,0.0,-2,2,0.0,0,1420.0,5:55,1,0,1,100.0,7,1,0,1,-1,0,0,0,0.0,0:0,0,0,0,0.0,0:0,550000
8474870,Tyler,Johnson,1990-07-29,C,R,2012-13,14,3,3,6,0.43,3,11,27.27,4,10982.0,13:4,72,49,121,59.5,18,4,2,4,-2,0,0,0,1413.0,1:40,0,0,0,562.0,0:40,756667
8474873,Brian,Lashoff,1990-07-16,D,L,2012-13,31,1,4,5,0.16,-10,26,3.85,15,33077.0,17:47,0,0,0,0.0,44,43,3,11,-8,0,0,0,343.0,0:11,0,0,0,4348.0,2:20,525000
8474884,Mike,Hoffman,1989-11-24,LW,L,2012-13,3,0,0,0,0.0,-1,6,0.0,2,2217.0,12:19,2,0,2,100.0,8,2,1,1,0,0,0,0,0.0,0:0,0,0,0,0.0,0:0,610000
8474892,Eric,Wellwood,1990-03-06,LW,L,2012-13,4,0,0,0,0.0,0,2,0.0,0,2260.0,9:25,0,6,6,0.0,2,1,3,0,3,0,0,0,64.0,0:16,0,0,0,77.0,0:19,-111
8475060,Matt,Taormina,1986-10-20,D,L,2012-13,2,0,0,0,0.0,-1,0,,0,1997.0,16:38,0,0,0,0.0,5,3,0,0,0,0,0,0,93.0,0:46,0,0,0,0.0,0:0,700000
8475098,Tyler,Bozak,1986-03-19,C,R,2012-13,46,12,16,28,0.61,-1,61,19.67,6,56057.0,20:18,559,504,1063,52.59,65,23,37,37,0,4,5,9,8207.0,2:58,1,0,1,4531.0,1:38,1500000
8475118,Matt,Gilroy,1984-07-20,D,R,2012-13,15,0,0,0,0.0,-3,14,0.0,6,8601.0,9:33,0,0,0,0.0,6,6,3,9,-6,0,0,0,84.0,0:5,0,0,0,98.0,0:6,-111
8475147,Jordan,Schroeder,1990-09-29,LW,R,2012-13,31,3,6,9,0.29,0,28,10.71,4,25506.0,13:42,140,181,321,43.61,10,11,14,5,9,1,0,1,4598.0,2:28,0,0,0,4.0,0:0,900000
8475148,Tim,Erixon,1991-02-24,D,L,2012-13,31,0,5,5,0.16,4,21,0.0,14,29195.0,15:41,0,0,0,0.0,20,35,0,11,-11,0,2,2,1770.0,0:57,0,0,0,313.0,0:10,900000
8475149,Marcus,Johansson,1990-10-06,LW,L,2012-13,34,6,16,22,0.65,3,40,15.0,4,33835.0,16:35,40,47,87,45.98,14,6,15,19,-4,3,1,4,3375.0,1:39,0,1,1,1958.0,0:57,900000
8475150,Jordan,Caron,1990-11-02,RW,L,2012-13,17,1,2,3,0.18,1,20,5.0,4,9594.0,9:24,0,0,0,0.0,18,4,3,3,0,0,0,0,289.0,0:17,0,0,0,0.0,0:0,886667
8475151,Kyle,Palmieri,1991-02-01,RW,R,2012-13,42,10,11,21,0.5,2,92,10.87,9,31064.0,12:19,1,11,12,8.33,48,10,14,7,7,2,1,3,3433.0,1:21,0,0,0,1.0,0:0,900000
8475155,Simon,Despres,1991-07-27,D,L,2012-13,33,2,5,7,0.21,9,33,6.06,20,29930.0,15:6,0,0,0,0.0,48,31,4,16,-12,0,1,1,1374.0,0:41,0,0,0,1063.0,0:32,840000
8475158,Ryan,O'Reilly,1991-02-07,C,L,2012-13,29,6,14,20,0.69,-3,66,9.09,4,32204.0,18:30,241,215,456,52.85,7,14,34,10,24,3,3,6,4481.0,2:34,0,0,0,1580.0,0:54,5000000
8475160,Kyle,Clifford,1991-01-13,LW,L,2012-13,48,7,7,14,0.29,1,56,12.5,51,30546.0,10:36,1,8,9,11.11,155,12,12,8,4,0,0,0,815.0,0:16,0,0,0,1284.0,0:26,710000
8475161,Chris,Brown,1991-02-03,RW,R,2012-13,5,0,0,0,0.0,0,6,0.0,2,2291.0,7:38,0,0,0,0.0,6,0,1,0,1,0,0,0,473.0,1:34,0,0,0,0.0,0:0,853333
8475163,Alex,Chiasson,1990-10-01,RW,R,2012-13,7,6,1,7,1.0,3,13,46.15,0,5914.0,14:4,5,13,18,27.78,10,2,1,0,1,1,0,1,672.0,1:36,0,0,0,0.0,0:0,866667
8475164,Jakob,Silfverberg,1990-10-13,RW,R,2012-13,48,10,9,19,0.4,9,134,7.46,12,46739.0,16:13,5,8,13,38.46,38,13,20,23,-3,2,1,3,4868.0,1:41,1,0,1,3249.0,1:7,863333
8475165,Anton,Lander,1991-04-24,C,L,2012-13,11,0,1,1,0.09,-4,11,0.0,2,7278.0,11:1,27,28,55,49.09,7,2,5,7,-2,0,0,0,5.0,0:0,0,1,1,1160.0,1:45,880000
8475166,John,Tavares,1990-09-20,C,L,2012-13,48,28,19,47,0.98,-2,162,17.28,18,59831.0,20:46,459,471,930,49.35,33,22,27,44,-17,9,7,16,9845.0,3:25,0,0,0,386.0,0:8,5500000
8475167,Victor,Hedman,1990-12-18,D,L,2012-13,44,4,16,20,0.45,1,76,5.26,31,59821.0,22:39,0,0,0,0.0,56,84,17,42,-25,0,2,2,4581.0,1:44,0,0,0,6876.0,2:36,4000000
8475168,Matt,Duchene,1991-01-16,C,L,2012-13,47,17,26,43,0.91,-12,132,12.88,12,58996.0,20:55,488,405,893,54.65,48,47,44,24,20,2,7,9,7946.0,2:49,0,1,1,6299.0,2:14,3500000
8475169,Evander,Kane,1991-08-02,LW,L,2012-13,48,17,16,33,0.69,-3,190,8.95,80,58903.0,20:27,13,20,33,39.39,147,22,25,31,-6,2,2,4,6972.0,2:25,0,0,0,2861.0,0:59,5250000
8475170,Brayden,Schenn,1991-08-22,C,L,2012-13,47,8,18,26,0.55,-8,79,10.13,24,43792.0,15:31,206,247,453,45.47,109,22,19,11,8,2,8,10,6786.0,2:24,0,0,0,140.0,0:2,870000
8475171,Oliver,Ekman-Larsson,1991-07-17,D,L,2012-13,48,3,21,24,0.5,5,101,2.97,26,72277.0,25:5,0,0,0,0.0,73,40,21,23,-2,0,8,8,10567.0,3:40,0,0,0,8678.0,3:0,900000
8475172,Nazem,Kadri,1990-10-06,C,L,2012-13,48,18,26,44,0.92,15,107,16.82,23,46230.0,16:3,250,315,565,44.25,62,22,23,30,-7,5,3,8,6371.0,2:12,0,0,0,512.0,0:10,870000
8475174,Jared,Cowen,1991-01-25,D,L,2012-13,7,1,0,1,0.14,1,8,12.5,10,8521.0,20:17,0,0,0,0.0,26,10,4,4,0,0,0,0,596.0,1:25,0,0,0,819.0,1:57,870000
8475175,Magnus,Paajarvi,1991-04-12,LW,L,2012-13,42,9,7,16,0.38,-1,75,12.0,14,35608.0,14:7,4,8,12,33.33,24,23,9,10,-1,2,0,2,3565.0,1:24,1,0,1,1033.0,0:24,900000
8475176,Ryan,Ellis,1991-01-03,D,R,2012-13,32,2,4,6,0.19,-2,48,4.17,15,31448.0,16:22,0,0,0,0.0,22,29,8,12,-4,2,0,2,3783.0,1:58,0,0,0,120.0,0:3,840000
8475178,Zack,Kassian,1991-01-24,RW,R,2012-13,39,7,4,11,0.28,-7,49,14.29,51,31544.0,13:28,6,8,14,42.86,70,4,10,20,-10,2,1,3,3445.0,1:28,0,0,0,0.0,0:0,870000
8475179,Dmitry,Kulikov,1990-10-29,D,L,2012-13,34,3,7,10,0.29,-5,52,5.77,22,42792.0,20:58,0,0,0,0.0,84,49,9,23,-14,2,4,6,4909.0,2:24,0,0,0,2479.0,1:12,2500000
8475180,Peter,Holland,1991-01-14,C,L,2012-13,21,3,2,5,0.24,4,26,11.54,4,14603.0,11:35,89,114,203,43.84,17,8,7,8,-1,1,0,1,892.0,0:42,0,0,0,38.0,0:1,870000
8475181,Nick,Leddy,1991-03-20,D,L,2012-13,48,6,12,18,0.38,15,65,9.23,10,50168.0,17:25,0,0,0,0.0,38,39,12,18,-6,2,6,8,7629.0,2:38,0,0,0,21.0,0:0,900000
8475182,David,Rundblad,1990-10-08,D,R,2012-13,8,0,1,1,0.12,-5,9,0.0,0,6592.0,13:44,0,0,0,0.0,7,9,0,2,-2,0,0,0,1786.0,3:43,0,0,0,148.0,0:18,900000
8475184,Chris,Kreider,1991-04-30,LW,L,2012-13,23,2,1,3,0.13,-1,19,10.53,6,13954.0,10:6,0,1,1,0.0,36,6,2,3,-1,0,0,0,959.0,0:41,0,0,0,0.0,0:0,800000
8475185,Jacob,Josefson,1991-03-02,C,L,2012-13,22,1,2,3,0.14,-10,20,5.0,2,17136.0,12:58,114,122,236,48.31,12,7,10,5,5,0,0,0,987.0,0:44,0,0,0,2335.0,1:46,900000
8475186,John,Moore,1990-11-19,D,L,2012-13,30,1,6,7,0.23,4,29,3.45,7,23989.0,13:19,0,0,0,0.0,38,32,3,4,-1,0,0,0,644.0,0:21,0,0,0,659.0,0:21,840000
8475191,Reilly,Smith,1991-04-01,RW,L,2012-13,37,3,6,9,0.24,0,34,8.82,8,24236.0,10:55,3,1,4,75.0,18,6,14,13,1,0,0,0,2275.0,1:1,0,0,0,885.0,0:23,900000
8475192,Taylor,Beck,1991-05-13,LW,R,2012-13,16,3,4,7,0.44,0,39,7.69,2,15450.0,16:5,6,3,9,66.67,13,11,3,5,-2,1,1,2,1841.0,1:55,0,0,0,0.0,0:0,660000
8475193,Tomas,Tatar,1990-12-01,LW,L,2012-13,18,4,3,7,0.39,2,32,12.5,4,12284.0,11:22,1,0,1,100.0,9,5,5,2,3,1,0,1,1963.0,1:49,0,0,0,0.0,0:0,630000
8475196,Ben,Hanowski,1990-10-18,RW,L,2012-13,5,1,0,1,0.2,0,4,25.0,0,3988.0,13:17,0,2,2,0.0,8,0,0,1,-1,0,0,0,47.0,0:9,0,0,0,44.0,0:8,900000
8475197,Tyson,Barrie,1991-07-26,D,R,2012-13,32,2,11,13,0.41,-11,58,3.45,10,41437.0,21:34,0,0,0,0.0,31,24,13,15,-2,1,4,5,5060.0,2:38,0,0,0,2287.0,1:11,715000
8475199,Eric,Gelinas,1991-05-08,D,L,2012-13,1,0,0,0,0.0,-1,1,0.0,0,959.0,15:59,0,0,0,0.0,1,0,0,0,0,0,0,0,54.0,0:54,0,0,0,0.0,0:0,660000
8475200,Dmitry,Orlov,1991-07-23,D,L,2012-13,5,0,1,1,0.2,5,1,0.0,0,4483.0,14:56,0,0,0,0.0,2,4,2,2,0,0,0,0,246.0,0:49,0,0,0,67.0,0:13,690000
8475204,Brandon,Pirri,1991-04-10,RW,L,2012-13,1,0,0,0,0.0,0,2,0.0,0,1075.0,17:55,6,8,14,42.86,1,1,0,0,0,0,0,0,102.0,1:42,0,0,0,1.0,0:1,618333
8475206,Stefan,Elliott,1991-01-30,D,R,2012-13,18,1,3,4,0.22,-3,35,2.86,2,18905.0,17:30,0,0,0,0.0,10,18,8,6,2,0,1,1,1727.0,1:35,0,0,0,255.0,0:14,843333
8475209,Richard,Panik,1991-02-07,RW,L,2012-13,25,5,4,9,0.36,-2,34,14.71,4,16993.0,11:19,1,2,3,33.33,38,13,13,7,6,1,1,2,1197.0,0:47,0,0,0,40.0,0:1,740000
8475213,Drew,Shore,1991-01-29,C,R,2012-13,43,3,10,13,0.3,-10,96,3.12,14,40782.0,15:48,212,231,443,47.86,37,18,19,10,9,1,2,3,2518.0,0:58,1,0,1,2261.0,0:52,900000
8475214,Jeremy,Morin,1991-04-16,LW,R,2012-13,3,1,1,2,0.67,1,7,14.29,0,2344.0,13:1,0,4,4,0.0,3,1,0,1,-1,0,0,0,102.0,0:34,0,0,0,0.0,0:0,735000
8475218,Mattias,Ekholm,1990-05-24,D,L,2012-13,1,0,0,0,0.0,-1,0,,0,965.0,16:5,0,0,0,0.0,0,0,1,3,-2,0,0,0,63.0,1:3,0,0,0,0.0,0:0,900000
8475220,Marcus,Foligno,1991-08-10,LW,L,2012-13,47,5,13,18,0.38,-4,55,9.09,41,38429.0,13:37,45,30,75,60.0,108,16,18,11,7,1,3,4,4345.0,1:32,0,1,1,394.0,0:8,826667
8475222,Sami,Vatanen,1991-06-03,D,R,2012-13,8,2,0,2,0.25,3,6,33.33,0,7593.0,15:49,0,0,0,0.0,2,13,2,1,1,1,0,1,1240.0,2:35,0,0,0,33.0,0:4,785000
8475225,Craig,Smith,1989-09-05,RW,R,2012-13,44,4,8,12,0.27,-11,83,4.82,20,36582.0,13:51,79,121,200,39.5,39,13,21,17,4,2,5,7,5008.0,1:53,0,0,0,1.0,0:0,715000
8475231,Casey,Cizikas,1991-02-27,C,L,2012-13,45,6,9,15,0.33,0,45,13.33,14,29124.0,10:47,144,132,276,52.17,75,21,21,6,15,0,1,1,89.0,0:1,0,0,0,1932.0,0:42,793333
8475233,David,Savard,1990-10-22,D,R,2012-13,4,0,0,0,0.0,-3,1,0.0,0,3168.0,13:12,0,0,0,0.0,4,2,0,1,-1,0,0,0,20.0,0:5,0,0,0,171.0,0:42,740167
8475236,Cody,Eakin,1991-05-24,C,L,2012-13,48,7,17,24,0.5,1,67,10.45,31,43444.0,15:5,304,322,626,48.56,71,29,27,25,2,3,0,3,3434.0,1:11,0,0,0,4947.0,1:43,571667
8475248,Alexander,Urbom,1990-12-20,D,L,2012-13,1,0,0,0,0.0,-1,0,,0,851.0,14:11,0,0,0,0.0,1,1,1,2,-1,0,0,0,0.0,0:0,0,0,0,21.0,0:21,563333
8475254,Gabriel,Dumont,1990-10-06,C,R,2012-13,10,1,2,3,0.3,1,20,5.0,13,5807.0,9:40,29,17,46,63.04,21,6,2,0,2,0,0,0,40.0,0:4,0,0,0,166.0,0:16,571667
8475264,Roman,Horak,1991-05-21,C,L,2012-13,20,2,5,7,0.35,-5,28,7.14,2,17433.0,14:31,93,112,205,45.37,18,13,12,5,7,0,0,0,1222.0,1:1,0,1,1,1070.0,0:53,613333
8475266,Tomas,Vincour,1990-11-19,C,R,2012-13,17,2,2,4,0.24,-1,12,16.67,4,9038.0,8:51,0,5,5,0.0,24,2,4,7,-3,0,0,0,140.0,0:8,0,0,0,0.0,0:0,621667
8475268,Gabriel,Bourque,1990-09-23,LW,L,2012-13,34,11,5,16,0.47,6,50,22.0,4,32298.0,15:49,4,2,6,66.67,39,23,13,10,3,3,0,3,2164.0,1:3,1,0,1,1767.0,0:51,618333
8475283,Lane,MacDermid,1989-08-25,LW,L,2012-13,9,2,0,2,0.22,1,4,50.0,19,2478.0,4:35,0,0,0,0.0,13,0,0,1,-1,0,0,0,0.0,0:0,0,0,0,0.0,0:0,600000
8475304,Scott,Timmins,1989-09-11,C,L,2012-13,5,0,0,0,0.0,-2,6,0.0,4,3175.0,10:35,15,16,31,48.39,6,5,1,3,-2,0,0,0,17.0,0:3,0,0,0,516.0,1:43,581667
8475314,Anders,Lee,1990-07-03,LW,L,2012-13,2,1,1,2,1.0,-3,2,50.0,0,984.0,8:12,0,2,2,0.0,0,2,0,1,-1,0,0,0,0.0,0:0,0,0,0,0.0,0:0,900000
8475323,Marcus,Kruger,1990-05-27,C,L,2012-13,47,4,9,13,0.28,3,50,8.0,24,39947.0,14:9,228,265,493,46.25,12,29,24,6,18,0,2,2,794.0,0:16,0,0,0,7089.0,2:30,735000
8475325,Jordan,Nolan,1989-06-23,C,L,2012-13,44,2,4,6,0.14,-5,23,8.7,46,22369.0,8:28,0,8,8,0.0,72,5,7,10,-3,0,0,0,282.0,0:6,0,0,0,13.0,0:0,531667
8475342,Oliver,Lauridsen,1989-03-24,D,L,2012-13,15,2,1,3,0.2,0,14,14.29,34,13621.0,15:8,0,0,0,0.0,36,24,0,12,-12,0,0,0,15.0,0:1,0,0,0,759.0,0:50,650000
8475395,Matthew,Konan,1991-09-03,D,L,2012-13,2,0,0,0,0.0,0,4,0.0,0,1911.0,15:55,0,0,0,0.0,5,2,0,1,-1,0,0,0,0.0,0:0,0,0,0,56.0,0:28,717500
8475430,Brandon,Manning,1990-06-04,D,L,2012-13,6,0,2,2,0.33,4,5,0.0,0,5329.0,14:48,0,0,0,0.0,15,4,2,3,-1,0,0,0,0.0,0:0,0,0,0,24.0,0:4,715000
8475455,Brenden,Dillon,1990-11-13,D,L,2012-13,48,3,5,8,0.17,1,75,4.0,65,61574.0,21:22,0,0,0,0.0,133,74,8,20,-12,0,0,0,1160.0,0:24,0,0,0,7443.0,2:35,743333
8475462,Radko,Gudas,1990-06-05,D,R,2012-13,22,2,3,5,0.23,3,31,6.45,38,22430.0,16:59,0,0,0,0.0,87,28,5,17,-12,0,0,0,224.0,0:10,0,0,0,1103.0,0:50,600000
8475598,Ryan,Stanton,1989-07-20,D,L,2012-13,1,0,0,0,0.0,1,1,0.0,2,1025.0,17:5,0,0,0,0.0,1,2,0,0,0,0,0,0,0.0,0:0,0,0,0,44.0,0:44,592500
8475613,Nate,Prosser,1986-05-07,D,R,2012-13,17,0,0,0,0.0,4,5,0.0,4,11476.0,11:15,0,0,0,0.0,17,22,4,5,-1,0,0,0,23.0,0:1,0,0,0,751.0,0:44,825000
8475619,Aaron,Volpatti,1985-05-30,LW,L,2012-13,33,1,1,2,0.06,-2,21,4.76,35,16508.0,8:20,1,3,4,25.0,80,10,4,5,-1,0,0,0,228.0,0:6,0,0,0,4.0,0:0,600000
8475625,Matt,Irwin,1987-11-29,D,L,2012-13,38,6,6,12,0.32,-1,79,7.59,10,43550.0,19:6,0,0,0,0.0,39,65,16,29,-13,4,1,5,3993.0,1:45,0,0,0,436.0,0:11,650000
8475637,Bobby,Butler,1987-04-26,RW,R,2012-13,34,4,7,11,0.32,-8,41,9.76,4,22039.0,10:48,2,3,5,40.0,15,4,7,4,3,1,3,4,3566.0,1:44,0,0,0,39.0,0:1,1050000
8475640,Erik,Gustafsson,1988-12-15,D,L,2012-13,27,3,5,8,0.3,-1,36,8.33,2,32639.0,20:8,0,1,1,0.0,15,39,7,16,-9,0,1,1,2573.0,1:35,0,0,0,2123.0,1:18,-111
8475650,Brandon,Bollig,1987-01-31,LW,L,2012-13,25,0,0,0,0.0,-1,34,0.0,51,12019.0,8:0,0,3,3,0.0,41,6,1,0,1,0,0,0,100.0,0:4,0,0,0,55.0,0:2,575000
8475661,Dave,Dziurzynski,1989-10-06,LW,L,2012-13,12,2,0,2,0.17,-1,20,10.0,13,9035.0,12:32,3,1,4,75.0,29,3,4,2,2,0,0,0,174.0,0:14,0,0,0,8.0,0:0,600000
8475671,Matt,Fraser,1990-05-20,RW,L,2012-13,12,1,2,3,0.25,0,17,5.88,0,8490.0,11:47,0,0,0,0.0,13,8,3,2,1,0,0,0,549.0,0:45,0,0,0,0.0,0:0,560000
8475690,Christopher,Tanev,1989-12-20,D,R,2012-13,38,2,5,7,0.18,4,20,10.0,10,39419.0,17:17,0,0,0,0.0,14,61,13,14,-1,0,0,0,256.0,0:6,0,0,0,3729.0,1:38,900000
8475692,Mats,Zuccarello,1987-09-01,RW,L,2012-13,15,3,5,8,0.53,10,27,11.11,8,14782.0,16:25,0,4,4,0.0,27,15,6,5,1,0,1,1,2171.0,2:24,0,1,1,9.0,0:0,700000
8475722,Jason,Zucker,1992-01-16,LW,L,2012-13,20,4,1,5,0.25,4,34,11.76,8,13518.0,11:15,0,1,1,0.0,11,5,4,7,-3,0,0,0,391.0,0:19,0,0,0,0.0,0:0,771667
8475726,Tyler,Toffoli,1992-04-24,C,R,2012-13,10,2,3,5,0.5,3,20,10.0,2,7187.0,11:58,0,0,0,0.0,4,1,3,2,1,1,1,2,933.0,1:33,0,0,0,0.0,0:0,716667
8475727,Ryan,Spooner,1992-01-30,C,L,2012-13,4,0,0,0,0.0,0,4,0.0,0,2189.0,9:7,11,13,24,45.83,1,2,0,1,-1,0,0,0,389.0,1:37,0,0,0,3.0,0:0,760000
8475728,Johan,Larsson,1992-07-25,C,L,2012-13,1,0,0,0,0.0,0,2,0.0,0,842.0,14:2,0,0,0,0.0,2,1,0,0,0,0,0,0,8.0,0:8,0,0,0,0.0,0:0,763333
8475733,Max,Reinhart,1992-02-04,C,L,2012-13,11,1,2,3,0.27,-3,26,3.85,4,9515.0,14:25,34,57,91,37.36,8,2,4,0,4,0,1,1,520.0,0:47,0,0,0,686.0,1:2,618333
8475745,Charlie,Coyle,1992-03-02,C,R,2012-13,37,8,6,14,0.38,3,50,16.0,28,33439.0,15:3,9,17,26,34.62,50,9,14,9,5,1,0,1,1707.0,0:46,0,0,0,878.0,0:23,900000
8475749,Christian,Thomas,1992-05-26,LW,R,2012-13,1,0,0,0,0.0,0,2,0.0,0,766.0,12:46,0,0,0,0.0,3,0,0,0,0,0,0,0,95.0,1:35,0,0,0,0.0,0:0,808333
8475753,Justin,Faulk,1992-03-20,D,R,2012-13,38,5,10,15,0.39,1,76,6.58,15,54738.0,24:0,0,0,0,0.0,63,47,24,26,-2,1,2,3,6033.0,2:38,1,0,1,6803.0,2:59,840000
8475755,Alex,Petrovic,1992-03-03,D,R,2012-13,6,0,0,0,0.0,-8,5,0.0,25,6761.0,18:46,0,0,0,0.0,10,4,0,6,-6,0,0,0,106.0,0:17,0,0,0,247.0,0:41,795000
8475758,Devante,Smith-Pelly,1992-06-14,RW,R,2012-13,7,0,0,0,0.0,-4,5,0.0,0,3778.0,8:59,0,0,0,0.0,14,4,2,1,1,0,0,0,0.0,0:0,0,0,0,83.0,0:11,720000
8475760,Nick,Bjugstad,1992-07-17,C,R,2012-13,11,1,0,1,0.09,-8,17,5.88,2,10039.0,15:12,53,79,132,40.15,17,2,3,2,1,0,0,0,653.0,0:59,0,0,0,54.0,0:4,900000
8475761,Beau,Bennett,1991-11-27,RW,R,2012-13,26,3,11,14,0.54,7,30,10.0,6,19192.0,12:18,1,3,4,25.0,28,9,10,7,3,1,4,5,2596.0,1:39,0,0,0,4.0,0:0,900000
8475764,Cam,Fowler,1991-12-05,D,L,2012-13,37,1,10,11,0.3,-4,50,2.0,4,45375.0,20:26,0,0,0,0.0,19,41,5,30,-25,1,5,6,5577.0,2:30,0,0,0,1099.0,0:29,900000
8475765,Vladimir,Tarasenko,1991-12-13,RW,L,2012-13,38,8,11,19,0.5,1,75,10.67,10,30575.0,13:24,1,0,1,100.0,28,7,14,6,8,3,2,5,4069.0,1:47,0,0,0,55.0,0:1,900000
8475766,Austin,Watson,1992-01-13,LW,R,2012-13,6,1,0,1,0.17,-2,4,25.0,0,4574.0,12:42,19,25,44,43.18,2,2,3,3,0,0,0,0,367.0,1:1,0,0,0,182.0,0:30,900000
8475768,Jaden,Schwartz,1992-06-25,LW,L,2012-13,45,7,6,13,0.29,-4,50,14.0,4,33664.0,12:28,15,12,27,55.56,34,18,21,9,12,0,0,0,759.0,0:16,0,0,0,465.0,0:10,830000
8475769,Quinton,Howden,1992-01-21,C,L,2012-13,18,0,0,0,0.0,-11,22,0.0,2,11292.0,10:27,1,3,4,25.0,21,6,9,1,8,0,0,0,37.0,0:2,0,0,0,128.0,0:7,870000
8475770,Emerson,Etem,1992-06-16,RW,L,2012-13,38,3,7,10,0.26,7,48,6.25,9,26133.0,11:27,2,3,5,40.0,43,20,11,5,6,0,0,0,307.0,0:8,0,2,2,2390.0,1:2,870000
8475772,Riley,Sheahan,1991-12-07,C,L,2012-13,1,0,0,0,0.0,0,1,0.0,0,407.0,6:47,0,1,1,0.0,0,0,1,0,1,0,0,0,0.0,0:0,0,0,0,0.0,0:0,785000
8475775,Tye,McGinn,1990-07-29,LW,L,2012-13,18,3,2,5,0.28,0,33,9.09,19,13737.0,12:43,0,0,0,0.0,19,1,6,2,4,0,0,0,1814.0,1:40,0,0,0,16.0,0:0,775000
8475784,Jeff,Skinner,1992-05-16,LW,L,2012-13,42,13,11,24,0.57,-21,159,8.18,26,46528.0,18:27,21,23,44,47.73,21,11,37,17,20,5,4,9,7026.0,2:47,0,0,0,238.0,0:5,900000
8475788,Alexander,Burmistrov,1991-10-21,C,L,2012-13,44,4,6,10,0.23,0,55,7.27,14,41289.0,15:38,142,159,301,47.18,106,16,22,17,5,0,0,0,2366.0,0:53,0,0,0,4018.0,1:31,900000
8475790,Erik,Gudbranson,1992-01-07,D,R,2012-13,32,0,4,4,0.12,-22,49,0.0,47,35997.0,18:44,0,0,0,0.0,80,32,2,16,-14,0,1,1,1252.0,0:39,0,0,0,3130.0,1:37,900000
8475791,Taylor,Hall,1991-11-14,LW,L,2012-13,45,16,34,50,1.11,5,154,10.39,33,50275.0,18:37,29,24,53,54.72,24,20,31,29,2,4,10,14,8763.0,3:14,0,0,0,147.0,0:3,900000
8475792,Brett,Connolly,1992-05-02,RW,R,2012-13,5,1,0,1,0.2,-3,10,10.0,0,3082.0,10:16,4,1,5,80.0,2,1,4,0,4,1,0,1,551.0,1:50,0,0,0,0.0,0:0,900000
8475793,Ryan,Johansen,1992-07-31,C,R,2012-13,40,5,7,12,0.3,-7,84,5.95,12,38602.0,16:5,272,257,529,51.42,42,14,15,6,9,0,1,1,5568.0,2:19,0,0,0,233.0,0:5,870000
8475794,Tyler,Seguin,1992-01-31,C,R,2012-13,48,16,16,32,0.67,23,161,9.94,16,49004.0,17:0,22,23,45,48.89,25,6,18,30,-12,4,2,6,6324.0,2:11,0,0,0,22.0,0:0,900000
8475796,Mark,Pysyk,1992-01-11,D,R,2012-13,19,1,4,5,0.26,-7,21,4.76,0,18557.0,16:16,0,0,0,0.0,6,9,3,9,-6,1,0,1,934.0,0:49,0,0,0,420.0,0:22,900000
8475797,Jarred,Tinordi,1992-02-20,D,L,2012-13,8,0,2,2,0.25,5,5,0.0,2,5622.0,11:42,0,0,0,0.0,14,6,0,2,-2,0,0,0,0.0,0:0,0,0,0,434.0,0:54,870000
8475798,Mikael,Granlund,1992-02-26,RW,L,2012-13,27,2,6,8,0.3,-4,36,5.56,6,21349.0,13:10,97,109,206,47.09,15,8,8,10,-2,0,2,2,2804.0,1:43,0,0,0,11.0,0:0,900000
8475848,Brendan,Gallagher,1992-05-06,RW,R,2012-13,44,15,13,28,0.64,10,117,12.82,33,36598.0,13:51,8,17,25,32.0,44,33,17,8,9,3,1,4,6214.0,2:21,0,0,0,39.0,0:0,685000
8475893,Joonas,Rask,1990-03-24,C,R,2012-13,2,0,1,1,0.5,-1,0,,0,961.0,8:0,0,0,0,0.0,0,0,0,0,0,0,0,0,0.0,0:0,0,0,0,0.0,0:0,-111
8475913,Mark,Stone,1992-05-13,RW,R,2012-13,4,0,0,0,0.0,-1,3,0.0,2,2401.0,10:0,1,0,1,100.0,10,0,2,2,0,0,0,0,97.0,0:24,0,0,0,0.0,0:0,603333
8475917,Jason,Akeson,1990-06-03,RW,R,2012-13,1,1,0,1,1.0,2,2,50.0,0,743.0,12:23,0,0,0,0.0,0,0,2,0,2,0,0,0,0.0,0:0,0,0,0,0.0,0:0,715000
8475958,Michael,Sgarbossa,1992-07-25,C,L,2012-13,6,0,0,0,0.0,-3,6,0.0,4,3731.0,10:21,9,16,25,36.0,4,1,1,1,0,0,0,0,704.0,1:57,0,0,0,0.0,0:0,556667
8476043,Ben,Street,1987-02-13,C,L,2012-13,6,0,1,1,0.17,-1,13,0.0,0,4899.0,13:36,24,27,51,47.06,8,2,3,0,3,0,0,0,171.0,0:28,0,1,1,364.0,1:0,575000
8476062,Mark,Arcobello,1988-08-12,RW,R,2012-13,1,0,0,0,0.0,0,0,,0,1095.0,18:15,3,7,10,30.0,0,2,0,1,-1,0,0,0,190.0,3:10,0,0,0,5.0,0:5,627500
8476116,Ryan,Garbutt,1985-08-12,C,L,2012-13,36,3,7,10,0.28,1,59,5.08,32,21431.0,9:55,7,10,17,41.18,67,9,11,3,8,0,0,0,368.0,0:10,0,0,0,1522.0,0:42,575000
8476158,Harry,Zolnierczyk,1987-09-01,LW,L,2012-13,7,0,1,1,0.14,0,4,0.0,36,3095.0,7:22,0,0,0,0.0,7,3,1,0,1,0,0,0,21.0,0:3,0,0,0,0.0,0:0,600000
8476162,Steve,Oleksy,1986-02-04,D,R,2012-13,28,1,8,9,0.32,9,25,4.0,33,29010.0,17:16,0,0,0,0.0,58,52,5,14,-9,0,0,0,200.0,0:7,0,0,0,2785.0,1:39,541667
8476177,Matt,Read,1986-06-14,RW,R,2012-13,42,11,13,24,0.57,1,72,15.28,2,45404.0,18:1,14,34,48,29.17,49,32,17,16,1,1,2,3,4656.0,1:50,0,0,0,5212.0,2:4,900000
8476195,Cory,Conacher,1989-12-14,C,L,2012-13,47,11,18,29,0.62,3,67,16.42,20,39406.0,13:58,4,11,15,26.67,39,9,10,20,-10,1,3,4,5719.0,2:1,0,0,0,123.0,0:2,871250
8476205,Stephane,Da Costa,1989-07-11,C,R,2012-13,9,1,1,2,0.22,-3,15,6.67,0,6404.0,11:51,39,25,64,60.94,8,1,1,4,-3,0,1,1,1208.0,2:14,0,0,0,0.0,0:0,800000
8476206,Andy,Miele,1988-04-15,C,L,2012-13,1,0,0,0,0.0,1,0,,0,542.0,9:2,2,1,3,66.67,2,0,0,0,0,0,0,0,0.0,0:0,0,0,0,0.0,0:0,850500
8476244,Raphael,Diaz,1986-01-09,D,R,2012-13,23,1,13,14,0.61,4,34,2.94,6,28367.0,20:33,0,0,0,0.0,11,44,6,17,-11,0,8,8,4683.0,3:23,0,0,0,3145.0,2:16,1225000
8476292,Ondrej,Palat,1991-03-28,LW,L,2012-13,14,2,2,4,0.29,5,16,12.5,0,9856.0,11:44,0,6,6,0.0,28,1,4,1,3,0,0,0,268.0,0:19,0,0,0,653.0,0:46,575000
8476302,Frank,Corrado,1993-03-26,D,R,2012-13,3,0,0,0,0.0,-1,4,0.0,0,3493.0,19:24,0,0,0,0.0,8,5,1,3,-2,0,0,0,228.0,1:16,0,0,0,165.0,0:55,591667
8476381,Andrew,Shaw,1991-07-20,RW,R,2012-13,48,9,6,15,0.31,6,64,14.06,38,43348.0,15:3,201,256,457,43.98,70,14,12,10,2,2,0,2,5877.0,2:2,0,0,0,235.0,0:4,573333
8476419,Jean-Gabriel,Pageau,1992-11-11,C,R,2012-13,9,2,2,4,0.44,3,14,14.29,0,6208.0,11:29,40,42,82,48.78,11,3,1,2,-1,0,0,0,47.0,0:5,0,0,0,447.0,0:49,613333
8476436,Dmitrij,Jaskin,1993-03-23,RW,L,2012-13,2,0,0,0,0.0,-1,2,0.0,0,899.0,7:29,0,0,0,0.0,2,0,1,0,1,0,0,0,0.0,0:0,0,0,0,0.0,0:0,772500
8476438,Brandon,Saad,1992-10-27,LW,L,2012-13,46,10,17,27,0.59,17,98,10.2,12,45433.0,16:27,17,29,46,36.96,41,12,26,15,11,0,3,3,4230.0,1:31,1,0,1,2375.0,0:51,764167
8476454,Ryan,Nugent-Hopkins,1993-04-12,C,L,2012-13,40,4,20,24,0.6,3,78,5.13,8,45277.0,18:51,226,325,551,41.02,27,27,22,11,11,2,9,11,7294.0,3:2,0,0,0,539.0,0:13,925000
8476455,Gabriel,Landeskog,1992-11-23,LW,L,2012-13,36,9,8,17,0.47,-4,109,8.26,22,41744.0,19:19,6,12,18,33.33,86,32,21,15,6,0,2,2,5334.0,2:28,3,0,3,4037.0,1:52,925000
8476456,Jonathan,Huberdeau,1993-06-04,LW,L,2012-13,48,14,17,31,0.65,-15,112,12.5,18,48751.0,16:55,11,22,33,33.33,33,19,17,28,-11,2,7,9,6809.0,2:21,0,0,0,84.0,0:1,894167
8476457,Adam,Larsson,1992-11-12,D,R,2012-13,37,0,6,6,0.16,4,30,0.0,12,40185.0,18:6,0,0,0,0.0,37,49,17,22,-5,0,0,0,341.0,0:9,0,0,0,2551.0,1:8,925000
8476459,Mika,Zibanejad,1993-04-18,C,R,2012-13,42,7,13,20,0.48,9,90,7.78,6,34187.0,13:33,159,184,343,46.36,82,19,12,7,5,3,1,4,4834.0,1:55,0,0,0,46.0,0:1,894167
8476460,Mark,Scheifele,1993-03-15,C,R,2012-13,4,0,0,0,0.0,0,6,0.0,0,2766.0,11:31,10,4,14,71.43,4,0,0,0,0,0,0,0,163.0,0:40,0,0,0,0.0,0:0,894167
8476461,Sean,Couturier,1992-12-07,C,L,2012-13,46,4,11,15,0.33,-8,75,5.33,10,43854.0,15:53,243,310,553,43.94,31,27,26,19,7,0,4,4,4127.0,1:29,0,0,0,6958.0,2:31,925000
8476462,Dougie,Hamilton,1993-06-17,D,R,2012-13,42,5,11,16,0.38,4,83,6.02,14,43163.0,17:7,0,0,0,0.0,59,33,8,27,-19,2,2,4,4841.0,1:55,0,0,0,705.0,0:16,925000
8476463,Jonas,Brodin,1993-07-12,D,L,2012-13,45,2,9,11,0.24,3,51,3.92,10,62675.0,23:12,0,0,0,0.0,17,60,18,15,3,1,1,2,3530.0,1:18,0,0,0,5433.0,2:0,925000
8476465,Ryan,Murphy,1993-03-31,D,R,2012-13,4,0,0,0,0.0,-4,7,0.0,2,5055.0,21:3,0,0,0,0.0,2,9,1,0,1,0,0,0,431.0,1:47,0,0,0,208.0,0:52,894167
8476466,Sven,Baertschi,1992-10-05,LW,L,2012-13,20,3,7,10,0.5,0,28,10.71,6,16087.0,13:24,1,0,1,100.0,12,5,12,5,7,0,0,0,1825.0,1:31,0,0,0,213.0,0:10,894167
8476467,Jamie,Oleksiak,1992-12-21,D,L,2012-13,16,0,2,2,0.12,-5,11,0.0,14,14240.0,14:50,0,0,0,0.0,32,18,2,8,-6,0,0,0,0.0,0:0,0,0,0,856.0,0:53,894167
8476468,J.T.,Miller,1993-03-14,C,L,2012-13,26,2,2,4,0.15,-7,43,4.65,8,21097.0,13:31,63,55,118,53.39,47,12,4,5,-1,1,1,2,2418.0,1:33,0,0,0,14.0,0:0,894167
8476470,Nathan,Beaulieu,1992-12-05,D,L,2012-13,6,0,2,2,0.33,5,8,0.0,0,5533.0,15:22,0,0,0,0.0,3,4,1,4,-3,0,0,0,824.0,2:17,0,0,0,0.0,0:0,925000
8476482,Nicklas,Jensen,1993-03-06,RW,L,2012-13,2,0,0,0,0.0,-1,0,,0,1662.0,13:51,0,0,0,0.0,2,0,1,0,1,0,0,0,46.0,0:23,0,0,0,0.0,0:0,894167
8476483,Rickard,Rakell,1993-05-05,C,R,2012-13,4,0,0,0,0.0,-2,3,0.0,0,2148.0,8:57,10,11,21,47.62,4,0,0,0,0,0,0,0,24.0,0:6,0,0,0,0.0,0:0,925000
8476539,Jonathan,Marchessault,1990-12-27,C,R,2012-13,2,0,0,0,0.0,-1,0,,0,1313.0,10:56,0,0,0,0.0,1,0,1,0,1,0,0,0,106.0,0:53,0,0,0,0.0,0:0,925000
8476792,Torey,Krug,1991-04-12,D,L,2012-13,1,0,1,1,1.0,-1,0,,0,947.0,15:47,0,0,0,0.0,0,1,0,0,0,0,1,1,194.0,3:14,0,0,0,95.0,1:35,916667
8476799,Cameron,Schilling,1988-10-07,D,L,2012-13,1,0,0,0,0.0,-1,0,,0,718.0,11:58,0,0,0,0.0,0,1,0,0,0,0,0,0,0.0,0:0,0,0,0,4.0,0:4,925000
8476807,Matt,Tennyson,1990-04-23,D,R,2012-13,4,0,2,2,0.5,2,8,0.0,2,3771.0,15:42,0,0,0,0.0,4,2,0,2,-2,0,0,0,10.0,0:2,0,0,0,25.0,0:6,925000
8476808,Brian,Flynn,1988-07-26,C,R,2012-13,26,6,5,11,0.42,6,49,12.24,0,22901.0,14:40,24,36,60,40.0,10,20,9,3,6,0,0,0,874.0,0:33,1,0,1,1565.0,1:0,925000
8476819,Jeremy,Welsh,1988-04-30,C,L,2012-13,5,0,1,1,0.2,1,4,0.0,0,1753.0,5:50,15,5,20,75.0,6,0,1,0,1,0,0,0,0.0,0:0,0,0,0,0.0,0:0,850000
8476834,Roman,Cervenka,1985-12-10,C,L,2012-13,39,9,8,17,0.44,-13,51,17.65,14,30749.0,13:8,58,67,125,46.4,7,4,8,8,0,1,3,4,3805.0,1:37,0,0,0,30.0,0:0,-111
8476835,Daniel,Bang,1987-04-19,LW,L,2012-13,8,0,2,2,0.25,-2,13,0.0,0,6192.0,12:54,0,0,0,0.0,12,0,3,0,3,0,0,0,60.0,0:7,0,0,0,180.0,0:22,-111
8476849,Harri,Pesonen,1988-08-06,C,L,2012-13,4,0,0,0,0.0,-1,3,0.0,2,2204.0,9:11,0,0,0,0.0,4,0,0,0,0,0,0,0,0.0,0:0,0,0,0,0.0,0:0,-111
8476851,Alex,Galchenyuk,1994-02-12,LW,L,2012-13,48,9,18,27,0.56,14,79,11.39,20,35484.0,12:19,59,79,138,42.75,23,25,9,8,1,0,1,1,3019.0,1:2,0,0,0,3.0,0:0,925000
8476855,Nail,Yakupov,1993-10-06,RW,L,2012-13,48,17,14,31,0.65,-4,81,20.99,24,41938.0,14:33,0,6,6,0.0,41,14,18,23,-5,6,4,10,7147.0,2:28,0,0,0,15.0,0:0,925000
8476870,Stefan,Matteau,1994-02-23,C,L,2012-13,17,1,2,3,0.18,-1,22,4.55,6,9371.0,9:11,0,4,4,0.0,25,1,5,4,1,0,0,0,17.0,0:1,0,0,0,0.0,0:0,842500
8476872,Scott,Laughton,1994-05-30,C,L,2012-13,5,0,0,0,0.0,0,10,0.0,0,3455.0,11:31,19,24,43,44.19,10,1,0,0,0,0,0,0,143.0,0:28,0,0,0,14.0,0:2,925000
8476887,Filip,Forsberg,1994-08-13,LW,R,2012-13,5,0,1,1,0.2,-5,14,0.0,0,4643.0,15:28,0,1,1,0.0,3,0,3,3,0,0,0,0,601.0,2:0,0,0,0,0.0,0:0,925000
8476888,Mikhail,Grigorenko,1994-05-16,C,L,2012-13,25,1,4,5,0.2,-1,31,3.23,0,15353.0,10:14,57,92,149,38.26,2,2,7,6,1,0,0,0,937.0,0:37,0,0,0,11.0,0:0,925000
8477059,Damien,Brunner,1986-03-09,RW,R,2012-13,44,12,14,26,0.59,-6,123,9.76,12,41154.0,15:35,2,3,5,40.0,20,2,22,14,8,3,7,10,7866.0,2:58,0,0,0,22.0,0:0,-111
8477205,Andrej,Sustr,1990-11-29,D,R,2012-13,2,0,0,0,0.0,1,2,0.0,0,1286.0,10:43,0,0,0,0.0,0,1,0,2,-2,0,0,0,37.0,0:18,0,0,0,0.0,0:0,925000
8477215,Danny,DeKeyser,1990-03-07,D,L,2012-13,11,0,1,1,0.09,4,15,0.0,2,11912.0,18:2,0,0,0,0.0,9,9,5,6,-1,0,0,0,389.0,0:35,0,0,0,1210.0,1:50,925000
8477243,Drew,LeBlanc,1989-06-29,C,L,2012-13,2,0,0,0,0.0,-3,3,0.0,0,1600.0,13:20,9,9,18,50.0,0,0,1,0,1,0,0,0,110.0,0:55,0,0,0,0.0,0:0,1486598
8477244,Chad,Ruhwedel,1990-05-07,D,R,2012-13,7,0,0,0,0.0,0,8,0.0,0,5963.0,14:11,0,0,0,0.0,7,8,2,0,2,0,0,0,2.0,0:0,0,0,0,69.0,0:9,925000
