player_id,firstName,lastName,birthDate,primaryPosition,shootsCatches,season,gamesPlayed,goals,assists,points,pointsPerGame,plusMinus,shots,shootingPercentage,penaltyMinutes,timeOnIce,avgTimeOnIce,faceOffWins,faceOffLosses,faceOffTaken,faceOffPercentage,hits,blocks,takeaways,giveaways,turnoverDifferential,powerPlayGoals,powerPlayAssists,powerPlayPoints,powerPlayTimeOnIce,avgPowerPlayTimeOnIce,shortHandedGoals,shortHandedAssists,shortHandedPoints,shortHandedTimeOnIce,avgShortHandedTimeOnIce,salary
8448208,Jaromir,Jagr,1972-02-15,RW,L,2013-14,82,24,43,67,0.82,16,231,10.39,46,94259.0,19:9,0,2,2,0.0,4,9,36,59,-23,5,12,17,14260.0,2:53,0,0,0,246.0,0:3,2000000
8457981,Teemu,Selanne,1970-07-03,RW,R,2013-14,64,9,18,27,0.42,8,111,8.11,12,54245.0,14:7,46,60,106,43.4,15,8,16,31,-15,4,4,8,9223.0,2:24,0,0,0,68.0,0:1,2000000
8458537,Ray,Whitney,1972-05-08,LW,R,2013-14,69,9,23,32,0.46,-6,124,7.26,14,57808.0,13:57,1,1,2,50.0,14,16,25,43,-18,3,12,15,11904.0,2:52,0,0,0,16.0,0:0,4500000
8458951,Sergei,Gonchar,1974-04-13,D,L,2013-14,76,2,20,22,0.29,-12,89,2.25,20,80302.0,17:36,0,0,0,0.0,71,81,10,33,-23,1,13,14,11300.0,2:28,0,0,0,1105.0,0:14,5000000
8459442,Saku,Koivu,1974-11-23,C,L,2013-14,65,11,18,29,0.45,3,81,13.58,46,58689.0,15:2,538,529,1067,50.42,29,30,25,34,-9,0,0,0,2598.0,0:39,1,3,4,6126.0,1:34,-111
8459444,Todd,Bertuzzi,1975-02-02,RW,L,2013-14,59,9,7,16,0.27,-17,100,9.0,40,51872.0,14:39,9,9,18,50.0,72,14,13,27,-14,6,1,7,10126.0,2:51,0,0,0,20.0,0:0,2075000
8459628,Hal,Gill,1975-04-06,D,L,2013-14,6,0,0,0,0.0,0,1,0.0,2,5343.0,14:50,0,0,0,0.0,7,6,1,1,0,0,0,0,0.0,0:0,0,0,0,518.0,1:26,700000
8459670,Kimmo,Timonen,1975-03-18,D,L,2013-14,77,6,29,35,0.45,5,152,3.95,32,93923.0,20:19,0,0,0,0.0,75,112,13,31,-18,1,19,20,15800.0,3:25,0,1,1,15716.0,3:24,6000000
8460492,Ed,Jovanovski,1976-06-26,D,L,2013-14,37,1,4,5,0.14,-6,44,2.27,39,35897.0,16:10,0,0,0,0.0,34,42,8,12,-4,0,1,1,3635.0,1:38,0,1,1,4303.0,1:56,4125000
8460496,Ryan,Smyth,1976-02-21,LW,L,2013-14,72,10,13,23,0.32,-18,129,7.75,44,66632.0,15:25,91,91,182,50.0,58,29,27,35,-8,5,2,7,11018.0,2:33,0,0,0,7317.0,1:41,2250000
8460542,Patrik,Elias,1976-04-13,C,L,2013-14,65,18,35,53,0.82,-4,116,15.52,30,69730.0,17:52,276,401,677,40.77,26,19,26,32,-6,4,13,17,9626.0,2:28,2,4,6,7246.0,1:51,5500000
8460621,Daniel,Alfredsson,1972-12-11,RW,R,2013-14,68,18,31,49,0.72,2,151,11.92,10,69064.0,16:55,5,9,14,35.71,59,25,24,36,-12,4,14,18,13125.0,3:13,0,0,0,705.0,0:10,3500000
8460626,Bryce,Salvador,1976-02-11,D,L,2013-14,40,1,3,4,0.1,-2,24,4.17,29,48705.0,20:17,0,0,0,0.0,47,50,12,21,-9,0,0,0,148.0,0:3,0,0,0,9527.0,3:58,3166667
8460720,Eric,Boulton,1976-08-17,LW,L,2013-14,23,2,2,4,0.17,0,21,9.52,88,8846.0,6:24,0,0,0,0.0,32,6,1,4,-3,0,0,0,57.0,0:2,0,0,0,51.0,0:2,550000
8462038,Shane,Doan,1976-10-10,RW,R,2013-14,69,23,24,47,0.68,-7,167,13.77,34,78416.0,18:56,6,6,12,50.0,135,22,48,20,28,10,9,19,11901.0,2:52,0,0,0,158.0,0:2,5300000
8462041,Radek,Dvorak,1977-03-09,RW,R,2013-14,60,4,5,9,0.15,3,52,7.69,41,38305.0,10:38,6,6,12,50.0,17,25,26,21,5,0,0,0,533.0,0:8,0,0,0,3438.0,0:57,600000
8462042,Jarome,Iginla,1977-07-01,RW,R,2013-14,78,30,31,61,0.78,34,209,14.35,47,85250.0,18:12,8,29,37,21.62,142,27,30,29,1,4,10,14,11711.0,2:30,0,0,0,1875.0,0:24,1800000
8462129,Michal,Handzus,1977-03-11,C,L,2013-14,59,4,12,16,0.27,0,50,8.0,16,48309.0,13:38,329,335,664,49.55,35,55,14,11,3,0,0,0,253.0,0:4,1,1,2,8899.0,2:30,1000000
8462196,Stephane,Robidas,1977-03-03,D,R,2013-14,38,5,5,10,0.26,10,56,8.93,20,45997.0,20:10,0,0,0,0.0,96,49,4,11,-7,1,0,1,1833.0,0:48,0,0,0,5229.0,2:17,3300000
8464956,Chris,Phillips,1978-03-09,D,L,2013-14,70,1,14,15,0.21,-12,90,1.11,30,80756.0,19:13,0,0,0,0.0,140,95,10,46,-36,1,7,8,5688.0,1:21,0,0,0,12976.0,3:5,3083333
8464966,Derek,Morris,1978-08-24,D,R,2013-14,63,5,12,17,0.27,-2,82,6.1,41,73516.0,19:26,0,0,0,0.0,99,104,21,23,-2,0,1,1,2069.0,0:32,0,0,0,6655.0,1:45,2750000
8464975,Daniel,Briere,1977-10-06,C,R,2013-14,69,13,12,25,0.36,1,118,11.02,30,52861.0,12:46,171,179,350,48.86,23,11,22,17,5,4,2,6,6872.0,1:39,0,0,0,66.0,0:0,6500000
8464977,Dainius,Zubrus,1978-06-16,C,L,2013-14,82,13,13,26,0.32,1,121,10.74,46,86370.0,17:33,216,208,424,50.94,107,39,19,20,-1,0,0,0,1897.0,0:23,0,0,0,10637.0,2:9,3100000
8464981,Cory,Sarich,1978-08-16,D,R,2013-14,54,1,9,10,0.19,7,48,2.08,38,55367.0,17:5,0,1,1,0.0,107,66,14,19,-5,0,0,0,101.0,0:1,0,0,0,5566.0,1:43,-111
8464989,Matt,Cullen,1976-11-02,C,L,2013-14,77,10,29,39,0.51,4,134,7.46,32,71591.0,15:29,438,334,772,56.74,18,22,30,40,-10,1,8,9,10340.0,2:14,0,0,0,2108.0,0:27,3500000
8465009,Zdeno,Chara,1977-03-18,D,L,2013-14,77,17,23,40,0.52,25,168,10.12,66,113899.0,24:39,0,0,0,0.0,163,104,20,62,-42,10,5,15,11252.0,2:26,0,1,1,14684.0,3:10,6916667
8465025,Arron,Asham,1978-04-13,RW,R,2013-14,6,0,0,0,0.0,-5,1,0.0,14,2693.0,7:28,0,0,0,0.0,8,1,0,2,-2,0,0,0,32.0,0:5,0,0,0,31.0,0:5,-111
8465058,Michal,Rozsival,1978-09-03,D,R,2013-14,42,1,7,8,0.19,7,39,2.56,32,41962.0,16:39,0,0,0,0.0,67,43,15,24,-9,0,0,0,1072.0,0:25,0,0,0,2002.0,0:47,2200000
8465166,Craig,Adams,1977-04-26,RW,R,2013-14,82,5,6,11,0.13,-16,73,6.85,46,61307.0,12:27,61,78,139,43.88,190,59,15,16,-1,0,0,0,76.0,0:0,0,0,0,14986.0,3:2,700000
8465185,Willie,Mitchell,1977-04-23,D,L,2013-14,76,1,11,12,0.16,14,73,1.37,58,92707.0,20:19,0,0,0,0.0,102,128,10,56,-46,0,2,2,2090.0,0:27,0,0,0,13433.0,2:56,3500000
8465202,Sami,Salo,1974-09-02,D,R,2013-14,71,4,13,17,0.24,11,81,4.94,18,77490.0,18:11,0,0,0,0.0,57,66,17,20,-3,0,6,6,8410.0,1:58,0,0,0,8729.0,2:2,3750000
8465914,Francis,Bouillon,1975-10-17,D,L,2013-14,52,2,4,6,0.12,-5,34,5.88,34,55183.0,17:41,0,0,0,0.0,80,70,7,27,-20,0,1,1,3942.0,1:15,0,0,0,1567.0,0:30,1500000
8465951,Matt,Cooke,1978-09-07,LW,L,2013-14,82,10,18,28,0.34,8,104,9.62,54,75796.0,15:24,10,16,26,38.46,190,61,34,25,9,0,2,2,307.0,0:3,1,1,2,12407.0,2:31,2500000
8465978,Shawn,Thornton,1977-07-23,LW,R,2013-14,64,5,3,8,0.12,3,93,5.38,74,33768.0,8:47,3,6,9,33.33,111,19,13,10,3,0,0,0,180.0,0:2,0,0,0,0.0,0:0,1100000
8466138,Joe,Thornton,1979-07-02,C,L,2013-14,82,11,65,76,0.93,20,122,9.02,32,93141.0,18:55,617,482,1099,56.14,54,34,76,96,-20,2,17,19,18096.0,3:40,0,1,1,1685.0,0:20,7000000
8466139,Patrick,Marleau,1979-09-15,C,L,2013-14,82,33,37,70,0.85,0,285,11.58,18,100968.0,20:31,163,145,308,52.92,85,29,50,65,-15,11,12,23,17778.0,3:36,2,0,2,8103.0,1:38,6900000
8466140,Olli,Jokinen,1978-12-05,C,L,2013-14,82,18,25,43,0.52,-8,171,10.53,62,83755.0,17:1,612,718,1330,46.02,120,45,20,30,-10,2,6,8,9001.0,1:49,0,0,0,2426.0,0:29,4500000
8466142,Eric,Brewer,1979-04-17,D,L,2013-14,77,4,13,17,0.22,10,83,4.82,59,81095.0,17:33,0,0,0,0.0,139,99,17,40,-23,0,0,0,206.0,0:2,0,2,2,10657.0,2:18,3875000
8466148,Marian,Hossa,1979-01-12,RW,L,2013-14,72,30,30,60,0.83,28,241,12.45,20,78937.0,18:16,1,2,3,33.33,43,26,75,26,49,4,9,13,9593.0,2:13,3,1,4,5755.0,1:19,5275000
8466149,Daniel,Cleary,1978-12-18,RW,L,2013-14,52,4,4,8,0.15,-11,64,6.25,31,43365.0,13:53,12,10,22,54.55,51,17,12,6,6,0,0,0,4691.0,1:30,0,1,1,4833.0,1:32,1750000
8466158,Scott,Hannan,1979-01-23,D,L,2013-14,56,3,9,12,0.21,1,52,5.77,55,59711.0,17:46,0,0,0,0.0,29,73,13,23,-10,0,0,0,496.0,0:8,0,1,1,6284.0,1:52,1000000
8466160,Brenden,Morrow,1979-01-16,LW,L,2013-14,71,13,12,25,0.35,1,56,23.21,76,50705.0,11:54,9,20,29,31.03,110,20,12,13,-1,4,3,7,4210.0,0:59,0,0,0,233.0,0:3,1500000
8466182,Henrik,Tallinder,1979-01-10,D,L,2013-14,64,2,6,8,0.12,-21,40,5.0,34,72959.0,18:59,1,0,1,100.0,39,76,28,32,-4,0,0,0,251.0,0:3,0,0,0,8651.0,2:15,-111
8466215,Joe,Corvo,1977-06-20,D,R,2013-14,25,3,7,10,0.4,-7,54,5.56,10,26283.0,17:31,0,0,0,0.0,15,24,5,12,-7,0,2,2,3093.0,2:3,0,0,0,73.0,0:2,900000
8466251,Jason,Chimera,1979-05-02,LW,L,2013-14,82,15,27,42,0.51,4,167,8.98,36,75865.0,15:25,38,49,87,43.68,140,30,25,30,-5,1,4,5,4152.0,0:50,0,1,1,8447.0,1:43,1750000
8466285,Brian,Campbell,1979-05-23,D,L,2013-14,82,7,30,37,0.45,-6,116,6.03,20,132632.0,26:57,0,1,1,0.0,50,108,43,45,-2,2,10,12,19183.0,3:53,0,2,2,9581.0,1:56,7142875
8466309,Mike,Mottau,1978-03-19,D,L,2013-14,8,0,0,0,0.0,-3,1,0.0,4,6079.0,12:39,0,0,0,0.0,3,5,1,0,1,0,0,0,44.0,0:5,0,0,0,634.0,1:19,-111
8466333,Andrew,Ference,1979-03-17,D,L,2013-14,71,3,15,18,0.25,-18,77,3.9,63,89718.0,21:3,2,1,3,66.67,135,108,13,55,-42,0,2,2,1616.0,0:22,0,0,0,12260.0,2:52,3250000
8466378,Martin,St. Louis,1975-06-18,RW,L,2013-14,81,30,39,69,0.85,13,204,14.71,10,101771.0,20:56,68,99,167,40.72,24,38,65,53,12,9,12,21,16118.0,3:18,1,1,2,5644.0,1:9,5625000
8466393,Pascal,Dupuis,1979-04-07,RW,L,2013-14,39,7,13,20,0.51,6,97,7.22,8,41412.0,17:41,2,4,6,33.33,68,29,12,11,1,0,0,0,681.0,0:17,0,0,0,4617.0,1:58,3750000
8467096,Dan,Boyle,1976-07-12,D,R,2013-14,75,12,24,36,0.48,-8,154,7.79,32,95772.0,21:16,0,0,0,0.0,46,92,26,59,-33,6,12,18,16379.0,3:38,0,0,0,1194.0,0:15,6666666
8467329,Vincent,Lecavalier,1980-04-21,C,L,2013-14,69,20,17,37,0.54,-16,132,15.15,44,62890.0,15:11,200,248,448,44.64,77,19,16,27,-11,8,5,13,10155.0,2:27,0,0,0,155.0,0:2,7727272
8467330,David,Legwand,1980-08-17,C,L,2013-14,83,14,37,51,0.61,-17,146,9.59,61,84547.0,16:58,585,571,1156,50.61,49,38,37,42,-5,6,13,19,14179.0,2:50,0,0,0,613.0,0:7,4500000
8467331,Brad,Stuart,1979-11-06,D,L,2013-14,61,3,8,11,0.18,4,64,4.69,35,70134.0,19:9,0,0,0,0.0,122,114,13,29,-16,0,0,0,377.0,0:6,0,0,0,7416.0,2:1,3600000
8467332,Bryan,Allen,1980-08-21,D,L,2013-14,68,0,10,10,0.15,20,60,0.0,75,71605.0,17:33,0,0,0,0.0,121,118,8,26,-18,0,0,0,280.0,0:4,0,1,1,9256.0,2:16,3500000
8467334,Manny,Malhotra,1980-05-18,C,L,2013-14,69,7,6,13,0.19,0,53,13.21,18,48004.0,11:35,566,386,952,59.45,82,56,24,21,3,0,0,0,305.0,0:4,0,1,1,6763.0,1:38,600000
8467336,Mike,Rupp,1980-01-13,LW,L,2013-14,13,0,1,1,0.08,1,6,0.0,23,4843.0,6:12,0,3,3,0.0,13,0,0,2,-2,0,0,0,0.0,0:0,0,0,0,0.0,0:0,1333333
8467338,Alex,Tanguay,1979-11-21,LW,L,2013-14,16,4,7,11,0.69,7,24,16.67,4,16586.0,17:16,1,2,3,33.33,8,8,9,10,-1,0,2,2,2715.0,2:49,1,0,1,764.0,0:47,3500000
8467344,Robyn,Regehr,1980-04-19,D,L,2013-14,79,3,11,14,0.18,6,73,4.11,46,89858.0,18:57,0,0,0,0.0,211,96,5,40,-35,0,0,0,360.0,0:4,0,0,0,13313.0,2:48,3000000
8467351,Scott,Gomez,1979-12-23,C,L,2013-14,46,2,10,12,0.26,-11,56,3.57,24,36244.0,13:7,239,276,515,46.41,16,16,20,15,5,0,2,2,3739.0,1:21,0,0,0,97.0,0:2,7357143
8467365,John,Erskine,1980-06-26,D,L,2013-14,37,1,3,4,0.11,-5,38,2.63,56,34626.0,15:35,0,0,0,0.0,64,66,4,12,-8,0,0,0,27.0,0:0,0,0,0,4606.0,2:4,1962500
8467370,Mike,Fisher,1980-06-05,C,R,2013-14,75,20,29,49,0.65,-4,177,11.3,60,88911.0,19:45,596,550,1146,52.01,144,73,34,38,-4,4,7,11,12264.0,2:43,0,0,0,6713.0,1:29,4200000
8467371,Mike,Ribeiro,1980-02-10,C,L,2013-14,80,16,31,47,0.59,-13,110,14.55,52,86371.0,17:59,391,512,903,43.3,72,18,24,46,-22,4,11,15,15835.0,3:17,0,0,0,739.0,0:9,5500000
8467389,Brad,Richards,1980-05-02,C,L,2013-14,82,20,31,51,0.62,-8,259,7.72,18,91923.0,18:41,512,517,1029,49.76,24,43,33,46,-13,5,14,19,18099.0,3:40,0,0,0,130.0,0:1,6666666
8467396,Erik,Cole,1978-11-06,LW,L,2013-14,75,16,13,29,0.39,-17,139,11.51,20,68224.0,15:9,19,22,41,46.34,89,21,31,34,-3,3,4,7,10974.0,2:26,0,0,0,368.0,0:4,4500000
8467400,Francois,Beauchemin,1980-06-04,D,L,2013-14,70,4,13,17,0.24,26,100,4.0,39,97017.0,23:5,0,0,0,0.0,112,171,17,51,-34,1,1,2,7002.0,1:40,0,1,1,13381.0,3:11,3500000
8467407,Brian,Gionta,1979-01-18,RW,R,2013-14,81,18,22,40,0.49,1,184,9.78,22,86731.0,17:50,23,37,60,38.33,46,52,38,21,17,2,5,7,6917.0,1:25,0,1,1,7802.0,1:36,5000000
8467423,Shawn,Horcoff,1978-09-17,C,L,2013-14,77,7,13,20,0.26,1,68,10.29,52,59406.0,12:51,209,208,417,50.12,63,29,34,17,17,4,0,4,5599.0,1:12,1,0,1,5406.0,1:10,5500000
8467428,Krys,Barch,1980-03-26,RW,L,2013-14,55,0,4,4,0.07,-10,19,0.0,99,19725.0,5:58,1,0,1,100.0,64,6,4,2,2,0,0,0,38.0,0:0,0,0,0,42.0,0:0,750000
8467452,Rob,Scuderi,1978-12-30,D,L,2013-14,53,0,4,4,0.08,-8,28,0.0,2,60170.0,18:55,0,0,0,0.0,18,90,7,21,-14,0,0,0,83.0,0:1,0,0,0,8374.0,2:38,3375000
8467463,Mikael,Samuelsson,1976-12-23,RW,R,2013-14,26,1,2,3,0.12,-4,36,2.78,6,16150.0,10:21,0,2,2,0.0,13,3,4,9,-5,0,2,2,3699.0,2:22,0,0,0,6.0,0:0,3000000
8467493,Chris,Neil,1979-06-18,RW,R,2013-14,76,8,6,14,0.18,-10,99,8.08,211,53821.0,11:48,1,2,3,33.33,253,18,16,13,3,0,1,1,2755.0,0:36,0,0,0,92.0,0:1,1900000
8467496,Andrei,Markov,1978-12-20,D,L,2013-14,81,7,36,43,0.53,12,131,5.34,34,122660.0,25:14,0,0,0,0.0,49,180,35,82,-47,2,19,21,21313.0,4:23,1,0,1,12157.0,2:30,5750000
8467514,Pavel,Datsyuk,1978-07-20,C,L,2013-14,45,17,20,37,0.82,1,126,13.49,6,54722.0,20:16,446,389,835,53.41,30,22,59,21,38,6,6,12,8502.0,3:8,0,0,0,1976.0,0:43,6700000
8467545,Michael,Ryder,1980-03-31,RW,R,2013-14,82,18,16,34,0.41,-6,166,10.84,18,77649.0,15:46,4,8,12,33.33,51,10,24,20,4,4,4,8,11570.0,2:21,1,0,1,165.0,0:2,3500000
8467831,Jeff,Halpern,1976-05-03,C,R,2013-14,69,5,7,12,0.17,-8,45,11.11,24,42585.0,10:17,296,266,562,52.67,65,33,13,4,9,0,0,0,172.0,0:2,0,0,0,8250.0,1:59,600000
8467875,Daniel,Sedin,1980-09-26,LW,L,2013-14,73,16,31,47,0.64,0,224,7.14,38,90252.0,20:36,8,19,27,29.63,37,21,32,27,5,5,13,18,15641.0,3:34,0,0,0,4102.0,0:56,6100000
8467876,Henrik,Sedin,1980-09-26,C,L,2013-14,70,11,39,50,0.71,3,97,11.34,42,86824.0,20:40,574,523,1097,52.32,43,19,22,36,-14,4,14,18,14536.0,3:27,0,0,0,4144.0,0:59,6100000
8467881,Taylor,Pyatt,1981-08-19,LW,L,2013-14,56,4,1,5,0.09,-24,52,7.69,20,38897.0,11:34,7,6,13,53.85,70,28,12,4,8,1,0,1,1378.0,0:24,0,0,0,2204.0,0:39,-111
8467890,Barret,Jackman,1981-03-05,D,L,2013-14,79,3,12,15,0.19,11,83,3.61,97,84975.0,17:55,0,1,1,0.0,96,130,25,32,-7,0,0,0,115.0,0:1,0,0,0,10915.0,2:18,3166667
8467899,Martin,Havlat,1981-04-19,RW,L,2013-14,48,12,10,22,0.46,14,72,16.67,10,42405.0,14:43,0,4,4,0.0,9,14,15,34,-19,1,1,2,5136.0,1:47,0,0,0,436.0,0:9,4250000
8467910,Nolan,Yonkman,1981-04-01,D,R,2013-14,2,0,1,1,0.5,-1,3,0.0,0,1787.0,14:53,0,0,0,0.0,7,2,1,0,1,0,0,0,0.0,0:0,0,0,0,0.0,0:0,-111
8467917,Jordan,Leopold,1980-08-03,D,L,2013-14,27,1,5,6,0.22,1,40,2.5,6,25270.0,15:35,0,0,0,0.0,8,24,2,6,-4,0,2,2,1321.0,0:48,0,0,0,632.0,0:23,2250000
8467925,Adam,Hall,1980-08-14,RW,R,2013-14,80,4,5,9,0.11,-15,61,6.56,23,47225.0,9:50,314,213,527,59.58,77,46,18,6,12,0,0,0,161.0,0:2,2,0,2,14293.0,2:58,600000
8467931,Matt,Carkner,1980-11-03,D,R,2013-14,53,0,3,3,0.06,-10,50,0.0,149,38128.0,11:59,0,0,0,0.0,58,59,9,15,-6,0,0,0,49.0,0:0,0,0,0,1181.0,0:22,1500000
8467967,Chris,Kelly,1980-11-11,C,L,2013-14,57,9,9,18,0.32,2,69,13.04,32,50253.0,14:41,283,296,579,48.88,72,29,32,12,20,0,0,0,462.0,0:8,1,0,1,6340.0,1:51,3000000
8467977,Brian,McGrattan,1981-09-02,RW,R,2013-14,76,4,4,8,0.11,-4,79,5.06,100,30630.0,6:43,2,1,3,66.67,82,23,14,10,4,0,0,0,278.0,0:3,0,0,0,54.0,0:0,750000
8467988,Ryan,Malone,1979-12-01,LW,L,2013-14,57,5,10,15,0.26,-7,95,5.26,67,40287.0,11:46,2,5,7,28.57,75,26,11,23,-12,0,3,3,4043.0,1:10,0,0,0,426.0,0:7,4500000
8468001,Derek,MacKenzie,1981-06-11,C,L,2013-14,71,9,9,18,0.25,0,70,12.86,47,47994.0,11:15,256,241,497,51.51,241,32,24,16,8,0,0,0,405.0,0:5,2,1,3,7912.0,1:51,1000000
8468064,Martin,Erat,1981-08-29,RW,L,2013-14,70,3,26,29,0.41,5,53,5.66,28,61625.0,14:40,97,116,213,45.54,75,25,16,14,2,0,4,4,4933.0,1:10,0,0,0,4152.0,0:59,4500000
8468083,Henrik,Zetterberg,1980-10-09,C,L,2013-14,45,16,32,48,1.07,19,151,10.6,20,55493.0,20:33,259,230,489,52.97,23,15,28,26,2,3,14,17,9524.0,3:31,0,0,0,1470.0,0:32,6083333
8468085,Radim,Vrbata,1981-06-13,RW,R,2013-14,80,20,31,51,0.64,-6,263,7.6,22,86193.0,17:57,17,26,43,39.53,68,27,41,20,21,10,11,21,13442.0,2:48,0,0,0,1951.0,0:24,3000000
8468095,George,Parros,1979-12-29,RW,R,2013-14,22,0,1,1,0.05,-6,4,0.0,85,6006.0,4:33,0,0,0,0.0,14,5,0,2,-2,0,0,0,102.0,0:4,0,0,0,0.0,0:0,937500
8468101,Radek,Martinek,1976-08-31,D,R,2013-14,13,0,3,3,0.23,4,12,0.0,4,12071.0,15:28,0,0,0,0.0,9,9,5,8,-3,0,0,0,19.0,0:1,0,0,0,63.0,0:4,600000
8468114,Douglas,Murray,1980-03-12,D,L,2013-14,53,0,2,2,0.04,-12,26,0.0,42,45638.0,14:21,0,0,0,0.0,144,115,5,17,-12,0,0,0,25.0,0:0,0,0,0,9081.0,2:51,1500000
8468162,Jerred,Smithson,1979-02-04,C,R,2013-14,18,0,0,0,0.0,-5,2,0.0,9,9457.0,8:45,126,90,216,58.33,36,9,2,2,0,0,0,0,47.0,0:2,0,0,0,1908.0,1:46,550000
8468208,Joel,Ward,1980-12-02,RW,R,2013-14,82,24,25,49,0.6,7,133,18.05,32,79070.0,16:4,90,109,199,45.23,54,67,48,27,21,6,4,10,8617.0,1:45,2,0,2,8952.0,1:49,3000000
8468309,Mark,Streit,1977-12-11,D,L,2013-14,82,10,34,44,0.54,3,121,8.26,44,101564.0,20:38,0,0,0,0.0,41,108,16,41,-25,4,11,15,13269.0,2:41,0,0,0,1740.0,0:21,5250000
8468478,Mike,Weaver,1978-05-02,D,R,2013-14,72,1,12,13,0.18,0,53,1.89,31,79843.0,18:28,1,0,1,100.0,121,128,15,23,-8,0,0,0,461.0,0:6,0,0,0,12724.0,2:56,1100000
8468482,Dany,Heatley,1981-01-21,LW,L,2013-14,76,12,16,28,0.37,-18,110,10.91,18,67573.0,14:49,7,10,17,41.18,33,30,21,19,2,4,6,10,11591.0,2:32,0,0,0,37.0,0:0,7500000
8468483,Marian,Gaborik,1982-02-14,RW,L,2013-14,41,11,19,30,0.73,7,103,10.68,10,41840.0,17:0,0,2,2,0.0,15,10,11,15,-4,1,6,7,6987.0,2:50,0,0,0,117.0,0:2,7500000
8468484,Rostislav,Klesla,1982-03-21,D,L,2013-14,25,1,3,4,0.16,-3,22,4.55,24,23264.0,15:30,0,0,0,0.0,41,25,1,4,-3,0,0,0,67.0,0:2,0,0,0,3185.0,2:7,2975000
8468485,Raffi,Torres,1981-10-08,LW,L,2013-14,5,3,2,5,1.0,4,9,33.33,7,3108.0,10:21,2,2,4,50.0,9,2,1,1,0,0,0,0,369.0,1:13,0,0,0,0.0,0:0,2000000
8468486,Scott,Hartnell,1982-04-18,LW,L,2013-14,78,20,32,52,0.67,11,207,9.66,103,79003.0,16:52,4,14,18,22.22,155,39,19,35,-16,9,11,20,15472.0,3:18,0,0,0,345.0,0:4,4750000
8468493,Ron,Hainsey,1981-03-24,D,L,2013-14,82,4,11,15,0.18,-9,72,5.56,45,105480.0,21:26,0,0,0,0.0,96,124,36,40,-4,0,0,0,3086.0,0:37,0,1,1,10100.0,2:3,2000000
8468498,Brooks,Orpik,1980-09-26,D,L,2013-14,72,2,11,13,0.18,-3,50,4.0,46,91573.0,21:11,0,0,0,0.0,221,143,11,32,-21,0,0,0,500.0,0:6,0,0,0,12723.0,2:56,3750000
8468501,Anton,Volchenkov,1982-02-25,D,L,2013-14,56,0,8,8,0.14,3,42,0.0,20,56392.0,16:47,0,0,0,0.0,129,91,9,9,0,0,0,0,194.0,0:3,0,1,1,12538.0,3:43,4250000
8468504,Brad,Boyes,1982-04-17,RW,R,2013-14,78,21,15,36,0.46,-6,176,11.93,28,79766.0,17:2,37,32,69,53.62,46,35,38,29,9,2,1,3,11563.0,2:28,1,0,1,1430.0,0:18,1000000
8468505,Steve,Ott,1982-08-19,C,L,2013-14,82,9,14,23,0.28,-38,127,7.09,92,89690.0,18:13,494,423,917,53.87,246,35,15,28,-13,6,2,8,8800.0,1:47,0,0,0,10657.0,2:9,2950000
8468508,Justin,Williams,1981-10-04,RW,R,2013-14,82,19,24,43,0.52,14,239,7.95,48,83415.0,16:57,2,8,10,20.0,44,21,25,75,-50,4,3,7,11537.0,2:20,0,0,0,3092.0,0:37,3825000
8468509,Niklas,Kronwall,1981-01-12,D,L,2013-14,79,8,41,49,0.62,0,110,7.27,44,115243.0,24:18,0,0,0,0.0,93,154,25,50,-25,5,20,25,16000.0,3:22,0,1,1,14498.0,3:3,4750000
8468513,Nick,Schultz,1982-08-25,D,L,2013-14,69,0,5,5,0.07,-13,35,0.0,28,67531.0,16:18,0,0,0,0.0,73,132,2,36,-34,0,0,0,192.0,0:2,0,1,1,8962.0,2:9,3500000
8468518,Tomas,Kopecky,1982-02-05,RW,L,2013-14,49,4,8,12,0.24,0,95,4.21,18,46704.0,15:53,8,21,29,27.59,31,19,17,10,7,0,0,0,4134.0,1:24,1,0,1,5267.0,1:47,3000000
8468526,Jarret,Stoll,1982-06-24,C,R,2013-14,78,8,19,27,0.35,9,109,7.34,48,74240.0,15:51,678,561,1239,54.72,202,60,14,20,-6,1,3,4,6946.0,1:29,0,1,1,9899.0,2:6,3250000
8468535,Antoine,Vermette,1982-07-20,C,L,2013-14,82,24,21,45,0.55,0,160,15.0,44,94521.0,19:12,1005,778,1783,56.37,90,71,42,22,20,7,6,13,11981.0,2:26,3,0,3,10970.0,2:13,3750000
8468542,Paul,Martin,1981-03-05,D,L,2013-14,39,3,12,15,0.38,-4,54,5.56,10,57496.0,24:34,0,0,0,0.0,30,74,12,17,-5,1,8,9,7010.0,2:59,0,0,0,6546.0,2:47,5000000
8468575,Dominic,Moore,1980-08-03,C,L,2013-14,73,6,12,18,0.25,0,96,6.25,18,51317.0,11:42,354,294,648,54.63,62,24,18,11,7,0,0,0,406.0,0:5,1,2,3,7335.0,1:40,1000000
8468598,Lubomir,Visnovsky,1976-08-11,D,L,2013-14,24,3,8,11,0.46,-1,34,8.82,10,29564.0,20:31,0,0,0,0.0,14,26,15,18,-3,2,5,7,5699.0,3:57,0,0,0,425.0,0:17,4750000
8468611,Matt,Hendricks,1981-06-17,C,L,2013-14,77,5,2,7,0.09,-11,102,4.9,112,58850.0,12:44,34,29,63,53.97,180,59,19,14,5,0,0,0,672.0,0:8,1,0,1,11955.0,2:35,1850000
8468635,Travis,Moen,1982-04-06,LW,L,2013-14,65,2,10,12,0.18,2,56,3.57,49,44966.0,11:31,7,1,8,87.5,92,54,15,11,4,0,0,0,320.0,0:4,0,1,1,9961.0,2:33,1850000
8468639,John-Michael,Liles,1980-11-25,D,L,2013-14,41,2,7,9,0.22,5,56,3.57,8,48350.0,19:39,1,0,1,100.0,50,80,14,18,-4,1,3,4,5955.0,2:25,0,0,0,410.0,0:10,3875000
8468674,Deryk,Engelland,1982-04-03,D,R,2013-14,56,6,6,12,0.21,-6,59,10.17,58,43829.0,13:2,0,0,0,0.0,117,52,8,13,-5,0,1,1,488.0,0:8,0,0,0,3140.0,0:56,566667
8468700,Paul,Gaustad,1982-02-03,C,L,2013-14,75,10,11,21,0.28,-6,74,13.51,61,62130.0,13:48,696,504,1200,58.0,122,55,25,20,5,0,0,0,338.0,0:4,0,0,0,11174.0,2:28,3250000
8468745,Jean-Philippe,Cote,1982-04-22,D,L,2013-14,19,0,4,4,0.21,0,12,0.0,22,11401.0,10:0,0,0,0,0.0,40,22,0,2,-2,0,0,0,0.0,0:0,0,0,0,894.0,0:47,-111
8468778,Colton,Orr,1982-03-03,RW,R,2013-14,54,0,0,0,0.0,-3,12,0.0,110,17428.0,5:22,1,1,2,50.0,112,10,3,6,-3,0,0,0,94.0,0:1,0,0,0,42.0,0:0,925000
8469455,Jason,Spezza,1983-06-13,C,R,2013-14,75,23,43,66,0.88,-26,223,10.31,46,81947.0,18:12,775,661,1436,53.97,17,26,47,68,-21,9,13,22,13759.0,3:3,0,0,0,3530.0,0:47,7000000
8469457,Stephen,Weiss,1983-04-03,C,L,2013-14,26,2,2,4,0.15,-4,28,7.14,12,23025.0,14:45,184,173,357,51.54,4,10,13,10,3,0,0,0,2323.0,1:29,0,1,1,1138.0,0:43,4900000
8469459,Mikko,Koivu,1983-03-12,C,L,2013-14,65,11,43,54,0.83,0,147,7.48,24,81641.0,20:56,719,592,1311,54.84,33,32,49,27,22,2,16,18,13454.0,3:26,0,2,2,5428.0,1:23,6750000
8469460,Mike,Komisarek,1982-01-19,D,R,2013-14,32,0,4,4,0.12,-4,20,0.0,14,22462.0,11:41,0,0,0,0.0,70,27,3,16,-13,0,0,0,315.0,0:9,0,0,0,1249.0,0:39,4300000
8469462,Tuomo,Ruutu,1983-02-16,LW,L,2013-14,76,8,16,24,0.32,-18,105,7.62,44,66420.0,14:33,14,23,37,37.84,216,34,32,34,-2,3,0,3,7377.0,1:37,0,0,0,756.0,0:9,4750000
8469465,Dan,Hamhuis,1982-12-13,D,L,2013-14,79,5,17,22,0.28,13,150,3.33,26,113556.0,23:57,0,0,0,0.0,87,130,48,69,-21,0,3,3,8748.0,1:50,0,0,0,14758.0,3:6,4500000
8469466,Ales,Hemsky,1983-08-13,RW,R,2013-14,75,13,30,43,0.57,-15,138,9.42,24,71813.0,15:57,1,3,4,25.0,37,33,44,42,2,2,11,13,10628.0,2:21,0,0,0,777.0,0:10,5000000
8469467,Chuck,Kobasew,1982-04-17,RW,R,2013-14,33,2,0,2,0.06,1,37,5.41,15,22197.0,11:12,1,1,2,50.0,49,18,10,9,1,0,0,0,1404.0,0:42,0,0,0,965.0,0:29,550000
8469469,R.J.,Umberger,1982-05-03,C,L,2013-14,74,18,16,34,0.46,-3,136,13.24,26,71818.0,16:10,25,15,40,62.5,113,36,31,26,5,8,4,12,9112.0,2:3,1,1,2,4955.0,1:6,4600000
8469470,Carlo,Colaiacovo,1983-01-27,D,L,2013-14,25,1,3,4,0.16,-4,18,5.56,18,22729.0,15:9,0,0,0,0.0,29,26,1,5,-4,0,1,1,1882.0,1:15,0,0,0,24.0,0:0,2500000
8469473,Marcel,Goc,1983-08-24,C,L,2013-14,74,11,14,25,0.34,-7,117,9.4,35,72491.0,16:19,658,575,1233,53.37,119,43,21,21,0,0,2,2,3607.0,0:48,0,0,0,10061.0,2:15,1700000
8469476,Tim,Gleason,1983-01-29,D,L,2013-14,56,1,5,6,0.11,-21,43,2.33,65,55882.0,16:37,0,0,0,0.0,156,88,9,26,-17,0,0,0,97.0,0:1,0,0,0,6197.0,1:50,4000000
8469483,David,Steckel,1982-03-15,C,L,2013-14,6,0,0,0,0.0,0,8,0.0,0,3902.0,10:50,44,24,68,64.71,15,3,1,3,-2,0,0,0,16.0,0:2,0,0,0,327.0,0:54,-111
8469485,Derek,Roy,1983-05-04,C,L,2013-14,75,9,28,37,0.49,-1,114,7.89,30,61291.0,13:37,219,247,466,47.0,13,30,22,20,2,4,12,16,10295.0,2:17,0,0,0,701.0,0:9,4000000
8469490,Tim,Jackman,1981-11-14,RW,R,2013-14,36,4,1,5,0.14,-3,46,8.7,103,15340.0,7:6,2,1,3,66.67,69,4,4,4,0,0,0,0,137.0,0:3,0,0,0,45.0,0:1,612500
8469492,Fedor,Tyutin,1983-07-19,D,L,2013-14,69,4,22,26,0.38,6,87,4.6,44,88641.0,21:24,0,0,0,0.0,91,89,16,24,-8,1,8,9,6645.0,1:36,0,2,2,11446.0,2:45,4500000
8469500,Michael,Cammalleri,1982-06-08,LW,L,2013-14,63,26,19,45,0.71,-13,191,13.61,26,75014.0,19:50,88,103,191,46.07,26,29,30,42,-12,6,8,14,11475.0,3:2,0,0,0,1466.0,0:23,6000000
8469501,Chris,Thorburn,1983-06-03,RW,R,2013-14,55,2,9,11,0.2,0,26,7.69,65,29542.0,8:57,20,13,33,60.61,108,34,4,8,-4,0,0,0,174.0,0:3,0,0,0,240.0,0:4,866667
8469506,Jason,Pominville,1982-11-30,RW,R,2013-14,82,30,30,60,0.73,3,226,13.27,16,91463.0,18:35,87,72,159,54.72,23,31,37,24,13,7,10,17,17038.0,3:27,0,0,0,383.0,0:4,5300000
8469508,Jay,McClement,1983-03-02,C,L,2013-14,81,4,6,10,0.12,-8,67,5.97,32,71742.0,14:45,676,584,1260,53.65,141,57,36,24,12,0,0,0,139.0,0:1,0,1,1,16642.0,3:25,1500000
8469521,Tomas,Plekanec,1982-10-31,C,L,2013-14,81,20,23,43,0.53,11,199,10.05,38,96107.0,19:46,822,891,1713,47.99,44,45,38,37,1,3,7,10,9425.0,1:56,3,0,3,14339.0,2:57,5000000
8469531,Jay,Harrison,1982-11-03,D,L,2013-14,68,4,11,15,0.22,-1,103,3.88,44,67836.0,16:37,0,0,0,0.0,141,82,8,23,-15,1,5,6,4119.0,1:0,0,0,0,2904.0,0:42,1500000
8469542,Stephane,Veilleux,1981-11-16,LW,L,2013-14,34,3,0,3,0.09,-2,26,11.54,21,17211.0,8:26,1,1,2,50.0,41,20,9,2,7,0,0,0,0.0,0:0,0,0,0,2492.0,1:13,587500
8469544,Patrick,Sharp,1981-12-27,LW,R,2013-14,82,34,44,78,0.95,13,313,10.86,40,92922.0,18:53,83,69,152,54.61,55,27,41,25,16,10,15,25,15995.0,3:15,0,0,0,211.0,0:2,5900000
8469547,Jordin,Tootoo,1983-02-02,RW,R,2013-14,11,0,1,1,0.09,-3,11,0.0,5,4610.0,6:59,0,0,0,0.0,27,1,0,0,0,0,0,0,0.0,0:0,0,0,0,0.0,0:0,1900000
8469555,Christian,Ehrhoff,1982-07-06,D,L,2013-14,79,6,27,33,0.42,-27,161,3.73,38,113343.0,23:54,0,0,0,0.0,49,119,36,61,-25,1,11,12,16363.0,3:27,1,2,3,12289.0,2:35,4000000
8469591,Cody,McCormick,1983-04-18,C,R,2013-14,43,2,5,7,0.16,-6,26,7.69,52,22988.0,8:54,89,109,198,44.95,76,21,7,4,3,0,0,0,63.0,0:1,0,0,0,3409.0,1:19,1200000
8469598,Kevin,Bieksa,1981-06-16,D,R,2013-14,76,4,20,24,0.32,-8,167,2.4,104,103850.0,22:46,1,0,1,100.0,144,130,32,55,-23,1,7,8,8916.0,1:57,0,0,0,10037.0,2:12,4600000
8469619,Dennis,Seidenberg,1981-07-18,D,L,2013-14,34,1,9,10,0.29,11,53,1.89,10,44549.0,21:50,0,0,0,0.0,61,66,7,16,-9,0,0,0,921.0,0:27,0,0,0,4900.0,2:24,3250000
8469622,Ryane,Clowe,1982-09-30,LW,L,2013-14,43,7,19,26,0.6,-10,74,9.46,33,41614.0,16:7,1,2,3,33.33,82,19,8,21,-13,3,5,8,5672.0,2:11,0,0,0,25.0,0:0,4850000
8469623,Marek,Zidlicky,1977-02-03,D,R,2013-14,81,12,30,42,0.52,-3,128,9.38,60,105218.0,21:38,0,0,0,0.0,124,81,19,58,-39,8,10,18,13925.0,2:51,0,2,2,1462.0,0:18,3000000
8469626,Andrew,Alberts,1981-06-30,D,L,2013-14,10,0,0,0,0.0,1,5,0.0,0,4431.0,7:23,0,0,0,0.0,6,7,0,4,-4,0,0,0,8.0,0:0,0,0,0,216.0,0:21,600000
8469638,Jussi,Jokinen,1983-04-01,LW,L,2013-14,81,21,36,57,0.7,12,172,12.21,18,76306.0,15:42,160,139,299,53.51,34,31,22,47,-25,6,15,21,11088.0,2:16,0,0,0,172.0,0:2,3000000
8469639,Brooks,Laich,1983-06-23,C,L,2013-14,51,8,7,15,0.29,-7,75,10.67,16,52790.0,17:15,203,257,460,44.13,62,35,20,15,5,1,2,3,4109.0,1:20,1,1,2,8777.0,2:52,4500000
8469664,David,Moss,1981-12-28,RW,R,2013-14,79,8,14,22,0.28,-1,151,5.3,18,69453.0,14:39,21,30,51,41.18,120,49,32,16,16,0,2,2,2176.0,0:27,0,0,0,10227.0,2:9,2100000
8469665,Johnny,Oduya,1981-10-01,D,L,2013-14,77,3,13,16,0.21,11,83,3.61,38,92897.0,20:6,1,0,1,100.0,49,114,15,52,-37,0,0,0,832.0,0:10,0,1,1,9796.0,2:7,3375000
8469707,PA,Parenteau,1983-03-24,RW,R,2013-14,55,14,19,33,0.6,3,110,12.73,30,55936.0,16:57,2,12,14,14.29,35,16,21,21,0,1,2,3,8429.0,2:33,0,0,0,107.0,0:1,4000000
8469752,Pascal,Pelletier,1983-06-16,LW,L,2013-14,3,0,0,0,0.0,0,1,0.0,0,1610.0,8:56,1,3,4,25.0,3,1,0,0,0,0,0,0,0.0,0:0,0,0,0,0.0,0:0,-111
8469759,Vernon,Fiddler,1980-05-09,C,L,2013-14,76,6,17,23,0.3,3,109,5.5,37,60576.0,13:17,513,469,982,52.24,45,52,21,24,-3,0,1,1,1066.0,0:14,0,2,2,9122.0,2:0,1800000
8469760,Zbynek,Michalek,1982-12-23,D,R,2013-14,59,2,8,10,0.17,6,78,2.56,24,74262.0,20:58,0,0,0,0.0,55,165,27,23,4,0,0,0,185.0,0:3,0,0,0,10337.0,2:55,4000000
8469770,Dennis,Wideman,1983-03-20,D,R,2013-14,46,4,17,21,0.46,-15,102,3.92,18,62634.0,22:41,0,0,0,0.0,62,75,13,39,-26,2,2,4,8634.0,3:7,0,1,1,3634.0,1:19,5250000
8469779,Keith,Aucoin,1978-11-06,C,L,2013-14,2,0,0,0,0.0,-3,1,0.0,0,1597.0,13:18,9,6,15,60.0,0,0,1,1,0,0,0,0,61.0,0:30,0,0,0,154.0,1:17,-111
8469798,Maxime,Fortunus,1983-07-28,D,R,2013-14,1,0,1,1,1.0,1,0,,0,977.0,16:17,0,0,0,0.0,0,1,0,0,0,0,0,0,9.0,0:9,0,0,0,55.0,0:55,-111
8469820,Zenon,Konopka,1981-01-02,C,L,2013-14,59,1,2,3,0.05,-9,21,4.76,88,27970.0,7:54,345,222,567,60.85,46,26,7,1,6,0,0,0,124.0,0:2,0,0,0,3900.0,1:6,-111
8469992,Sheldon,Brookbank,1980-10-03,D,R,2013-14,48,2,5,7,0.15,2,43,4.65,52,37117.0,12:53,0,0,0,0.0,64,38,7,20,-13,0,0,0,117.0,0:2,0,0,0,1429.0,0:29,-111
8470018,Matt,Ellis,1981-08-31,LW,L,2013-14,50,4,2,6,0.12,-6,70,5.71,4,28414.0,9:28,69,97,166,41.57,37,24,17,3,14,0,0,0,226.0,0:4,0,0,0,4115.0,1:22,550000
8470039,Tomas,Fleischmann,1984-05-16,LW,L,2013-14,80,8,20,28,0.35,-18,188,4.26,22,82179.0,17:7,5,13,18,27.78,59,11,30,26,4,2,5,7,12437.0,2:35,0,1,1,5095.0,1:3,4500000
8470041,Rick,Nash,1984-06-16,LW,L,2013-14,65,26,13,39,0.6,10,258,10.08,36,66369.0,17:1,2,0,2,100.0,11,29,51,49,2,4,3,7,9709.0,2:29,2,2,4,1949.0,0:29,7800000
8470047,Valtteri,Filppula,1984-03-20,C,L,2013-14,75,25,33,58,0.77,5,131,19.08,20,89910.0,19:58,693,633,1326,52.26,33,33,53,28,25,6,14,20,15144.0,3:21,0,0,0,4844.0,1:4,5000000
8470054,Keith,Ballard,1982-11-26,D,L,2013-14,45,2,7,9,0.2,-7,29,6.9,37,36747.0,13:36,0,0,0,0.0,58,37,7,18,-11,0,2,2,1861.0,0:41,0,0,0,1627.0,0:36,1500000
8470063,Adam,Burish,1983-01-06,RW,R,2013-14,15,0,0,0,0.0,-4,9,0.0,6,8658.0,9:37,39,36,75,52.0,23,9,2,1,1,0,0,0,123.0,0:8,0,0,0,1012.0,1:7,1850000
8470065,Ryan,Craig,1982-01-06,C,L,2013-14,6,0,0,0,0.0,-3,4,0.0,0,2528.0,7:1,0,0,0,0.0,8,1,0,0,0,0,0,0,0.0,0:0,0,0,0,0.0,0:0,600000
8470085,Paul,Ranger,1984-09-12,D,L,2013-14,53,6,8,14,0.26,-1,59,10.17,36,55407.0,17:25,0,0,0,0.0,115,72,39,53,-14,0,0,0,853.0,0:16,1,0,1,6063.0,1:54,1000000
8470104,Tom,Gilbert,1983-01-10,D,R,2013-14,73,3,25,28,0.38,-5,93,3.23,18,93474.0,21:20,0,0,0,0.0,59,95,16,32,-16,2,4,6,9722.0,2:13,0,0,0,3816.0,0:52,4000000
8470105,Scottie,Upshall,1983-10-07,RW,L,2013-14,76,15,22,37,0.49,1,161,9.32,73,72604.0,15:55,32,39,71,45.07,134,25,35,15,20,1,5,6,7194.0,1:34,1,0,1,5619.0,1:13,3500000
8470110,Trevor,Daley,1983-10-09,D,L,2013-14,67,9,16,25,0.37,10,107,8.41,38,85005.0,21:8,0,0,0,0.0,42,98,15,21,-6,1,3,4,4750.0,1:10,0,0,0,9672.0,2:24,3300000
8470120,Alexander,Semin,1984-03-03,RW,R,2013-14,65,22,20,42,0.65,1,210,10.48,42,77648.0,19:54,1,9,10,10.0,22,30,49,56,-7,6,6,12,13270.0,3:24,1,0,1,2112.0,0:32,7000000
8470121,Matt,Greene,1983-05-13,D,R,2013-14,38,2,4,6,0.16,6,38,5.26,47,36225.0,15:53,0,1,1,0.0,118,59,1,36,-35,0,0,0,655.0,0:17,0,0,0,6131.0,2:41,2950000
8470123,Cam,Janssen,1984-04-15,RW,R,2013-14,24,3,0,3,0.12,3,11,27.27,22,7071.0,4:54,0,0,0,0.0,32,3,0,1,-1,0,0,0,0.0,0:0,0,0,0,0.0,0:0,550000
8470144,Frans,Nielsen,1984-04-24,C,L,2013-14,80,25,33,58,0.72,-11,167,14.97,8,88020.0,18:20,534,550,1084,49.26,39,47,50,35,15,5,15,20,16465.0,3:25,2,1,3,10365.0,2:9,2750000
8470151,Jay,Bouwmeester,1983-09-27,D,L,2013-14,82,4,33,37,0.45,26,152,2.63,20,118319.0,24:2,3,1,4,75.0,51,106,18,22,-4,1,10,11,10350.0,2:6,0,0,0,16071.0,3:15,6680000
8470153,Pierre-Marc,Bouchard,1984-04-27,C,L,2013-14,28,4,5,9,0.32,-9,51,7.84,12,23432.0,13:56,3,2,5,60.0,7,6,10,15,-5,1,0,1,2610.0,1:33,0,0,0,4.0,0:0,2000000
8470156,Joey,Crabb,1983-04-03,RW,R,2013-14,9,0,1,1,0.11,-2,5,0.0,7,7765.0,14:22,10,10,20,50.0,23,5,1,1,0,0,0,0,114.0,0:12,0,0,0,1004.0,1:51,600000
8470159,Boyd,Gordon,1983-10-19,C,R,2013-14,74,8,13,21,0.28,-15,80,10.0,20,65511.0,14:45,843,649,1492,56.5,27,89,21,19,2,1,3,4,2275.0,0:30,1,1,2,12360.0,2:47,3000000
8470162,Matt,Stajan,1983-12-19,C,L,2013-14,63,14,19,33,0.52,-13,70,20.0,42,69455.0,18:22,527,569,1096,48.08,74,36,49,40,9,0,1,1,1417.0,0:22,1,2,3,7677.0,2:1,3500000
8470169,Gregory,Campbell,1983-12-17,C,L,2013-14,82,8,13,21,0.26,1,84,9.52,47,58566.0,11:54,358,391,749,47.8,134,46,26,10,16,0,1,1,742.0,0:9,1,1,2,9143.0,1:51,1600000
8470171,Max,Talbot,1984-02-11,C,L,2013-14,81,8,19,27,0.33,5,124,6.45,45,78532.0,16:9,100,125,225,44.44,116,46,37,20,17,0,1,1,690.0,0:8,1,0,1,13303.0,2:44,1800000
8470176,Sean,Bergenheim,1984-02-08,LW,L,2013-14,62,16,13,29,0.47,-16,190,8.42,40,61401.0,16:30,2,2,4,50.0,111,18,27,16,11,3,1,4,8665.0,2:19,0,0,0,1364.0,0:22,2750000
8470180,Eric,Nystrom,1983-02-14,LW,L,2013-14,79,15,6,21,0.27,-25,120,12.5,60,70429.0,14:51,2,8,10,20.0,154,35,26,16,10,0,0,0,352.0,0:4,1,0,1,8720.0,1:50,2500000
8470187,Johnny,Boychuk,1984-01-19,D,R,2013-14,75,5,18,23,0.31,31,142,3.52,45,95365.0,21:11,0,0,0,0.0,158,151,16,31,-15,0,0,0,1395.0,0:18,0,3,3,13086.0,2:54,3366667
8470189,David,Van Der Gulik,1983-04-20,LW,L,2013-14,2,0,0,0,0.0,0,3,0.0,0,681.0,5:40,1,1,2,50.0,1,2,0,0,0,0,0,0,0.0,0:0,0,0,0,0.0,0:0,600000
8470201,Jiri,Hudler,1984-01-04,RW,L,2013-14,75,17,37,54,0.72,4,109,15.6,16,84802.0,18:50,4,18,22,18.18,35,15,29,39,-10,2,11,13,14007.0,3:6,0,0,0,300.0,0:4,4000000
8470207,Joffrey,Lupul,1983-09-23,LW,R,2013-14,69,22,22,44,0.64,-15,191,11.52,44,76395.0,18:27,24,31,55,43.64,118,35,25,47,-22,6,6,12,10089.0,2:26,0,0,0,109.0,0:1,5250000
8470222,James,Wisniewski,1984-02-21,D,R,2013-14,75,7,44,51,0.68,0,166,4.22,61,101798.0,22:37,0,0,0,0.0,101,73,18,38,-20,3,25,28,16426.0,3:39,0,0,0,8987.0,1:59,5500000
8470230,Daniel,Paille,1984-04-15,LW,L,2013-14,72,9,9,18,0.25,9,71,12.68,6,47361.0,10:57,11,6,17,64.71,70,30,32,13,19,0,0,0,203.0,0:2,1,0,1,6383.0,1:28,1300000
8470232,Kris,Newbury,1982-02-19,C,L,2013-14,4,0,1,1,0.25,0,1,0.0,7,1206.0,5:1,6,8,14,42.86,10,0,0,0,0,0,0,0,0.0,0:0,0,0,0,0.0,0:0,-111
8470257,Alexander,Steen,1984-03-01,LW,L,2013-14,68,33,29,62,0.91,17,211,15.64,46,82748.0,20:16,265,276,541,48.98,43,28,42,12,30,7,10,17,13578.0,3:19,1,2,3,7762.0,1:54,3362500
8470268,Denis,Grebeshkov,1983-10-11,D,L,2013-14,7,0,1,1,0.14,0,3,0.0,2,5750.0,13:41,0,0,0,0.0,3,9,1,1,0,0,0,0,317.0,0:45,0,0,0,20.0,0:2,1500000
8470274,Chris,Higgins,1983-06-02,LW,L,2013-14,78,17,22,39,0.5,-14,216,7.87,30,89738.0,19:10,17,21,38,44.74,98,45,31,23,8,2,1,3,7702.0,1:38,0,1,1,9815.0,2:5,2500000
8470280,Ben,Eager,1984-01-22,LW,L,2013-14,7,0,1,1,0.14,1,4,0.0,2,3033.0,7:13,1,1,2,50.0,9,2,2,2,0,0,0,0,15.0,0:2,0,0,0,0.0,0:0,1100000
8470281,Duncan,Keith,1983-07-16,D,L,2013-14,79,6,55,61,0.77,22,198,3.03,28,116840.0,24:38,0,0,0,0.0,36,89,48,70,-22,3,18,21,15063.0,3:10,0,1,1,11297.0,2:23,5538462
8470289,Jim,Slater,1982-12-09,C,L,2013-14,27,1,1,2,0.07,-5,24,4.17,8,17222.0,10:37,163,118,281,58.01,41,7,7,7,0,0,0,0,133.0,0:4,0,0,0,3028.0,1:52,1600000
8470302,Patrick,Dwyer,1983-06-22,RW,R,2013-14,75,8,14,22,0.29,-2,134,5.97,14,65928.0,14:39,9,15,24,37.5,107,48,44,26,18,0,0,0,348.0,0:4,2,0,2,8183.0,1:49,900000
8470309,Ryan,Whitney,1983-02-19,D,L,2013-14,7,0,0,0,0.0,-7,8,0.0,6,7034.0,16:44,0,0,0,0.0,4,10,0,2,-2,0,0,0,820.0,1:57,0,0,0,131.0,0:18,900000
8470310,Aaron,Rome,1983-09-27,D,L,2013-14,25,0,1,1,0.04,-6,15,0.0,11,19632.0,13:5,0,0,0,0.0,20,38,2,12,-10,0,0,0,76.0,0:3,0,0,0,1484.0,0:59,1500000
8470317,Nate,Guenin,1982-12-10,D,R,2013-14,68,1,8,9,0.13,3,52,1.92,46,70496.0,17:16,0,0,0,0.0,119,128,12,24,-12,0,0,0,223.0,0:3,0,0,0,11460.0,2:48,600000
8470318,Jonathan,Ericsson,1984-03-02,D,L,2013-14,48,1,10,11,0.23,2,66,1.52,34,61190.0,21:14,0,0,0,0.0,91,46,14,35,-21,0,0,0,1342.0,0:27,0,1,1,8588.0,2:58,3250000
8470324,Josh,Gorges,1984-08-14,D,L,2013-14,66,1,13,14,0.21,6,35,2.86,12,84119.0,21:14,0,1,1,0.0,97,177,11,29,-18,0,1,1,1401.0,0:21,0,1,1,13289.0,3:21,3900000
8470358,Alexandre,Burrows,1981-04-11,RW,L,2013-14,49,5,10,15,0.31,-9,104,4.81,71,52385.0,17:49,23,32,55,41.82,84,33,24,13,11,2,4,6,6858.0,2:19,0,1,1,5477.0,1:51,4500000
8470366,Martin,St Pierre,1983-08-11,C,L,2013-14,1,0,0,0,0.0,0,0,,0,593.0,9:53,2,1,3,66.67,1,1,0,0,0,0,0,0,69.0,1:9,0,0,0,0.0,0:0,-111
8470378,Andre,Benoit,1984-01-06,D,L,2013-14,79,7,21,28,0.35,2,113,6.19,26,95805.0,20:12,0,0,0,0.0,58,119,20,32,-12,1,7,8,11598.0,2:26,0,1,1,8205.0,1:43,900000
8470543,Chris,Kunitz,1979-09-26,LW,L,2013-14,78,35,33,68,0.87,25,218,16.06,66,89656.0,19:9,3,1,4,75.0,157,25,24,45,-21,13,9,22,16992.0,3:37,0,0,0,837.0,0:10,3725000
8470595,Eric,Staal,1984-10-29,C,L,2013-14,79,21,40,61,0.77,-13,230,9.13,74,96162.0,20:17,754,676,1430,52.73,67,28,77,61,16,1,11,12,15836.0,3:20,2,2,4,4163.0,0:52,8250000
8470596,Nathan,Horton,1985-05-29,RW,R,2013-14,35,4,14,18,0.51,-3,48,8.33,24,33389.0,15:53,1,0,1,100.0,53,14,12,11,1,2,2,4,4684.0,2:13,0,0,0,124.0,0:3,5300000
8470598,Thomas,Vanek,1984-01-19,LW,R,2013-14,78,27,41,68,0.87,7,248,10.89,46,90563.0,19:21,20,26,46,43.48,30,17,31,50,-19,8,10,18,18534.0,3:57,0,0,0,153.0,0:1,7142857
8470599,Milan,Michalek,1984-12-07,LW,L,2013-14,82,17,22,39,0.48,-25,169,10.06,41,86531.0,17:35,6,8,14,42.86,86,31,32,14,18,4,4,8,10603.0,2:9,0,0,0,8864.0,1:48,4333333
8470600,Ryan,Suter,1985-01-21,D,L,2013-14,82,8,35,43,0.52,15,150,5.33,34,144714.0,29:24,1,0,1,100.0,72,132,30,41,-11,3,14,17,18556.0,3:46,0,1,1,11619.0,2:21,7538462
8470601,Braydon,Coburn,1985-02-27,D,L,2013-14,82,5,12,17,0.21,-6,122,4.1,63,110423.0,22:26,0,0,0,0.0,109,115,26,44,-18,0,0,0,1118.0,0:13,1,0,1,19641.0,3:59,4500000
8470602,Dion,Phaneuf,1985-04-10,D,L,2013-14,80,8,23,31,0.39,2,145,5.52,144,113109.0,23:33,0,1,1,0.0,227,156,32,60,-28,2,9,11,15764.0,3:17,0,1,1,13582.0,2:49,6500000
8470604,Jeff,Carter,1985-01-01,C,R,2013-14,72,27,23,50,0.69,8,256,10.55,44,81871.0,18:57,336,308,644,52.17,68,29,32,59,-27,8,6,14,14127.0,3:16,1,0,1,6526.0,1:30,5272727
8470606,Dustin,Brown,1984-11-04,RW,R,2013-14,79,15,12,27,0.34,7,195,7.69,66,75063.0,15:50,6,13,19,31.58,246,12,26,41,-15,1,3,4,10096.0,2:7,0,0,0,2324.0,0:29,3175000
8470607,Brent,Seabrook,1985-04-20,D,R,2013-14,82,7,34,41,0.5,23,149,4.7,22,109540.0,22:15,0,0,0,0.0,171,142,35,68,-33,3,6,9,9740.0,1:58,1,0,1,9786.0,1:59,5800000
8470609,Steve,Bernier,1985-03-31,RW,R,2013-14,78,3,9,12,0.15,-15,104,2.88,33,58253.0,12:26,6,12,18,33.33,118,23,22,13,9,0,1,1,4408.0,0:56,0,0,0,58.0,0:0,775000
8470610,Zach,Parise,1984-07-28,LW,L,2013-14,67,29,27,56,0.84,10,245,11.84,30,82113.0,20:25,10,14,24,41.67,70,45,46,18,28,14,6,20,13412.0,3:20,1,0,1,4163.0,1:2,7538462
8470611,Eric,Fehr,1985-09-07,C,R,2013-14,73,13,18,31,0.42,0,137,9.49,32,64601.0,14:44,196,230,426,46.01,81,33,50,17,33,0,1,1,2637.0,0:36,0,1,1,4397.0,1:0,1500000
8470612,Ryan,Getzlaf,1985-05-10,C,R,2013-14,77,31,56,87,1.13,28,204,15.2,31,98338.0,21:17,692,719,1411,49.04,110,87,53,76,-23,5,18,23,16986.0,3:40,0,0,0,9834.0,2:7,8250000
8470613,Brent,Burns,1985-03-09,D,R,2013-14,69,22,26,48,0.7,26,245,8.98,34,69608.0,16:48,61,70,131,46.56,145,24,45,37,8,2,9,11,9171.0,2:12,0,0,0,230.0,0:3,5760000
8470614,Mark,Stuart,1984-04-27,D,L,2013-14,69,2,11,13,0.19,11,73,2.74,101,77149.0,18:38,0,0,0,0.0,229,160,6,32,-26,0,0,0,77.0,0:1,0,0,0,12713.0,3:4,1700000
8470616,Ryan,Kesler,1984-08-31,C,R,2013-14,77,25,18,43,0.56,-15,239,10.46,81,100787.0,21:48,740,666,1406,52.63,133,68,47,28,19,9,7,16,16127.0,3:29,1,0,1,10198.0,2:12,5000000
8470617,Mike,Richards,1985-02-11,C,L,2013-14,82,11,30,41,0.5,-6,157,7.01,28,83530.0,16:58,489,418,907,53.91,73,21,28,65,-37,4,8,12,14065.0,2:51,1,1,2,7701.0,1:33,5750000
8470619,Brian,Boyle,1984-12-18,C,L,2013-14,82,6,12,18,0.22,1,137,4.38,56,62790.0,12:45,306,272,578,52.94,154,54,20,20,0,1,1,2,1020.0,0:12,0,2,2,10199.0,2:4,1700000
8470621,Corey,Perry,1985-05-16,RW,R,2013-14,81,43,39,82,1.01,32,280,15.36,65,94679.0,19:28,9,16,25,36.0,81,28,31,56,-25,8,10,18,17061.0,3:30,0,0,0,2691.0,0:33,8625000
8470622,Patrick,Eaves,1984-05-01,RW,R,2013-14,30,2,3,5,0.17,-7,53,3.77,2,20267.0,11:15,7,8,15,46.67,43,5,8,3,5,1,2,3,1789.0,0:59,0,0,0,2107.0,1:10,1200000
8470626,Loui,Eriksson,1985-07-17,LW,L,2013-14,61,10,27,37,0.61,14,115,8.7,6,60494.0,16:31,0,0,0,0.0,12,13,31,17,14,2,9,11,7175.0,1:57,0,1,1,5233.0,1:25,4250000
8470630,Kevin,Klein,1984-12-13,D,R,2013-14,77,2,7,9,0.12,-7,73,2.74,21,80070.0,17:19,0,0,0,0.0,111,137,19,33,-14,0,0,0,345.0,0:4,0,0,0,7308.0,1:34,2900000
8470638,Patrice,Bergeron,1985-07-24,C,R,2013-14,80,30,32,62,0.78,38,243,12.35,43,86358.0,17:59,1015,717,1732,58.6,52,57,49,28,21,7,4,11,9524.0,1:59,1,3,4,9414.0,1:57,5000000
8470640,Matt,Carle,1984-09-25,D,L,2013-14,82,2,29,31,0.38,11,115,1.74,28,109159.0,22:11,0,1,1,0.0,46,161,21,43,-22,1,6,7,7130.0,1:26,0,0,0,11443.0,2:19,5500000
8470642,Shea,Weber,1985-08-14,D,R,2013-14,79,23,33,56,0.71,-2,195,11.79,52,127522.0,26:54,0,0,0,0.0,169,173,35,50,-15,12,14,26,14795.0,3:7,0,0,0,12337.0,2:36,7857143
8470644,Colin,McDonald,1984-09-30,RW,R,2013-14,70,8,10,18,0.26,-22,96,8.33,34,52030.0,12:23,7,8,15,46.67,217,15,17,13,4,0,0,0,1679.0,0:23,0,0,0,1017.0,0:14,637500
8470647,B.J.,Crombeen,1985-07-10,RW,R,2013-14,55,3,7,10,0.18,-2,60,5.0,79,33551.0,10:10,3,5,8,37.5,57,15,15,5,10,0,0,0,92.0,0:1,0,1,1,4923.0,1:29,1150000
8470654,Maxim,Lapierre,1985-03-29,C,R,2013-14,71,9,6,15,0.21,-3,78,11.54,78,47572.0,11:10,301,292,593,50.76,87,18,19,3,16,0,0,0,98.0,0:1,0,0,0,6358.0,1:29,1100000
8470655,David,Backes,1984-05-01,RW,R,2013-14,74,27,30,57,0.77,14,165,16.36,119,86793.0,19:32,621,580,1201,51.71,273,56,32,22,10,10,6,16,11761.0,2:38,0,0,0,8511.0,1:55,4500000
8470662,Colin,Fraser,1985-01-28,C,L,2013-14,33,0,2,2,0.06,-4,22,0.0,30,17797.0,8:59,87,86,173,50.29,58,20,2,7,-5,0,0,0,179.0,0:5,0,0,0,1219.0,0:36,825000
8470666,Daniel,Carcillo,1985-01-28,LW,L,2013-14,57,4,1,5,0.09,-1,44,9.09,100,31741.0,9:16,1,0,1,100.0,112,21,4,20,-16,0,0,0,289.0,0:5,0,0,0,10.0,0:0,825000
8470667,Clarke,MacArthur,1985-04-06,LW,L,2013-14,79,24,31,55,0.7,12,159,15.09,78,83583.0,17:38,15,17,32,46.88,108,20,33,37,-4,8,7,15,12271.0,2:35,1,2,3,6946.0,1:27,3250000
8470685,Alexander,Sulzer,1984-05-30,D,L,2013-14,25,0,2,2,0.08,-3,21,0.0,8,27188.0,18:7,0,0,0,0.0,11,44,1,10,-9,0,1,1,928.0,0:37,0,1,1,2789.0,1:51,-111
8470699,Jan,Hejda,1978-06-18,D,L,2013-14,78,6,11,17,0.22,8,75,8.0,40,104484.0,22:19,0,0,0,0.0,170,144,22,31,-9,0,0,0,565.0,0:7,0,0,0,13681.0,2:55,3250000
8470713,Paul,Bissonnette,1985-03-11,LW,L,2013-14,39,2,6,8,0.21,6,25,8.0,53,11108.0,4:44,1,2,3,33.33,51,4,6,3,3,0,0,0,0.0,0:0,0,0,0,0.0,0:0,737500
8470714,Corey,Potter,1984-01-05,D,R,2013-14,19,0,5,5,0.26,-1,17,0.0,21,15700.0,13:46,0,0,0,0.0,20,18,6,6,0,0,2,2,834.0,0:43,0,0,0,1383.0,1:12,775000
8470724,Kyle,Quincey,1985-08-12,D,L,2013-14,82,4,9,13,0.16,-5,106,3.77,88,102363.0,20:48,0,0,0,0.0,88,109,31,39,-8,0,0,0,1617.0,0:19,0,0,0,11988.0,2:26,3775000
8470729,Tyson,Strachan,1984-10-30,D,R,2013-14,18,0,2,2,0.11,-2,7,0.0,28,18715.0,17:19,0,0,0,0.0,31,30,4,9,-5,0,0,0,184.0,0:10,0,0,0,1138.0,1:3,550000
8470740,Lee,Stempniak,1983-02-04,RW,R,2013-14,73,12,22,34,0.47,-16,178,6.74,32,80870.0,18:27,10,23,33,30.3,104,21,40,39,1,0,4,4,8184.0,1:52,2,3,5,5857.0,1:20,2500000
8470750,John,Mitchell,1985-01-22,C,L,2013-14,75,11,21,32,0.43,13,107,10.28,36,73222.0,16:16,374,374,748,50.0,112,51,38,27,11,3,0,3,4749.0,1:3,0,1,1,8157.0,1:48,1100000
8470755,Brad,Richardson,1985-02-04,C,L,2013-14,73,11,12,23,0.32,1,85,12.94,39,65268.0,14:54,533,433,966,55.18,63,52,27,20,7,1,0,1,606.0,0:8,2,1,3,8975.0,2:2,1150000
8470760,Marc,Methot,1985-06-21,D,L,2013-14,75,6,17,23,0.31,0,117,5.13,28,97902.0,21:45,0,0,0,0.0,181,110,21,43,-22,0,3,3,2588.0,0:34,0,0,0,12156.0,2:42,3000000
8470775,Nate,Thompson,1984-10-05,C,L,2013-14,81,9,7,16,0.2,3,105,8.57,27,62521.0,12:51,496,478,974,50.92,114,45,28,9,19,0,0,0,210.0,0:2,2,0,2,9733.0,2:0,1600000
8470778,Drew,Miller,1984-02-17,LW,L,2013-14,82,7,8,15,0.18,-11,117,5.98,21,69560.0,14:8,9,14,23,39.13,122,63,26,9,17,0,0,0,441.0,0:5,0,0,0,14814.0,3:0,1350000
8470794,Joe,Pavelski,1984-07-11,C,R,2013-14,82,41,38,79,0.96,23,225,18.22,32,97663.0,19:51,675,531,1206,55.97,47,68,56,57,-1,16,15,31,17298.0,3:30,1,1,2,7839.0,1:35,4000000
8470803,Kyle,Brodziak,1984-05-25,C,R,2013-14,81,8,16,24,0.3,0,115,6.96,61,78829.0,16:13,590,633,1223,48.24,73,41,49,20,29,0,1,1,683.0,0:8,1,0,1,12747.0,2:37,2833333
8470816,Jay,Rosehill,1985-07-16,LW,L,2013-14,34,2,0,2,0.06,-8,14,14.29,90,10082.0,4:56,0,1,1,0.0,48,4,1,5,-4,0,0,0,89.0,0:2,0,0,0,14.0,0:0,675000
8470828,Toby,Enstrom,1984-11-05,D,L,2013-14,82,10,20,30,0.37,-9,106,9.43,56,117580.0,23:53,1,0,1,100.0,37,142,13,39,-26,4,9,13,16090.0,3:16,0,0,0,9817.0,1:59,5750000
8470834,Dustin,Byfuglien,1985-03-27,D,R,2013-14,78,20,36,56,0.72,-20,256,7.81,86,108042.0,23:5,0,2,2,0.0,213,80,68,72,-4,8,18,26,16184.0,3:27,0,0,0,7629.0,1:37,5200000
8470839,Shane,O'Brien,1983-08-09,D,L,2013-14,45,0,3,3,0.07,-8,16,0.0,58,30404.0,11:15,0,0,0,0.0,56,38,3,9,-6,0,0,0,94.0,0:2,0,0,0,221.0,0:4,2000000
8470852,Matt,Moulson,1983-11-01,LW,L,2013-14,75,23,28,51,0.68,2,176,13.07,34,80863.0,17:58,2,7,9,22.22,46,43,32,14,18,9,10,19,13918.0,3:5,0,0,0,132.0,0:1,3133333
8470854,Tanner,Glass,1983-11-29,LW,L,2013-14,67,4,9,13,0.19,-8,56,7.14,90,47381.0,11:47,9,10,19,47.37,247,57,10,5,5,0,0,0,79.0,0:1,0,0,0,6602.0,1:38,1100000
8470867,Troy,Bodie,1985-01-25,RW,R,2013-14,47,3,7,10,0.21,6,50,6.0,26,24345.0,8:37,2,5,7,28.57,64,19,6,7,-1,0,0,0,49.0,0:1,0,0,0,43.0,0:0,600000
8470871,Chris,Porter,1984-05-29,LW,L,2013-14,22,0,1,1,0.05,-3,24,0.0,0,13696.0,10:22,3,7,10,30.0,68,3,3,1,2,0,0,0,46.0,0:2,0,0,0,612.0,0:27,675000
8470877,David,Jones,1984-08-10,RW,R,2013-14,48,9,8,17,0.35,1,104,8.65,10,44524.0,15:27,38,35,73,52.05,102,31,15,13,2,2,0,2,5159.0,1:47,0,0,0,328.0,0:6,4000000
8470886,Clayton,Stoner,1985-02-19,D,L,2013-14,63,1,4,5,0.08,-6,48,2.08,84,50373.0,13:19,0,0,0,0.0,99,65,11,19,-8,0,0,0,94.0,0:1,0,0,0,4874.0,1:17,1050000
8470920,David,Clarkson,1984-03-31,RW,R,2013-14,60,5,6,11,0.18,-14,102,4.9,93,54366.0,15:6,8,13,21,38.1,159,35,23,25,-2,1,1,2,3834.0,1:3,0,0,0,21.0,0:0,5250000
8470966,Mark,Giordano,1983-10-03,D,L,2013-14,64,14,33,47,0.73,12,180,7.78,63,96898.0,25:14,0,0,0,0.0,73,103,39,43,-4,7,13,20,13201.0,3:26,0,3,3,10170.0,2:38,4020000
8471185,Curtis,Glencross,1982-12-28,LW,L,2013-14,38,12,12,24,0.63,-11,77,15.58,12,40166.0,17:37,14,27,41,34.15,59,27,19,22,-3,3,5,8,5781.0,2:32,0,0,0,909.0,0:23,2550000
8471208,Dustin,Penner,1982-09-28,RW,L,2013-14,67,14,21,35,0.52,25,119,11.76,30,58164.0,14:28,15,32,47,31.91,92,24,22,27,-5,5,6,11,7715.0,1:55,0,0,0,68.0,0:1,2000000
8471214,Alex,Ovechkin,1985-09-17,LW,R,2013-14,78,51,28,79,1.01,-35,386,13.21,48,96152.0,20:32,2,1,3,66.67,204,22,32,48,-16,24,15,39,23566.0,5:2,0,1,1,59.0,0:0,9538462
8471215,Evgeni,Malkin,1986-07-31,C,L,2013-14,60,23,49,72,1.2,10,191,12.04,62,72225.0,20:3,303,318,621,48.79,27,18,37,58,-21,7,23,30,16468.0,4:34,0,0,0,94.0,0:1,8700000
8471217,Andrew,Ladd,1985-12-12,LW,L,2013-14,78,23,31,54,0.69,8,189,12.17,57,92317.0,19:43,24,38,62,38.71,154,42,37,44,-7,4,8,12,12721.0,2:43,0,2,2,9642.0,2:3,4400000
8471218,Blake,Wheeler,1986-08-31,RW,R,2013-14,82,28,41,69,0.84,4,225,12.44,63,91948.0,18:41,15,25,40,37.5,150,68,36,32,4,8,11,19,12941.0,2:37,0,0,0,4215.0,0:51,5600000
8471220,Rostislav,Olesz,1985-10-10,LW,L,2013-14,10,0,2,2,0.2,-1,9,0.0,0,6852.0,11:25,1,2,3,33.33,11,1,3,0,3,0,1,1,289.0,0:28,0,0,0,460.0,0:46,3125000
8471222,Ladislav,Smid,1986-02-01,D,L,2013-14,73,2,6,8,0.11,-10,41,4.88,78,79407.0,18:7,0,0,0,0.0,193,168,13,38,-25,0,0,0,185.0,0:2,0,0,0,8982.0,2:3,3500000
8471226,Drew,Stafford,1985-10-30,RW,R,2013-14,70,16,18,34,0.49,-19,185,8.65,39,78294.0,18:38,106,91,197,53.81,78,25,24,30,-6,2,5,7,9762.0,2:19,1,0,1,6329.0,1:30,4000000
8471231,Kyle,Chipchura,1986-02-19,C,L,2013-14,80,5,15,20,0.25,3,46,10.87,45,46647.0,9:43,176,155,331,53.17,116,9,30,12,18,0,0,0,141.0,0:1,0,0,0,239.0,0:2,875000
8471232,Lauri,Korpikoski,1986-07-28,LW,L,2013-14,64,9,16,25,0.39,-7,109,8.26,24,61736.0,16:4,5,12,17,29.41,136,38,19,13,6,1,1,2,3100.0,0:48,0,3,3,7790.0,2:1,2500000
8471233,Travis,Zajac,1985-05-13,C,R,2013-14,80,18,30,48,0.6,3,165,10.91,28,97492.0,20:18,761,633,1394,54.59,53,25,49,23,26,3,12,15,12040.0,2:30,0,0,0,9546.0,1:59,5750000
8471236,Andrej,Meszaros,1985-10-13,D,L,2013-14,52,7,15,22,0.42,5,84,8.33,40,55492.0,17:47,0,0,0,0.0,67,64,11,28,-17,1,1,2,3352.0,1:4,0,0,0,2728.0,0:52,4000000
8471241,Mark,Fistric,1986-06-01,D,L,2013-14,34,1,4,5,0.15,9,22,4.55,28,31428.0,15:24,0,0,0,0.0,145,46,5,8,-3,0,1,1,216.0,0:6,0,0,0,3384.0,1:39,900000
8471242,Mike,Green,1985-10-12,D,R,2013-14,70,9,29,38,0.54,-16,172,5.23,64,95465.0,22:43,0,0,0,0.0,62,107,32,65,-33,3,12,15,11611.0,2:45,0,0,0,2056.0,0:29,6083333
8471245,Dave,Bolland,1986-06-05,C,R,2013-14,23,8,4,12,0.52,-1,33,24.24,24,19963.0,14:27,152,185,337,45.1,38,13,10,12,-2,1,1,2,814.0,0:35,1,0,1,1642.0,1:11,3375000
8471254,Bryan,Bickell,1986-03-09,LW,L,2013-14,59,11,4,15,0.25,-6,93,11.83,28,40179.0,11:21,1,1,2,50.0,105,10,10,8,2,0,0,0,1747.0,0:29,0,0,0,0.0,0:0,4000000
8471260,Blake,Comeau,1986-02-18,LW,R,2013-14,61,5,11,16,0.26,-2,107,4.67,36,44141.0,12:3,10,7,17,58.82,197,16,22,16,6,0,0,0,548.0,0:8,0,0,0,1484.0,0:24,1000000
8471262,Carl,Soderberg,1985-10-12,C,L,2013-14,73,16,32,48,0.66,4,129,12.4,36,62453.0,14:15,139,189,328,42.38,52,36,33,14,19,5,11,16,7788.0,1:46,0,0,0,42.0,0:0,1008333
8471266,David,Booth,1984-11-24,LW,L,2013-14,66,9,10,19,0.29,1,117,7.69,18,53356.0,13:28,13,10,23,56.52,121,17,23,16,7,0,1,1,1974.0,0:29,0,0,0,212.0,0:3,4250000
8471269,Nicklas,Grossmann,1985-01-22,D,L,2013-14,78,1,13,14,0.18,-6,71,1.41,55,89453.0,19:6,0,0,0,0.0,189,174,4,44,-40,0,0,0,307.0,0:3,0,1,1,12486.0,2:40,3500000
8471273,Brandon,Dubinsky,1986-04-29,C,L,2013-14,76,16,34,50,0.66,5,189,8.47,98,85617.0,18:46,586,521,1107,52.94,234,39,33,20,13,4,6,10,11865.0,2:36,2,2,4,9814.0,2:9,4200000
8471274,Alex,Goligoski,1985-07-30,D,L,2013-14,81,6,36,42,0.52,9,141,4.26,28,118163.0,24:18,0,1,1,0.0,94,154,18,88,-70,3,12,15,16077.0,3:18,0,0,0,12023.0,2:28,4600000
8471276,David,Krejci,1986-04-28,C,R,2013-14,80,19,50,69,0.86,39,169,11.24,28,91780.0,19:7,618,590,1208,51.16,75,56,45,48,-3,3,16,19,12316.0,2:33,0,0,0,3106.0,0:38,5250000
8471280,Nick,Johnson,1985-12-24,RW,R,2013-14,9,0,0,0,0.0,-4,10,0.0,0,5240.0,9:42,0,0,0,0.0,3,5,5,2,3,0,0,0,31.0,0:3,0,0,0,0.0,0:0,-111
8471283,Brandon,Prust,1984-03-16,LW,L,2013-14,52,6,7,13,0.25,-1,49,12.24,121,40007.0,12:49,65,60,125,52.0,92,35,12,15,-3,0,1,1,528.0,0:10,0,1,1,5490.0,1:45,2500000
8471284,Andrej,Sekera,1986-06-08,D,L,2013-14,74,11,33,44,0.59,4,142,7.75,20,105132.0,23:40,0,0,0,0.0,54,127,68,38,30,4,11,15,11783.0,2:39,1,0,1,11637.0,2:37,2750000
8471296,Alexei,Emelin,1986-04-25,D,L,2013-14,59,3,14,17,0.29,-1,58,5.17,59,68167.0,19:15,0,0,0,0.0,189,127,7,44,-37,1,2,3,2089.0,0:35,0,0,0,6129.0,1:43,2000000
8471299,Peter,Regin,1986-04-16,C,L,2013-14,61,4,7,11,0.18,-5,69,5.8,20,41869.0,11:26,176,220,396,44.44,43,19,21,10,11,0,1,1,1649.0,0:27,0,2,2,2177.0,0:35,750000
8471303,Alexander,Edler,1986-04-21,D,L,2013-14,63,7,15,22,0.35,-39,178,3.93,50,88023.0,23:17,2,1,3,66.67,112,136,28,34,-6,4,8,12,10791.0,2:51,0,0,0,8307.0,2:11,5000000
8471309,Johan,Franzen,1979-12-23,RW,L,2013-14,54,16,25,41,0.76,6,149,10.74,40,57211.0,17:39,119,106,225,52.89,66,23,18,28,-10,7,10,17,9493.0,2:55,0,0,0,980.0,0:18,3954545
8471311,Tyler,Kennedy,1986-07-15,C,R,2013-14,67,4,13,17,0.25,-10,143,2.8,34,51137.0,12:43,57,79,136,41.91,54,11,36,14,22,0,1,1,1983.0,0:29,0,0,0,696.0,0:10,2350000
8471323,Ryan,Jones,1984-06-14,LW,L,2013-14,52,2,4,6,0.12,0,59,3.39,40,30704.0,9:50,2,4,6,33.33,74,21,15,18,-3,0,0,0,1474.0,0:28,0,0,0,2743.0,0:52,1500000
8471326,Patrick,Bordeleau,1986-03-23,LW,L,2013-14,82,6,5,11,0.13,-1,37,16.22,115,33884.0,6:53,1,2,3,33.33,178,14,8,13,-5,0,0,0,179.0,0:2,0,0,0,0.0,0:0,1000000
8471331,Kevin,Porter,1986-03-12,C,L,2013-14,12,0,1,1,0.08,-5,3,0.0,2,8370.0,11:37,18,35,53,33.96,24,4,5,1,4,0,0,0,36.0,0:3,0,0,0,936.0,1:18,537500
8471338,Torrey,Mitchell,1985-01-30,C,R,2013-14,67,2,8,10,0.15,-3,56,3.57,25,43719.0,10:52,12,19,31,38.71,60,25,13,11,2,0,0,0,118.0,0:1,0,0,0,7088.0,1:45,1900000
8471339,Ryan,Callahan,1985-03-21,RW,R,2013-14,65,17,19,36,0.55,1,163,10.43,24,72729.0,18:38,13,19,32,40.62,189,60,34,20,14,7,5,12,9384.0,2:24,1,0,1,5490.0,1:24,4275000
8471346,Kris,Versteeg,1986-05-13,RW,R,2013-14,81,12,24,36,0.44,0,157,7.64,36,70289.0,14:27,56,63,119,47.06,29,23,37,20,17,1,7,8,9589.0,1:58,0,0,0,205.0,0:2,4400000
8471348,Nikita,Nikitin,1986-06-16,D,L,2013-14,66,2,13,15,0.23,9,95,2.11,20,67774.0,17:6,0,0,0,0.0,84,72,13,21,-8,0,0,0,3210.0,0:48,0,0,0,2954.0,0:44,2150000
8471352,Jake,Dowell,1985-03-04,C,L,2013-14,1,0,0,0,0.0,-1,1,0.0,0,429.0,7:9,2,2,4,50.0,3,0,0,0,0,0,0,0,0.0,0:0,0,0,0,58.0,0:58,-111
8471362,Mikhail,Grabovski,1984-01-31,C,L,2013-14,58,13,22,35,0.6,6,81,16.05,26,54817.0,15:45,346,295,641,53.98,19,22,27,21,6,3,5,8,5027.0,1:26,0,0,0,78.0,0:1,5500000
8471371,Mike,Brown,1985-06-24,RW,R,2013-14,56,2,3,5,0.09,-9,45,4.44,94,24028.0,7:9,2,1,3,66.67,146,15,8,4,4,0,0,0,186.0,0:3,0,0,0,89.0,0:1,736667
8471385,Adam,Pardy,1984-03-29,D,L,2013-14,60,0,6,6,0.1,4,47,0.0,38,51915.0,14:25,0,0,0,0.0,77,55,15,31,-16,0,0,0,68.0,0:1,0,0,0,3633.0,1:0,600000
8471388,Patrick,Kaleta,1986-06-08,RW,R,2013-14,5,0,0,0,0.0,-1,0,,5,2503.0,8:20,1,0,1,100.0,11,1,0,2,-2,0,0,0,0.0,0:0,0,0,0,442.0,1:28,1250000
8471390,Mike,Santorelli,1985-12-14,C,R,2013-14,49,10,18,28,0.57,9,91,10.99,6,54580.0,18:33,215,204,419,51.31,23,44,22,7,15,0,0,0,4108.0,1:23,0,2,2,5050.0,1:43,550000
8471392,Roman,Polak,1986-04-28,D,R,2013-14,72,4,9,13,0.18,3,83,4.82,71,74897.0,17:20,0,0,0,0.0,151,131,10,11,-1,0,0,0,58.0,0:0,0,0,0,9886.0,2:17,2750000
8471426,Troy,Brouwer,1985-08-17,RW,R,2013-14,82,25,18,43,0.52,-6,161,15.53,92,92739.0,18:50,223,213,436,51.15,210,39,34,22,12,12,9,21,16865.0,3:25,0,0,0,10379.0,2:6,3666667
8471428,Pierre-Luc,Letourneau-Leblond,1985-06-04,RW,L,2013-14,1,0,0,0,0.0,0,1,0.0,0,274.0,4:34,0,0,0,0.0,0,1,0,0,0,0,0,0,0.0,0:0,0,0,0,0.0,0:0,550000
8471436,Matt,Hunwick,1985-05-21,D,L,2013-14,1,0,0,0,0.0,0,1,0.0,0,1047.0,17:27,0,0,0,0.0,1,2,0,0,0,0,0,0,54.0,0:54,0,0,0,61.0,1:1,1600000
8471450,Brandon,Yip,1985-04-25,RW,R,2013-14,2,0,0,0,0.0,0,1,0.0,0,825.0,6:52,0,0,0,0.0,6,1,1,0,1,0,0,0,0.0,0:0,0,0,0,0.0,0:0,-111
8471474,Travis,Morin,1984-01-09,C,L,2013-14,4,0,1,1,0.25,2,4,0.0,0,2479.0,10:19,19,19,38,50.0,0,1,1,0,1,0,0,0,37.0,0:9,0,0,0,0.0,0:0,550000
8471476,Daniel,Winnik,1985-03-06,LW,L,2013-14,76,6,24,30,0.39,6,115,5.22,23,70175.0,15:23,85,111,196,43.37,61,62,34,30,4,0,0,0,546.0,0:7,2,2,4,11488.0,2:31,1800000
8471482,Grant,Clitsome,1985-04-14,D,L,2013-14,32,2,10,12,0.38,-5,42,4.76,18,37991.0,19:47,0,0,0,0.0,51,42,9,22,-13,0,2,2,2540.0,1:19,0,0,0,2939.0,1:31,2066667
8471490,Adam,Cracknell,1985-07-15,RW,R,2013-14,19,0,2,2,0.11,0,16,0.0,0,9327.0,8:10,10,17,27,37.04,33,8,3,0,3,0,0,0,135.0,0:7,0,0,0,129.0,0:6,600000
8471498,Jannik,Hansen,1986-03-15,RW,R,2013-14,71,11,9,20,0.28,-9,112,9.82,43,66734.0,15:39,12,17,29,41.38,99,22,28,14,14,0,1,1,3570.0,0:50,1,0,1,3516.0,0:49,1350000
8471504,Rene,Bourque,1981-12-10,RW,L,2013-14,63,9,7,16,0.25,-1,118,7.63,32,53613.0,14:11,4,4,8,50.0,90,15,13,9,4,3,1,4,4535.0,1:11,0,0,0,169.0,0:2,3333333
8471514,Rich,Peverley,1982-07-08,C,R,2013-14,62,7,23,30,0.48,-3,122,5.74,15,57235.0,15:23,348,231,579,60.1,27,42,25,26,-1,0,3,3,7626.0,2:3,1,1,2,4234.0,1:8,3250000
8471636,Tim,Sestito,1984-08-28,LW,L,2013-14,16,0,3,3,0.19,1,13,0.0,2,8733.0,9:5,20,27,47,42.55,24,9,1,3,-2,0,0,0,0.0,0:0,0,0,0,789.0,0:49,562500
8471657,Cody,McLeod,1984-06-26,LW,L,2013-14,71,5,8,13,0.18,2,76,6.58,122,43995.0,10:19,2,8,10,20.0,148,33,10,1,9,0,0,0,75.0,0:1,1,0,1,6412.0,1:30,1150000
8471663,Mike,Blunden,1986-12-15,RW,R,2013-14,7,0,0,0,0.0,-2,2,0.0,5,2576.0,6:8,0,0,0,0.0,16,3,0,0,0,0,0,0,2.0,0:0,0,0,0,77.0,0:11,550000
8471664,Mason,Raymond,1985-09-17,LW,L,2013-14,82,19,26,45,0.55,-6,178,10.67,22,85330.0,17:20,7,9,16,43.75,38,24,26,39,-13,6,5,11,9716.0,1:58,1,1,2,6708.0,1:21,1000000
8471669,Paul,Stastny,1985-12-27,C,L,2013-14,71,25,35,60,0.85,9,150,16.67,22,78351.0,18:23,655,555,1210,54.13,54,46,35,20,15,4,11,15,10113.0,2:22,0,1,1,2602.0,0:36,6600000
8471675,Sidney,Crosby,1987-08-07,C,L,2013-14,80,36,68,104,1.3,18,259,13.9,46,105467.0,21:58,991,896,1887,52.52,47,28,41,56,-15,11,27,38,20582.0,4:17,0,0,0,2420.0,0:30,8700000
8471676,Bobby,Ryan,1987-03-17,RW,R,2013-14,70,23,25,48,0.69,7,190,12.11,45,70850.0,16:52,8,5,13,61.54,104,30,50,39,11,6,3,9,10591.0,2:31,0,0,0,886.0,0:12,5100000
8471677,Jack,Johnson,1987-01-13,D,L,2013-14,82,5,28,33,0.4,-7,147,3.4,48,121423.0,24:40,0,1,1,0.0,182,128,17,40,-23,4,14,18,15793.0,3:12,0,0,0,14629.0,2:58,4357143
8471678,Benoit,Pouliot,1986-09-29,LW,L,2013-14,80,15,21,36,0.45,10,141,10.64,56,64513.0,13:26,20,19,39,51.28,141,18,31,39,-8,7,1,8,9334.0,1:56,0,0,0,32.0,0:0,1300000
8471680,Gilbert,Brule,1987-01-01,C,R,2013-14,3,0,0,0,0.0,-1,3,0.0,2,2080.0,11:33,0,0,0,0.0,3,1,1,1,0,0,0,0,28.0,0:9,0,0,0,0.0,0:0,685000
8471681,Jack,Skille,1987-05-19,RW,R,2013-14,16,4,0,4,0.25,2,23,17.39,6,8315.0,8:39,1,0,1,100.0,19,6,5,0,5,0,0,0,123.0,0:7,0,0,0,0.0,0:0,675000
8471682,Devin,Setoguchi,1987-01-01,RW,R,2013-14,75,11,16,27,0.36,-7,129,8.53,22,67743.0,15:3,5,15,20,25.0,143,37,24,29,-5,2,1,3,8081.0,1:47,0,0,0,51.0,0:0,3000000
8471685,Anze,Kopitar,1987-08-24,C,L,2013-14,82,29,41,70,0.85,34,200,14.5,24,102765.0,20:53,773,678,1451,53.27,90,44,52,41,11,10,13,23,16710.0,3:23,0,0,0,9893.0,2:0,6800000
8471686,Marc,Staal,1987-01-13,D,L,2013-14,72,3,11,14,0.19,-1,92,3.26,24,88688.0,20:31,1,0,1,100.0,83,84,41,48,-7,1,0,1,1623.0,0:22,0,1,1,8705.0,2:0,3975000
8471691,Martin,Hanzal,1987-02-20,C,L,2013-14,65,15,25,40,0.62,-9,169,8.88,73,72859.0,18:40,599,500,1099,54.5,200,37,32,19,13,5,8,13,10874.0,2:47,0,0,0,4717.0,1:12,3100000
8471693,Jakub,Kindl,1987-02-10,D,L,2013-14,66,2,17,19,0.29,-4,93,2.15,24,68233.0,17:13,0,0,0,0.0,57,42,14,34,-20,0,7,7,8065.0,2:2,0,0,0,370.0,0:5,2400000
8471698,T.J.,Oshie,1986-12-23,RW,R,2013-14,79,21,39,60,0.76,19,152,13.82,42,89985.0,18:59,28,38,66,42.42,77,54,62,21,41,5,10,15,12904.0,2:43,2,1,3,8373.0,1:45,4175000
8471699,Andrew,Cogliano,1987-06-14,LW,L,2013-14,82,21,21,42,0.51,13,157,13.38,26,75734.0,15:23,11,16,27,40.74,94,36,22,31,-9,0,0,0,1082.0,0:13,3,2,5,7836.0,1:35,2390000
8471700,Matt,Pelech,1987-09-04,RW,R,2013-14,6,1,0,1,0.17,1,3,33.33,22,1414.0,3:55,0,0,0,0.0,7,1,1,0,1,0,0,0,29.0,0:4,0,0,0,0.0,0:0,550000
8471702,Matt,Niskanen,1986-12-06,D,R,2013-14,81,10,36,46,0.57,33,162,6.17,51,103488.0,21:17,0,0,0,0.0,124,76,19,49,-30,3,12,15,14546.0,2:59,0,0,0,3477.0,0:42,2300000
8471703,Steve,Downie,1987-04-03,RW,R,2013-14,62,4,20,24,0.39,1,88,4.55,106,52461.0,14:6,4,3,7,57.14,70,18,24,21,3,3,3,6,6570.0,1:45,0,0,0,4.0,0:0,2650000
8471707,James,Neal,1987-09-03,LW,L,2013-14,59,27,34,61,1.03,15,238,11.34,55,65310.0,18:26,5,13,18,27.78,58,23,31,22,9,11,15,26,13574.0,3:50,0,0,0,71.0,0:1,5000000
8471708,Ryan,Stoa,1987-04-13,C,L,2013-14,3,0,0,0,0.0,-1,2,0.0,0,1635.0,9:5,0,9,9,0.0,4,1,0,0,0,0,0,0,0.0,0:0,0,0,0,0.0,0:0,550000
8471709,Marc-Edouard,Vlasic,1987-03-30,D,L,2013-14,81,5,19,24,0.3,31,138,3.62,38,100673.0,20:42,0,0,0,0.0,51,150,18,35,-17,0,1,1,3409.0,0:42,1,1,2,10664.0,2:11,4250000
8471716,Justin,Abdelkader,1987-02-25,LW,L,2013-14,70,10,18,28,0.4,2,147,6.8,31,64192.0,15:17,23,32,55,41.82,172,31,21,15,6,1,2,3,3705.0,0:52,0,0,0,2677.0,0:38,1800000
8471717,Adam,McQuaid,1986-10-12,D,R,2013-14,30,1,5,6,0.2,12,25,4.0,69,28886.0,16:2,0,0,0,0.0,54,42,1,10,-9,0,0,0,45.0,0:1,0,0,0,3263.0,1:48,1566667
8471718,Marc-Andre,Cliche,1987-03-23,C,R,2013-14,76,1,6,7,0.09,-11,69,1.45,17,48172.0,10:33,331,388,719,46.04,25,42,34,4,30,0,0,0,279.0,0:3,0,1,1,11543.0,2:31,537500
8471719,Matt,Kassian,1986-10-28,LW,L,2013-14,33,1,1,2,0.06,-1,12,8.33,63,8787.0,4:26,0,0,0,0.0,52,3,1,5,-4,0,0,0,0.0,0:0,0,0,0,0.0,0:0,575000
8471724,Kris,Letang,1987-04-24,D,R,2013-14,37,11,11,22,0.59,-8,108,10.19,16,53799.0,24:14,0,0,0,0.0,43,51,9,39,-30,6,6,12,8244.0,3:42,0,0,0,4436.0,1:59,3500000
8471729,Kris,Russell,1987-05-02,D,L,2013-14,68,7,22,29,0.43,-11,109,6.42,15,94389.0,23:8,0,0,0,0.0,42,201,25,39,-14,4,8,12,12059.0,2:57,0,1,1,3647.0,0:53,1500000
8471733,Rich,Clune,1987-04-25,LW,L,2013-14,58,3,4,7,0.12,-7,29,10.34,166,29432.0,8:27,0,0,0,0.0,132,9,11,6,5,0,0,0,109.0,0:1,0,0,0,614.0,0:10,537500
8471735,Keith,Yandle,1986-09-09,D,L,2013-14,82,8,45,53,0.65,-23,241,3.32,63,118799.0,24:8,0,0,0,0.0,22,105,31,65,-34,3,28,31,21616.0,4:23,0,0,0,1001.0,0:12,5250000
8471742,Cody,Franson,1987-08-08,D,R,2013-14,79,5,28,33,0.42,-20,115,4.35,30,98056.0,20:41,0,0,0,0.0,282,111,50,68,-18,1,17,18,13803.0,2:54,0,0,0,7779.0,1:38,2000000
8471743,Vladimir,Sobotka,1987-07-02,LW,L,2013-14,61,9,24,33,0.54,14,102,8.82,72,61278.0,16:44,503,310,813,61.87,110,28,25,8,17,1,6,7,5874.0,1:36,0,1,1,6879.0,1:52,1300000
8471748,Mark,Fraser,1986-09-29,D,L,2013-14,42,1,1,2,0.05,-15,11,9.09,76,38734.0,15:22,0,0,0,0.0,118,95,7,33,-26,0,0,0,96.0,0:2,0,0,0,5467.0,2:10,1275000
8471760,Cody,Bass,1987-01-07,C,R,2013-14,1,0,0,0,0.0,0,0,,5,163.0,2:43,0,0,0,0.0,0,0,0,0,0,0,0,0,0.0,0:0,0,0,0,0.0,0:0,600000
8471761,Chris,Butler,1986-10-27,D,L,2013-14,82,2,14,16,0.2,-23,83,2.41,39,99708.0,20:15,0,0,0,0.0,68,211,14,64,-50,0,0,0,1686.0,0:20,0,1,1,13247.0,2:41,1700000
8471762,Chris,VandeVelde,1987-03-15,C,L,2013-14,18,0,1,1,0.06,-3,8,0.0,6,8347.0,7:43,16,24,40,40.0,24,6,3,2,1,0,1,1,64.0,0:3,0,0,0,1727.0,1:35,550000
8471766,Jared,Boll,1986-05-13,RW,R,2013-14,28,1,1,2,0.07,-6,12,8.33,62,12814.0,7:37,0,1,1,0.0,55,9,2,0,2,0,0,0,35.0,0:1,0,0,0,0.0,0:0,1050000
8471767,Blair,Jones,1986-09-27,C,R,2013-14,14,2,0,2,0.14,0,14,14.29,21,9556.0,11:22,36,40,76,47.37,30,5,5,9,-4,0,0,0,247.0,0:17,1,0,1,918.0,1:5,650000
8471768,Tom,Pyatt,1987-02-14,LW,L,2013-14,27,3,4,7,0.26,-2,27,11.11,4,18568.0,11:27,101,92,193,52.33,11,20,2,5,-3,0,0,0,162.0,0:6,0,0,0,1552.0,0:57,600000
8471769,Niklas,Hjalmarsson,1987-06-06,D,L,2013-14,81,4,22,26,0.32,11,98,4.08,34,103416.0,21:16,0,0,0,0.0,39,157,21,100,-79,0,0,0,555.0,0:6,1,3,4,13714.0,2:49,3500000
8471794,Darren,Helm,1987-01-21,LW,L,2013-14,42,12,8,20,0.48,2,83,14.46,14,38231.0,15:10,269,279,548,49.09,73,16,17,13,4,1,0,1,1700.0,0:40,2,0,2,5472.0,2:10,2125000
8471804,Nathan,Gerbe,1987-07-24,C,L,2013-14,81,16,15,31,0.38,-6,221,7.24,36,79710.0,16:24,2,4,6,33.33,53,15,48,34,14,3,4,7,8509.0,1:45,2,0,2,4835.0,0:59,1450000
8471816,Mark,Fayne,1987-05-15,D,R,2013-14,72,4,7,11,0.15,-5,88,4.55,30,79105.0,18:18,0,0,0,0.0,77,83,12,32,-20,0,0,0,191.0,0:2,1,0,1,8617.0,1:59,1300000
8471817,Ryan,Reaves,1987-01-20,RW,R,2013-14,63,2,6,8,0.13,-1,25,8.0,126,32215.0,8:31,6,2,8,75.0,211,12,12,6,6,0,0,0,55.0,0:0,0,0,0,4.0,0:0,600000
8471832,Nick,Drazenovic,1987-01-14,C,L,2013-14,1,0,0,0,0.0,-1,3,0.0,2,618.0,10:18,3,1,4,75.0,1,0,0,0,0,0,0,0,43.0,0:43,0,0,0,0.0,0:0,550000
8471840,Brett,Sutter,1987-06-02,LW,L,2013-14,17,1,1,2,0.12,-4,16,6.25,9,7712.0,7:33,37,36,73,50.68,35,2,4,2,2,0,0,0,85.0,0:5,0,0,0,393.0,0:23,600000
8471842,Tim,Kennedy,1986-04-30,LW,L,2013-14,37,2,6,8,0.22,0,42,4.76,4,26108.0,11:45,18,31,49,36.73,62,21,15,11,4,0,0,0,63.0,0:1,0,0,0,99.0,0:2,700000
8471851,Matt,D'Agostini,1986-10-23,RW,R,2013-14,57,5,7,12,0.21,-15,110,4.55,26,50794.0,14:51,5,10,15,33.33,55,40,22,12,10,2,0,2,5400.0,1:34,0,0,0,1301.0,0:22,550000
8471856,Joe,Vitale,1985-08-20,C,R,2013-14,53,1,13,14,0.26,-1,42,2.38,29,34898.0,10:58,200,120,320,62.5,89,22,8,12,-4,0,1,1,150.0,0:2,0,0,0,2071.0,0:39,550000
8471862,Colin,Greening,1986-03-09,C,L,2013-14,76,6,11,17,0.22,-15,108,5.56,41,62670.0,13:44,22,37,59,37.29,225,30,28,20,8,2,1,3,1946.0,0:25,0,0,0,5496.0,1:12,816666
8471873,Anton,Stralman,1986-08-01,D,R,2013-14,81,1,12,13,0.16,9,104,0.96,26,94337.0,19:24,0,0,0,0.0,75,64,29,49,-20,0,0,0,1348.0,0:16,0,0,0,7879.0,1:37,1700000
8471887,Patric,Hornqvist,1987-01-01,RW,R,2013-14,76,22,31,53,0.7,1,248,8.87,28,76875.0,16:51,0,6,6,0.0,77,34,53,13,40,7,10,17,13316.0,2:55,0,0,0,50.0,0:0,4250000
8471956,Andrew,Desjardins,1986-07-27,LW,L,2013-14,81,3,14,17,0.21,-8,95,3.16,86,54157.0,11:8,371,304,675,54.96,103,43,37,26,11,0,0,0,298.0,0:3,0,0,0,5880.0,1:12,750000
8471958,Dan,Girardi,1984-04-29,D,R,2013-14,81,5,19,24,0.3,6,100,5.0,16,112361.0,23:7,0,0,0,0.0,191,174,28,55,-27,1,2,3,7395.0,1:31,0,2,2,13654.0,2:48,3325000
8471976,David,Desharnais,1986-09-14,C,L,2013-14,79,16,36,52,0.66,11,96,16.67,24,81533.0,17:12,611,591,1202,50.83,23,35,34,22,12,3,12,15,12749.0,2:41,0,0,0,625.0,0:7,3500000
8471996,Bracken,Kearns,1981-05-12,C,L,2013-14,25,3,2,5,0.2,-2,37,8.11,6,19789.0,13:11,30,41,71,42.25,45,16,4,4,0,1,0,1,1226.0,0:49,0,0,0,861.0,0:34,550000
8472368,Chris,Conner,1983-12-23,RW,L,2013-14,19,4,1,5,0.26,-3,17,23.53,2,13415.0,11:46,0,1,1,0.0,21,10,4,3,1,0,0,0,370.0,0:19,0,0,0,0.0,0:0,550000
8472382,Andy,Greene,1982-10-30,D,L,2013-14,82,8,24,32,0.39,3,134,5.97,32,120925.0,24:34,0,0,0,0.0,87,129,46,52,-6,3,10,13,11566.0,2:21,0,2,2,17523.0,3:33,3000000
8472394,Peter,Harrold,1983-06-08,D,R,2013-14,33,0,4,4,0.12,-2,32,0.0,14,36961.0,18:40,0,0,0,0.0,17,29,3,12,-9,0,0,0,2090.0,1:3,0,0,0,2046.0,1:2,800000
8472410,Stephen,Gionta,1983-10-09,RW,R,2013-14,66,4,7,11,0.17,-8,89,4.49,18,49346.0,12:27,238,343,581,40.96,113,25,26,10,16,0,0,0,71.0,0:1,1,0,1,7475.0,1:53,562500
8472424,Ryan,Hamilton,1985-04-15,LW,L,2013-14,2,0,0,0,0.0,-2,0,,0,1203.0,10:1,0,0,0,0.0,3,1,0,1,-1,0,0,0,143.0,1:11,0,0,0,112.0,0:56,600000
8473412,Bryan,Little,1987-11-12,C,R,2013-14,82,23,41,64,0.78,8,170,13.53,58,98418.0,20:0,785,868,1653,47.49,84,38,38,31,7,8,7,15,13111.0,2:39,2,2,4,11057.0,2:14,4700000
8473419,Brad,Marchand,1988-05-11,LW,L,2013-14,82,25,28,53,0.65,36,149,16.78,64,78464.0,15:56,6,17,23,26.09,73,23,46,51,-5,1,1,2,2459.0,0:29,5,0,5,7628.0,1:33,4500000
8473422,Nick,Foligno,1987-10-31,LW,L,2013-14,70,18,21,39,0.56,5,111,16.22,96,67445.0,16:3,6,7,13,46.15,210,42,43,22,21,3,3,6,7306.0,1:44,0,0,0,859.0,0:12,3083333
8473426,Mike,Weber,1987-12-16,D,L,2013-14,68,1,8,9,0.13,-29,47,2.13,73,72694.0,17:49,0,0,0,0.0,208,161,11,35,-24,0,0,0,110.0,0:1,0,1,1,8218.0,2:0,1666667
8473432,Derek,Dorsett,1986-12-20,RW,R,2013-14,51,4,4,8,0.16,-1,67,5.97,128,33743.0,11:1,0,3,3,0.0,102,27,12,8,4,0,0,0,311.0,0:6,0,0,0,2326.0,0:45,1633333
8473446,Erik,Johnson,1988-03-21,D,R,2013-14,80,9,30,39,0.49,5,157,5.73,61,110433.0,23:0,0,0,0,0.0,136,130,49,42,7,2,12,14,12701.0,2:38,0,0,0,4828.0,1:0,3750000
8473449,Kyle,Okposo,1988-04-16,RW,R,2013-14,71,27,42,69,0.97,-9,195,13.85,51,87046.0,20:26,97,107,204,47.55,43,35,44,39,5,5,10,15,16836.0,3:57,0,0,0,725.0,0:10,2800000
8473453,Trevor,Lewis,1987-01-08,C,R,2013-14,73,6,5,11,0.15,-1,111,5.41,6,58067.0,13:15,127,135,262,48.47,145,36,14,18,-4,0,0,0,1265.0,0:17,1,0,1,8222.0,1:52,1325000
8473465,Jamie,McGinn,1988-08-05,LW,L,2013-14,79,19,19,38,0.48,-3,167,11.38,30,74791.0,15:46,1,1,2,50.0,140,35,36,17,19,5,4,9,8328.0,1:45,0,0,0,1479.0,0:18,1750000
8473466,Ryan,White,1988-03-17,C,R,2013-14,52,2,4,6,0.12,-8,51,3.92,50,30229.0,9:41,197,191,388,50.77,88,37,10,7,3,0,0,0,177.0,0:3,0,0,0,5556.0,1:46,700000
8473468,Eric,Gryba,1988-04-14,D,R,2013-14,57,2,9,11,0.19,9,57,3.51,64,59922.0,17:31,0,0,0,0.0,161,60,6,35,-29,0,0,0,446.0,0:7,0,1,1,10315.0,3:0,562500
8473473,Milan,Lucic,1988-06-07,LW,L,2013-14,80,24,35,59,0.74,30,153,15.69,91,83403.0,17:22,61,70,131,46.56,240,22,33,71,-38,3,9,12,11273.0,2:20,0,0,0,57.0,0:0,6000000
8473482,Jiri,Tlusty,1988-03-16,LW,L,2013-14,68,16,14,30,0.44,2,131,12.21,22,61890.0,15:10,3,12,15,20.0,88,38,26,19,7,0,1,1,6117.0,1:29,2,0,2,2334.0,0:34,1600000
8473485,Chris,Stewart,1987-10-30,RW,R,2013-14,63,15,11,26,0.41,0,110,13.64,118,51739.0,13:41,12,23,35,34.29,80,9,12,13,-1,3,3,6,7107.0,1:52,0,0,0,146.0,0:2,4150000
8473492,Matt,Beleskey,1988-06-07,LW,L,2013-14,55,9,15,24,0.44,8,112,8.04,64,41035.0,12:26,8,10,18,44.44,132,24,14,13,1,0,4,4,4123.0,1:14,0,1,1,1464.0,0:26,1350000
8473504,Cal,Clutterbuck,1987-11-18,RW,R,2013-14,73,12,7,19,0.26,-9,172,6.98,50,62772.0,14:19,7,9,16,43.75,270,14,30,24,6,0,0,0,5748.0,1:18,3,1,4,7781.0,1:46,2750000
8473505,Peter,LeBlanc,1988-02-03,C,L,2013-14,1,0,0,0,0.0,0,0,,0,566.0,9:26,0,0,0,0.0,2,1,0,0,0,0,0,0,0.0,0:0,0,0,0,0.0,0:0,-111
8473507,Jeff,Petry,1987-12-09,D,R,2013-14,80,7,10,17,0.21,-22,96,7.29,42,103607.0,21:35,0,0,0,0.0,181,132,29,96,-67,1,1,2,4043.0,0:50,0,0,0,14669.0,3:3,1750000
8473512,Claude,Giroux,1988-01-12,C,R,2013-14,82,28,58,86,1.05,7,223,12.56,46,100538.0,20:26,931,829,1760,52.9,90,46,43,34,9,7,30,37,18440.0,3:44,0,0,0,4643.0,0:56,3750000
8473514,Jesse,Joensuu,1987-10-05,LW,L,2013-14,42,3,2,5,0.12,-16,41,7.32,16,23490.0,9:19,0,5,5,0.0,63,18,14,18,-4,1,0,1,1303.0,0:31,0,0,0,123.0,0:2,950000
8473533,Jordan,Staal,1988-09-10,C,L,2013-14,82,15,25,40,0.49,2,165,9.09,34,93233.0,18:56,803,674,1477,54.37,194,37,51,41,10,2,8,10,11074.0,2:15,1,3,4,8021.0,1:37,6000000
8473534,Patrik,Berglund,1988-06-02,C,L,2013-14,78,14,18,32,0.41,10,144,9.72,38,75685.0,16:10,373,410,783,47.64,88,30,42,12,30,2,2,4,7195.0,1:32,0,0,0,7111.0,1:31,3250000
8473536,James,Sheppard,1988-04-25,C,L,2013-14,67,4,16,20,0.3,3,84,4.76,35,48925.0,12:10,105,128,233,45.06,105,34,31,15,16,0,1,1,1047.0,0:15,0,0,0,181.0,0:2,830000
8473537,Viktor,Stalberg,1986-01-17,LW,L,2013-14,70,8,10,18,0.26,-14,114,7.02,32,52852.0,12:35,1,2,3,33.33,55,25,32,23,9,0,0,0,819.0,0:11,0,0,0,224.0,0:3,3000000
8473542,Tom,Sestito,1987-09-28,LW,L,2013-14,77,5,4,9,0.12,-14,31,16.13,213,29832.0,6:27,3,8,11,27.27,121,12,8,7,1,1,0,1,493.0,0:6,0,0,0,0.0,0:0,750000
8473544,Derick,Brassard,1987-09-22,C,L,2013-14,81,18,27,45,0.56,2,159,11.32,46,76772.0,15:47,469,508,977,48.0,124,19,28,28,0,7,11,18,12293.0,2:31,0,0,0,137.0,0:1,3200000
8473546,Michael,Grabner,1987-10-05,RW,L,2013-14,64,12,14,26,0.41,-10,137,8.76,12,54502.0,14:11,7,8,15,46.67,68,25,54,26,28,0,0,0,1081.0,0:16,3,0,3,7882.0,2:3,3000000
8473548,Phil,Kessel,1987-10-02,RW,R,2013-14,82,37,43,80,0.98,-5,305,12.13,27,101678.0,20:39,2,12,14,14.29,25,30,37,88,-51,8,12,20,15429.0,3:8,0,0,0,143.0,0:1,5400000
8473558,Cory,Emmerton,1988-06-01,C,L,2013-14,18,0,2,2,0.11,-2,22,0.0,4,9669.0,8:57,58,49,107,54.21,7,5,4,1,3,0,0,0,2.0,0:0,0,0,0,1548.0,1:26,533333
8473562,John,McCarthy,1986-08-09,C,L,2013-14,36,1,1,2,0.06,-11,49,2.04,4,23883.0,11:3,71,62,133,53.38,25,17,9,9,0,0,0,0,266.0,0:7,0,0,0,2586.0,1:11,612500
8473563,Nicklas,Backstrom,1987-11-23,C,L,2013-14,82,18,61,79,0.96,-20,196,9.18,54,97426.0,19:48,714,701,1415,50.46,89,54,54,24,30,6,38,44,18066.0,3:40,1,0,1,4772.0,0:58,6700000
8473564,Michael,Frolik,1988-02-17,RW,L,2013-14,81,15,27,42,0.52,8,189,7.94,12,81031.0,16:40,43,25,68,63.24,41,51,53,24,29,1,1,2,4827.0,0:59,0,1,1,6362.0,1:18,2333333
8473565,Brian,Strait,1988-01-04,D,L,2013-14,47,3,6,9,0.19,-14,40,7.5,14,50631.0,17:57,0,0,0,0.0,65,86,16,21,-5,0,0,0,243.0,0:5,0,1,1,7453.0,2:38,775000
8473571,Jamie,McBain,1988-02-25,D,R,2013-14,69,6,11,17,0.25,-13,98,6.12,14,83488.0,20:9,0,0,0,0.0,34,113,12,31,-19,2,3,5,11112.0,2:41,0,1,1,4314.0,1:2,1800000
8473573,Artem,Anisimov,1988-05-24,C,L,2013-14,81,22,17,39,0.48,-2,162,13.58,20,80658.0,16:35,476,489,965,49.33,31,55,51,19,32,3,3,6,9860.0,2:1,2,0,2,10177.0,2:5,3283333
8473574,Shawn,Matthias,1988-02-19,LW,L,2013-14,77,12,11,23,0.3,-3,127,9.45,26,60125.0,13:0,183,250,433,42.26,93,29,33,15,18,0,0,0,1663.0,0:21,0,0,0,7909.0,1:42,1750000
8473579,Nikolay,Kulemin,1986-07-14,LW,L,2013-14,70,9,11,20,0.29,-4,81,11.11,24,68106.0,16:12,38,70,108,35.19,153,63,30,15,15,0,0,0,286.0,0:4,0,0,0,10889.0,2:35,2800000
8473584,Andrew,MacDonald,1986-09-07,D,L,2013-14,82,4,24,28,0.34,-22,92,4.35,50,121170.0,24:37,0,0,0,0.0,69,242,23,60,-37,2,9,11,14159.0,2:52,0,1,1,11668.0,2:22,550000
8473588,Erik,Condra,1986-08-06,RW,R,2013-14,76,6,10,16,0.21,0,85,7.06,30,53118.0,11:38,1,14,15,6.67,28,44,37,30,7,0,0,0,253.0,0:3,1,1,2,10922.0,2:23,1250000
8473589,Chris,Summers,1988-02-05,D,L,2013-14,18,2,1,3,0.17,0,17,11.76,15,16116.0,14:55,0,0,0,0.0,33,25,0,4,-4,0,0,0,16.0,0:0,0,0,0,1929.0,1:47,550000
8473600,Benn,Ferriero,1987-04-29,RW,R,2013-14,2,0,0,0,0.0,0,0,,0,523.0,4:21,0,0,0,0.0,1,0,0,0,0,0,0,0,0.0,0:0,0,0,0,0.0,0:0,550000
8473604,Jonathan,Toews,1988-04-29,C,L,2013-14,76,28,40,68,0.89,26,193,14.51,34,93328.0,20:28,884,660,1544,57.25,29,20,51,30,21,5,10,15,14463.0,3:10,3,2,5,7075.0,1:33,6300000
8473618,Mathieu,Perreault,1988-01-05,C,L,2013-14,69,18,25,43,0.62,13,120,15.0,36,57412.0,13:52,437,393,830,52.65,73,15,19,19,0,4,5,9,8970.0,2:10,0,0,0,113.0,0:1,1050000
8473646,Ryan,Carter,1983-08-03,LW,L,2013-14,62,7,3,10,0.16,-6,69,10.14,35,42143.0,11:19,16,20,36,44.44,72,24,14,9,5,0,0,0,97.0,0:1,0,1,1,3827.0,1:1,775000
8473658,Victor,Bartley,1988-02-17,D,L,2013-14,50,1,5,6,0.12,0,21,4.76,23,46093.0,15:21,0,0,0,0.0,81,79,14,7,7,0,0,0,193.0,0:3,0,0,0,4546.0,1:30,666667
8473673,David,Schlemko,1987-05-07,D,L,2013-14,48,1,8,9,0.19,2,61,1.64,18,47224.0,16:23,0,0,0,0.0,61,79,8,12,-4,0,3,3,2909.0,1:0,0,0,0,5489.0,1:54,1187500
8473682,Andrew,Ebbett,1983-01-02,C,L,2013-14,9,0,1,1,0.11,-4,9,0.0,0,5967.0,11:3,15,20,35,42.86,10,7,2,2,0,0,0,0,261.0,0:29,0,0,0,266.0,0:29,550000
8473700,Ryan,Wilson,1987-02-03,D,L,2013-14,28,0,6,6,0.21,1,23,0.0,12,24640.0,14:40,0,1,1,0.0,53,17,5,9,-4,0,0,0,412.0,0:14,0,0,0,1897.0,1:7,2250000
8473712,Frazer,McLaren,1987-10-29,LW,L,2013-14,27,0,0,0,0.0,-2,4,0.0,77,6490.0,4:0,1,0,1,100.0,24,3,0,3,-3,0,0,0,0.0,0:0,0,0,0,7.0,0:0,700000
8473722,John,Scott,1982-09-26,LW,L,2013-14,56,1,0,1,0.02,-12,16,6.25,125,22696.0,6:45,0,0,0,0.0,95,21,3,4,-1,0,0,0,459.0,0:8,0,0,0,0.0,0:0,750000
8473908,Kevin,Westgarth,1984-02-07,RW,R,2013-14,48,4,3,7,0.15,-4,31,12.9,68,18701.0,6:29,1,4,5,20.0,45,10,8,12,-4,0,0,0,60.0,0:1,0,0,0,0.0,0:0,725000
8473911,Steven,Pinizzotto,1984-04-26,RW,R,2013-14,6,0,2,2,0.33,-1,2,0.0,15,3472.0,9:38,0,0,0,0.0,10,1,1,1,0,0,0,0,13.0,0:2,0,0,0,0.0,0:0,650000
8473914,Mark,Letestu,1985-02-04,C,R,2013-14,82,12,22,34,0.41,1,122,9.84,20,72276.0,14:41,374,356,730,51.23,63,25,27,13,14,5,6,11,6062.0,1:13,1,2,3,11211.0,2:16,1250000
8473921,Joe,Piskula,1984-07-05,D,L,2013-14,2,0,0,0,0.0,1,2,0.0,0,1461.0,12:10,0,0,0,0.0,2,0,0,2,-2,0,0,0,49.0,0:24,0,0,0,0.0,0:0,550000
8473927,Brad,Mills,1983-05-03,C,R,2013-14,3,0,0,0,0.0,-1,2,0.0,0,1859.0,10:19,8,6,14,57.14,9,1,1,1,0,0,0,0,1.0,0:0,0,0,0,242.0,1:20,550000
8473932,Darroll,Powe,1985-06-22,C,L,2013-14,1,0,0,0,0.0,-2,0,,0,513.0,8:33,1,0,1,100.0,1,0,0,0,0,0,0,0,0.0,0:0,0,0,0,61.0,1:1,1066667
8473933,Ben,Lovejoy,1984-02-20,D,R,2013-14,78,5,13,18,0.23,21,107,4.67,39,90778.0,19:23,0,0,0,0.0,215,150,17,32,-15,0,1,1,969.0,0:12,0,0,0,9295.0,1:59,1100000
8473942,Trevor,Smith,1985-02-08,C,L,2013-14,28,4,5,9,0.32,-3,24,16.67,4,17425.0,10:22,115,143,258,44.57,45,16,4,3,1,0,1,1,672.0,0:24,0,0,0,455.0,0:16,550000
8473953,Derek,Smith,1984-10-13,D,L,2013-14,14,0,1,1,0.07,-10,12,0.0,2,8006.0,9:31,2,1,3,66.67,6,6,2,3,-1,0,0,0,3.0,0:0,0,0,0,44.0,0:3,775000
8473962,Teddy,Purcell,1985-09-08,LW,R,2013-14,81,12,30,42,0.52,-3,157,7.64,14,80027.0,16:27,4,12,16,25.0,13,12,36,40,-4,3,14,17,14765.0,3:2,0,0,0,109.0,0:1,4500000
8473970,Rob,Klinkhammer,1986-08-12,LW,L,2013-14,72,11,9,20,0.28,6,103,10.68,19,49108.0,11:22,1,5,6,16.67,168,7,14,13,1,1,0,1,275.0,0:3,0,0,0,1000.0,0:13,625000
8473986,Alex,Killorn,1989-09-14,LW,L,2013-14,82,17,24,41,0.5,8,173,9.83,63,82552.0,16:46,74,98,172,43.02,77,31,32,43,-11,3,5,8,9452.0,1:55,0,0,0,740.0,0:9,875000
8473989,Luke,Gazdic,1989-07-25,LW,L,2013-14,67,2,2,4,0.06,-8,30,6.67,127,23320.0,5:48,3,0,3,100.0,103,22,6,11,-5,0,0,0,169.0,0:2,0,0,0,17.0,0:0,635000
8473991,Karl,Alzner,1988-09-24,D,L,2013-14,82,2,16,18,0.22,-7,95,2.11,26,101033.0,20:32,0,0,0,0.0,73,158,28,33,-5,0,1,1,304.0,0:3,0,2,2,17397.0,3:32,2800000
8473992,Justin,Falk,1988-10-11,D,L,2013-14,21,0,2,2,0.1,-5,10,0.0,20,15034.0,11:55,0,0,0,0.0,39,28,0,9,-9,0,0,0,22.0,0:1,0,0,0,880.0,0:41,975000
8473994,Jamie,Benn,1989-07-18,LW,L,2013-14,81,34,45,79,0.98,21,279,12.19,64,93080.0,19:9,411,367,778,52.83,118,60,70,68,2,5,14,19,17843.0,3:40,1,2,3,3580.0,0:44,5250000
8474001,TJ,Galiardi,1988-04-22,LW,L,2013-14,62,4,13,17,0.27,-13,100,4.0,21,54351.0,14:36,62,93,155,40.0,77,43,23,16,7,0,0,0,615.0,0:9,1,1,2,4067.0,1:5,1250000
8474005,Alex,Grant,1989-01-20,D,R,2013-14,2,2,0,2,1.0,3,2,100.0,2,1461.0,12:10,0,0,0,0.0,1,0,0,0,0,0,0,0,0.0,0:0,0,0,0,1.0,0:0,550000
8474008,Paul,Carey,1988-09-24,C,L,2013-14,12,0,0,0,0.0,2,6,0.0,0,4633.0,6:26,0,0,0,0.0,11,2,1,1,0,0,0,0,227.0,0:18,0,0,0,0.0,0:0,675000
8474009,Nick,Bonino,1988-04-20,C,L,2013-14,77,22,27,49,0.64,14,159,13.84,22,74981.0,16:13,583,611,1194,48.83,28,68,37,35,2,7,13,20,13235.0,2:51,0,0,0,7821.0,1:41,700000
8474012,John,Albert,1989-01-19,C,L,2013-14,9,1,0,1,0.11,-3,5,20.0,0,2761.0,5:6,9,12,21,42.86,8,3,1,0,1,0,0,0,0.0,0:0,0,0,0,0.0,0:0,585000
8474013,Ian,Cole,1989-02-21,D,L,2013-14,46,3,8,11,0.24,15,45,6.67,31,41632.0,15:5,0,0,0,0.0,24,68,9,9,0,0,2,2,667.0,0:14,0,0,0,1767.0,0:38,825000
8474025,Eric,Tangradi,1989-02-10,LW,L,2013-14,55,3,3,6,0.11,-6,52,5.77,21,28526.0,8:38,3,0,3,100.0,105,17,10,12,-2,0,0,0,447.0,0:8,0,0,0,24.0,0:0,675000
8474027,Justin,Braun,1987-02-10,D,R,2013-14,82,4,13,17,0.21,19,121,3.31,20,103251.0,20:59,0,0,0,0.0,77,146,40,39,1,1,0,1,5054.0,1:1,0,0,0,10799.0,2:11,1250000
8474030,Aaron,Palushaj,1989-09-07,RW,R,2013-14,2,0,0,0,0.0,-1,2,0.0,0,1119.0,9:19,0,1,1,0.0,3,0,0,1,-1,0,0,0,32.0,0:16,0,0,0,36.0,0:18,600000
8474031,Kevin,Shattenkirk,1989-01-29,D,R,2013-14,81,10,35,45,0.56,1,188,5.32,38,99964.0,20:34,0,0,0,0.0,72,101,38,37,1,7,19,26,16241.0,3:20,0,1,1,3384.0,0:41,4250000
8474034,Patrick,Maroon,1988-04-23,LW,L,2013-14,62,11,18,29,0.47,11,93,11.83,101,45804.0,12:18,7,8,15,46.67,124,16,15,15,0,1,3,4,6417.0,1:43,0,0,0,56.0,0:0,575000
8474037,James,van Riemsdyk,1989-05-04,LW,L,2013-14,80,30,31,61,0.76,-9,279,10.75,50,101071.0,21:3,46,67,113,40.71,118,29,36,41,-5,9,6,15,15099.0,3:8,2,2,4,6997.0,1:27,4250000
8474038,Paul,Byron,1989-04-27,LW,L,2013-14,47,7,14,21,0.45,6,46,15.22,27,40729.0,14:26,7,25,32,21.88,63,10,29,13,16,2,1,3,2046.0,0:43,1,3,4,3723.0,1:19,643500
8474040,Sam,Gagner,1989-08-10,C,R,2013-14,67,10,27,37,0.55,-29,143,6.99,41,73874.0,18:22,451,512,963,46.83,33,34,28,47,-19,1,6,7,10499.0,2:36,0,1,1,1639.0,0:24,4800000
8474048,Keith,Aulie,1989-06-11,D,L,2013-14,15,0,1,1,0.07,-3,6,0.0,9,8841.0,9:49,0,0,0,0.0,17,15,0,1,-1,0,0,0,0.0,0:0,0,0,0,377.0,0:25,975000
8474052,Chris,Terry,1989-04-07,LW,L,2013-14,10,0,2,2,0.2,-4,13,0.0,0,7249.0,12:4,0,0,0,0.0,9,6,7,3,4,0,2,2,1197.0,1:59,0,0,0,0.0,0:0,537500
8474053,Logan,Couture,1989-03-28,C,L,2013-14,65,23,31,54,0.83,21,233,9.87,20,73855.0,18:56,479,471,950,50.42,16,68,39,43,-4,4,9,13,13249.0,3:23,2,2,4,5306.0,1:21,2875000
8474056,P.K.,Subban,1989-05-13,D,R,2013-14,82,10,43,53,0.65,-4,204,4.9,81,121112.0,24:36,0,0,0,0.0,135,125,26,83,-57,4,19,23,22936.0,4:39,0,0,0,3302.0,0:40,2763889
8474059,Linus,Omark,1987-02-05,LW,L,2013-14,14,0,2,2,0.14,-6,10,0.0,6,10504.0,12:30,0,1,1,0.0,4,3,2,2,0,0,2,2,1580.0,1:52,0,0,0,0.0,0:0,-111
8474061,Anthony,Peluso,1989-04-18,RW,R,2013-14,53,2,3,5,0.09,-5,24,8.33,65,18364.0,5:46,1,2,3,33.33,85,3,7,2,5,0,0,0,141.0,0:2,0,0,0,0.0,0:0,562500
8474062,Riley,Nash,1989-05-09,C,R,2013-14,73,10,14,24,0.33,0,86,11.63,29,55492.0,12:40,306,360,666,45.95,81,22,54,18,36,1,2,3,3500.0,0:47,0,1,1,3315.0,0:45,575000
8474066,Thomas,Hickey,1989-02-08,D,L,2013-14,82,4,18,22,0.27,5,96,4.17,34,92836.0,18:52,0,0,0,0.0,72,132,34,57,-23,0,1,1,1362.0,0:16,0,1,1,9736.0,1:58,675000
8474068,Kyle,Turris,1989-08-14,C,R,2013-14,82,26,32,58,0.71,22,215,12.09,39,92147.0,18:43,724,705,1429,50.66,45,33,51,39,12,6,8,14,11849.0,2:24,2,1,3,8529.0,1:44,3500000
8474074,Paul,Postma,1989-02-22,D,R,2013-14,20,1,2,3,0.15,1,19,5.26,8,19357.0,16:7,0,0,0,0.0,20,29,3,17,-14,0,0,0,839.0,0:41,0,0,0,417.0,0:20,712500
8474077,Carson,McMillan,1988-09-10,RW,R,2013-14,1,0,0,0,0.0,0,0,,0,486.0,8:6,0,0,0,0.0,0,2,0,0,0,0,0,0,0.0,0:0,0,0,0,58.0,0:58,-111
8474089,Brad,Malone,1989-05-20,C,L,2013-14,32,3,2,5,0.16,-4,16,18.75,23,12994.0,6:46,45,51,96,46.88,79,5,4,7,-3,0,0,0,111.0,0:3,0,0,0,0.0,0:0,735000
8474090,Brendan,Smith,1989-02-08,D,L,2013-14,71,5,14,19,0.27,-2,90,5.56,68,78335.0,18:23,0,0,0,0.0,57,69,18,49,-31,1,0,1,721.0,0:10,0,0,0,3440.0,0:48,1262500
8474091,Brandon,Sutter,1989-02-14,C,R,2013-14,81,13,13,26,0.32,-9,144,9.03,12,76635.0,15:46,549,601,1150,47.74,69,40,29,13,16,2,3,5,5311.0,1:5,3,0,3,11236.0,2:18,2066667
8474094,Matt,Halischuk,1988-06-01,RW,R,2013-14,46,5,5,10,0.22,-3,56,8.93,6,31286.0,11:20,2,2,4,50.0,19,27,12,5,7,0,0,0,174.0,0:3,0,0,0,2699.0,0:58,650000
8474095,Dana,Tyrell,1989-04-23,C,L,2013-14,7,0,0,0,0.0,0,4,0.0,4,3879.0,9:14,2,4,6,33.33,10,3,1,1,0,0,0,0,2.0,0:0,0,0,0,504.0,1:12,600000
8474096,Nick,Spaling,1988-09-19,C,L,2013-14,71,13,19,32,0.45,2,85,15.29,14,68245.0,16:1,88,79,167,52.69,42,32,30,7,23,3,3,6,5036.0,1:10,1,0,1,6467.0,1:31,1500000
8474098,Colton,Sceviour,1989-04-20,C,R,2013-14,26,8,4,12,0.46,-3,69,11.59,4,23213.0,14:52,17,26,43,39.53,19,16,7,13,-6,2,0,2,3000.0,1:55,0,0,0,576.0,0:22,600000
8474100,Dwight,King,1989-07-05,LW,L,2013-14,77,15,15,30,0.39,16,111,13.51,18,69496.0,15:2,2,3,5,40.0,114,17,15,33,-18,0,1,1,2281.0,0:29,2,0,2,5915.0,1:16,750000
8474102,David,Perron,1988-05-28,LW,R,2013-14,78,28,29,57,0.73,-16,220,12.73,90,89508.0,19:7,13,26,39,33.33,116,20,52,42,10,8,5,13,13246.0,2:49,1,0,1,2219.0,0:28,3812500
8474125,Carl,Gunnarsson,1986-11-09,D,L,2013-14,80,3,14,17,0.21,12,48,6.25,34,93167.0,19:24,0,0,0,0.0,166,176,29,65,-36,0,1,1,1058.0,0:13,0,0,0,14105.0,2:56,3150000
8474130,Corey,Tropp,1989-07-25,RW,R,2013-14,53,2,9,11,0.21,3,35,5.71,37,28433.0,8:56,0,1,1,0.0,112,28,9,4,5,0,0,0,237.0,0:4,0,0,0,280.0,0:5,577500
8474134,Yannick,Weber,1988-09-23,D,R,2013-14,49,6,4,10,0.2,-7,70,8.57,16,35033.0,11:54,0,0,0,0.0,39,37,9,9,0,3,2,5,4612.0,1:34,0,0,0,704.0,0:14,650000
8474135,Brett,Bellemore,1988-06-25,D,R,2013-14,64,2,6,8,0.12,-1,54,3.7,45,67093.0,17:28,0,0,0,0.0,169,98,21,39,-18,0,0,0,304.0,0:4,0,0,0,7714.0,2:0,600000
8474137,Drayson,Bowman,1989-03-08,LW,L,2013-14,70,4,8,12,0.17,-2,80,5.0,16,43496.0,10:21,6,4,10,60.0,45,18,19,12,7,0,0,0,1508.0,0:21,0,0,0,1462.0,0:20,600000
8474138,Dustin,Jeffrey,1988-02-27,LW,L,2013-14,34,2,2,4,0.12,-4,30,6.67,2,19525.0,9:34,55,60,115,47.83,6,5,9,5,4,0,0,0,671.0,0:19,0,0,0,294.0,0:8,625000
8474141,Patrick,Kane,1988-11-19,RW,L,2013-14,69,29,40,69,1.0,7,227,12.78,22,81186.0,19:36,4,4,8,50.0,16,15,44,23,21,10,15,25,13687.0,3:18,0,0,0,58.0,0:0,6300000
8474145,Robert,Bortuzzo,1989-03-18,D,R,2013-14,54,0,10,10,0.19,-3,50,0.0,74,50151.0,15:28,0,1,1,0.0,137,73,6,11,-5,0,0,0,123.0,0:2,0,1,1,4251.0,1:18,600000
8474150,Mikael,Backlund,1989-03-17,C,L,2013-14,76,18,21,39,0.51,4,178,10.11,32,84521.0,18:32,628,694,1322,47.5,64,62,63,40,23,5,6,11,8484.0,1:51,4,0,4,8827.0,1:56,1500000
8474151,Ryan,McDonagh,1989-06-13,D,L,2013-14,77,14,29,43,0.56,11,177,7.91,36,114653.0,24:49,0,0,0,0.0,88,131,51,66,-15,2,11,13,13268.0,2:52,3,1,4,12579.0,2:43,4700000
8474157,Max,Pacioretty,1988-11-20,LW,L,2013-14,73,39,21,60,0.82,8,270,14.44,35,80992.0,18:29,6,4,10,60.0,69,33,28,18,10,10,7,17,13222.0,3:1,1,0,1,4618.0,1:3,4500000
8474161,Jakub,Voracek,1989-08-15,RW,L,2013-14,82,23,39,62,0.76,11,235,9.79,22,84895.0,17:15,4,2,6,66.67,19,20,33,30,3,8,15,23,16550.0,3:21,0,0,0,240.0,0:2,4250000
8474162,Jake,Muzzin,1989-02-21,D,L,2013-14,76,5,19,24,0.32,8,175,2.86,58,86779.0,19:1,0,0,0,0.0,169,82,14,57,-43,1,4,5,10988.0,2:24,0,0,0,2035.0,0:26,1000000
8474164,Jonathon,Blum,1989-01-30,D,R,2013-14,15,0,1,1,0.07,-1,11,0.0,0,10498.0,11:39,0,0,0,0.0,10,13,1,2,-1,0,0,0,257.0,0:17,0,0,0,153.0,0:10,650000
8474166,Alec,Martinez,1987-07-26,D,L,2013-14,61,11,11,22,0.36,17,79,13.92,14,57397.0,15:40,0,0,0,0.0,96,75,5,27,-22,3,5,8,7240.0,1:58,0,0,0,1529.0,0:25,1100000
8474168,Joakim,Andersson,1989-02-05,C,L,2013-14,65,8,9,17,0.26,-11,78,10.26,12,53928.0,13:49,345,326,671,51.42,26,25,18,27,-9,0,0,0,971.0,0:14,0,1,1,10222.0,2:37,732500
8474176,Carl,Hagelin,1988-08-23,LW,L,2013-14,72,17,16,33,0.46,8,144,11.81,44,67089.0,15:31,0,5,5,0.0,64,33,32,34,-2,0,0,0,893.0,0:12,1,0,1,7228.0,1:40,2250000
8474184,Keaton,Ellerby,1988-11-05,D,L,2013-14,51,2,4,6,0.12,4,33,6.06,2,42561.0,13:54,0,0,0,0.0,76,46,13,49,-36,1,0,1,285.0,0:5,0,0,0,537.0,0:10,735000
8474189,Lars,Eller,1989-05-08,C,L,2013-14,77,12,14,26,0.34,-15,137,8.76,68,73742.0,15:57,521,458,979,53.22,130,58,30,25,5,2,1,3,5122.0,1:6,1,1,2,6504.0,1:24,1150000
8474190,Wayne,Simmonds,1988-08-26,RW,R,2013-14,82,29,31,60,0.73,-4,209,13.88,106,82510.0,16:46,1,1,2,50.0,132,35,36,27,9,15,9,24,16722.0,3:23,0,0,0,199.0,0:2,3975000
8474192,Matt,Frattin,1988-01-03,RW,R,2013-14,44,2,5,7,0.16,-4,61,3.28,11,31712.0,12:0,2,2,4,50.0,85,11,6,11,-5,1,1,2,3003.0,1:8,0,0,0,45.0,0:1,875000
8474201,Pierre-Cedric,Labrie,1986-12-06,LW,L,2013-14,13,0,0,0,0.0,-4,2,0.0,20,5363.0,6:52,2,0,2,100.0,24,2,1,0,1,0,0,0,31.0,0:2,0,0,0,20.0,0:1,625000
8474207,Nick,Holden,1987-05-15,D,L,2013-14,54,10,15,25,0.46,12,66,15.15,22,60533.0,18:40,0,0,0,0.0,118,57,10,22,-12,2,5,7,5608.0,1:43,0,1,1,5044.0,1:33,600000
8474218,Jason,Demers,1988-06-09,D,R,2013-14,75,5,29,34,0.45,14,105,4.76,30,87693.0,19:29,0,0,0,0.0,69,107,40,69,-29,1,8,9,8663.0,1:55,0,1,1,6378.0,1:25,1500000
8474236,Brett,Gallant,1988-12-28,LW,L,2013-14,4,0,0,0,0.0,0,3,0.0,17,1652.0,6:53,0,0,0,0.0,9,0,0,0,0,0,0,0,0.0,0:0,0,0,0,0.0,0:0,550000
8474250,Zack,Smith,1988-04-05,LW,L,2013-14,82,13,9,22,0.27,-9,154,8.44,111,76416.0,15:31,680,611,1291,52.67,175,28,45,39,6,0,1,1,1616.0,0:19,1,1,2,7927.0,1:36,1887500
8474291,Jay,Beagle,1985-10-16,C,R,2013-14,62,4,5,9,0.15,-9,60,6.67,28,41832.0,11:14,296,277,573,51.66,93,32,18,7,11,0,0,0,346.0,0:5,0,0,0,3367.0,0:54,900000
8474497,Michael,Kostka,1985-11-28,D,R,2013-14,28,4,7,11,0.39,10,49,8.16,8,25916.0,15:25,0,0,0,0.0,26,33,4,9,-5,0,0,0,2157.0,1:17,0,0,0,256.0,0:9,625000
8474498,Jesse,Winchester,1983-10-04,C,R,2013-14,52,9,9,18,0.35,-2,100,9.0,38,39740.0,12:44,63,67,130,48.46,65,21,9,9,0,1,0,1,1087.0,0:20,0,0,0,5964.0,1:54,600000
8474519,Jack,Hillen,1986-01-24,D,L,2013-14,13,0,1,1,0.08,-4,12,0.0,4,14251.0,18:16,0,0,0,0.0,10,16,0,11,-11,0,0,0,198.0,0:15,0,0,0,1127.0,1:26,700000
8474520,Jason,Garrison,1984-11-13,D,L,2013-14,81,7,26,33,0.41,-5,181,3.87,57,101558.0,20:53,0,0,0,0.0,58,128,30,44,-14,4,11,15,13268.0,2:43,1,2,3,7227.0,1:29,4600000
8474535,Chris,Mueller,1986-03-06,C,R,2013-14,9,0,0,0,0.0,-2,8,0.0,0,4994.0,9:14,29,25,54,53.7,11,4,1,1,0,0,0,0,20.0,0:2,0,0,0,100.0,0:11,600000
8474551,Ville,Leino,1983-10-06,LW,L,2013-14,58,0,15,15,0.26,-16,38,0.0,10,50231.0,14:26,125,162,287,43.55,26,25,23,17,6,0,6,6,6221.0,1:47,0,0,0,38.0,0:0,4500000
8474563,Drew,Doughty,1989-12-08,D,R,2013-14,78,10,27,37,0.47,17,177,5.65,64,120335.0,25:42,0,0,0,0.0,180,91,16,82,-66,6,10,16,18228.0,3:53,0,1,1,12164.0,2:35,7000000
8474564,Steven,Stamkos,1990-02-07,C,R,2013-14,37,25,15,40,1.08,9,124,20.16,18,44953.0,20:14,260,269,529,49.15,50,16,24,13,11,9,4,13,8501.0,3:49,1,0,1,1259.0,0:34,7500000
8474565,Alex,Pietrangelo,1990-01-18,D,R,2013-14,81,8,43,51,0.63,20,164,4.88,32,123245.0,25:21,0,0,0,0.0,24,164,37,34,3,2,16,18,13649.0,2:48,0,1,1,16324.0,3:21,6500000
8474567,Zach,Bogosian,1990-07-15,D,R,2013-14,55,3,8,11,0.2,3,134,2.24,48,75601.0,22:54,0,0,0,0.0,94,75,17,47,-30,0,1,1,5314.0,1:36,0,0,0,7351.0,2:13,5142857
8474568,Luke,Schenn,1989-11-02,D,R,2013-14,79,4,8,12,0.15,0,78,5.13,58,78397.0,16:32,0,0,0,0.0,260,113,17,36,-19,0,0,0,124.0,0:1,0,1,1,10204.0,2:9,3600000
8474569,Colin,Wilson,1989-10-20,C,L,2013-14,81,11,22,33,0.41,-1,112,9.82,21,73950.0,15:12,166,177,343,48.4,49,35,33,27,6,2,3,5,7620.0,1:34,0,0,0,29.0,0:0,2000000
8474570,Cody,Hodgson,1990-02-18,C,R,2013-14,72,20,24,44,0.61,-26,182,10.99,20,78377.0,18:8,453,516,969,46.75,47,22,24,36,-12,9,10,19,13565.0,3:8,0,0,0,2039.0,0:28,4250000
8474571,Mikkel,Boedker,1989-12-16,LW,L,2013-14,82,19,32,51,0.62,-9,166,11.45,20,85685.0,17:24,3,4,7,42.86,105,16,33,18,15,5,11,16,10839.0,2:12,0,0,0,1208.0,0:14,2550000
8474573,Josh,Bailey,1989-10-02,RW,L,2013-14,77,8,30,38,0.49,-8,98,8.16,26,73187.0,15:50,113,115,228,49.56,44,29,39,39,0,2,8,10,8378.0,1:48,0,0,0,2118.0,0:27,3300000
8474574,Tyler,Myers,1990-02-01,D,R,2013-14,62,9,13,22,0.35,-26,99,9.09,58,81463.0,21:53,0,0,0,0.0,107,81,18,41,-23,3,6,9,9268.0,2:29,0,0,0,8966.0,2:24,5500000
8474576,Zach,Boychuk,1989-10-04,LW,L,2013-14,11,1,3,4,0.36,2,15,6.67,0,6731.0,10:11,0,1,1,0.0,17,2,4,1,3,0,0,0,602.0,0:54,0,0,0,0.0,0:0,550000
8474577,Joe,Colborne,1990-01-30,C,L,2013-14,80,10,18,28,0.35,-17,80,12.5,34,68480.0,14:16,214,227,441,48.53,129,33,30,38,-8,1,3,4,6772.0,1:24,0,0,0,1259.0,0:15,600000
8474578,Erik,Karlsson,1990-05-31,D,R,2013-14,82,20,54,74,0.9,-15,257,7.78,36,133199.0,27:4,0,0,0,0.0,122,101,68,115,-47,5,26,31,20128.0,4:5,0,0,0,7416.0,1:30,6500000
8474579,Luca,Sbisa,1990-01-30,D,L,2013-14,30,1,5,6,0.2,0,30,3.33,43,30702.0,17:3,0,0,0,0.0,83,38,7,10,-3,0,0,0,428.0,0:14,0,0,0,2105.0,1:10,2175000
8474581,Jake,Gardiner,1990-07-04,D,L,2013-14,80,10,21,31,0.39,-3,136,7.35,19,101166.0,21:4,0,0,0,0.0,108,87,33,68,-35,2,9,11,10946.0,2:16,1,0,1,2962.0,0:37,875000
8474582,Mattias,Tedenby,1990-02-21,RW,L,2013-14,15,1,0,1,0.07,-8,9,11.11,10,9021.0,10:1,0,2,2,0.0,16,2,4,1,3,0,0,0,47.0,0:3,0,0,0,32.0,0:2,600000
8474584,Michael,Del Zotto,1990-06-24,D,L,2013-14,67,3,13,16,0.24,-9,90,3.33,18,69175.0,17:12,0,1,1,0.0,78,75,15,31,-16,1,4,5,5306.0,1:19,0,0,0,1260.0,0:18,2550000
8474586,Jordan,Eberle,1990-05-15,C,R,2013-14,80,28,37,65,0.81,-11,200,14.0,18,93827.0,19:32,8,13,21,38.1,51,40,61,71,-10,7,13,20,14592.0,3:2,1,0,1,3312.0,0:41,6000000
8474589,Tyler,Ennis,1989-10-06,LW,L,2013-14,80,21,22,43,0.54,-25,210,10.0,42,90490.0,18:51,242,383,625,38.72,89,53,38,26,12,6,10,16,15632.0,3:15,0,0,0,113.0,0:1,2812500
8474590,John,Carlson,1990-01-10,D,R,2013-14,82,10,27,37,0.45,-3,208,4.81,22,120608.0,24:30,0,1,1,0.0,64,177,55,53,2,5,17,22,15476.0,3:8,0,1,1,18423.0,3:44,3966667
8474594,Slava,Voynov,1990-01-15,D,R,2013-14,82,4,30,34,0.41,6,143,2.8,44,109710.0,22:17,1,0,1,100.0,165,69,16,75,-59,1,12,13,13907.0,2:49,0,0,0,10032.0,2:2,4166666
8474597,Cody,Goloubef,1989-11-30,D,R,2013-14,5,0,0,0,0.0,0,4,0.0,2,2947.0,9:49,0,0,0,0.0,3,7,0,0,0,0,0,0,0.0,0:0,0,0,0,8.0,0:1,826875
8474598,Nicolas,Deschamps,1990-01-06,C,L,2013-14,3,0,0,0,0.0,-1,2,0.0,0,1227.0,6:49,0,0,0,0.0,1,0,0,0,0,0,0,0,0.0,0:0,0,0,0,0.0,0:0,726000
8474600,Roman,Josi,1990-06-01,D,L,2013-14,72,13,27,40,0.56,-2,168,7.74,18,114126.0,26:25,0,0,0,0.0,32,150,22,34,-12,3,10,13,13372.0,3:5,0,0,0,11052.0,2:33,4000000
8474601,Yann,Sauve,1990-02-18,D,L,2013-14,3,0,0,0,0.0,-2,1,0.0,0,2210.0,12:16,0,0,0,0.0,5,2,1,0,1,0,0,0,0.0,0:0,0,0,0,0.0,0:0,708750
8474602,Justin,Schultz,1990-07-06,D,R,2013-14,74,11,22,33,0.45,-22,109,10.09,16,103659.0,23:20,0,1,1,0.0,30,107,20,63,-43,1,11,12,15286.0,3:26,0,0,0,4332.0,0:58,925000
8474603,Eric,O'Dell,1990-06-21,C,R,2013-14,30,3,4,7,0.23,-2,17,17.65,10,17443.0,9:41,78,78,156,50.0,31,12,15,4,11,0,0,0,630.0,0:21,0,0,0,5.0,0:0,630000
8474604,Aaron,Ness,1990-05-18,D,L,2013-14,20,1,2,3,0.15,-13,23,4.35,10,17753.0,14:47,0,0,0,0.0,14,26,3,7,-4,0,0,0,358.0,0:17,0,0,0,880.0,0:44,791667
8474605,Patrick,Wiercioch,1990-09-12,D,L,2013-14,53,4,19,23,0.43,-1,97,4.12,20,52050.0,16:22,0,2,2,0.0,54,48,4,27,-23,3,9,12,8589.0,2:42,0,0,0,1008.0,0:19,2000000
8474606,Colby,Robak,1990-04-24,D,L,2013-14,16,0,2,2,0.12,-4,15,0.0,6,17830.0,18:34,0,0,0,0.0,17,19,4,4,0,0,0,0,427.0,0:26,0,1,1,2193.0,2:17,675000
8474609,Luke,Adam,1990-06-18,C,L,2013-14,12,1,0,1,0.08,0,16,6.25,4,9240.0,12:50,10,16,26,38.46,16,1,1,0,1,0,0,0,406.0,0:33,0,0,0,0.0,0:0,735000
8474610,Zac,Dalpe,1989-11-01,C,R,2013-14,55,4,3,7,0.13,-7,52,7.69,6,23529.0,7:7,106,125,231,45.89,36,9,4,2,2,1,0,1,806.0,0:14,0,0,0,85.0,0:1,550000
8474611,Cameron,Gaunce,1990-03-19,D,L,2013-14,9,0,0,0,0.0,1,9,0.0,7,7472.0,13:50,0,0,0,0.0,11,4,3,10,-7,0,0,0,39.0,0:4,0,0,0,562.0,1:2,650000
8474612,Travis,Hamonic,1990-08-16,D,R,2013-14,69,3,15,18,0.26,2,134,2.24,68,103568.0,25:0,0,0,0,0.0,93,132,40,51,-11,2,1,3,5373.0,1:17,0,0,0,12667.0,3:3,3857143
8474613,Derek,Stepan,1990-06-18,C,R,2013-14,82,17,40,57,0.7,12,199,8.54,18,88837.0,18:3,683,829,1512,45.17,30,46,50,37,13,5,13,18,13303.0,2:42,0,3,3,5746.0,1:10,3075000
8474616,Patrice,Cormier,1990-06-14,C,L,2013-14,9,0,3,3,0.33,2,4,0.0,7,3762.0,6:58,26,20,46,56.52,20,3,2,0,2,0,0,0,54.0,0:6,0,0,0,0.0,0:0,575000
8474618,Marco,Scandella,1990-02-23,D,L,2013-14,76,3,14,17,0.22,10,80,3.75,20,85780.0,18:48,0,0,0,0.0,70,102,25,35,-10,0,0,0,1192.0,0:15,0,0,0,8784.0,1:55,1025000
8474625,Jimmy,Hayes,1989-11-21,RW,R,2013-14,55,11,7,18,0.33,-5,72,15.28,18,36192.0,10:58,11,19,30,36.67,115,19,14,5,9,3,1,4,4074.0,1:14,0,0,0,14.0,0:0,654167
8474628,Michael,Stone,1990-06-07,D,R,2013-14,70,8,13,21,0.3,-10,105,7.62,38,76467.0,18:12,0,0,0,0.0,153,114,9,5,4,2,4,6,5361.0,1:16,0,1,1,6344.0,1:30,1150000
8474638,Andrew,Campbell,1988-02-04,D,L,2013-14,3,0,0,0,0.0,0,4,0.0,0,2285.0,12:41,0,0,0,0.0,3,1,0,0,0,0,0,0,0.0,0:0,0,0,0,85.0,0:28,537500
8474641,Adam,Henrique,1990-02-06,C,L,2013-14,77,25,18,43,0.56,3,137,18.25,20,83411.0,18:3,407,511,918,44.34,73,50,50,30,20,7,5,12,9772.0,2:6,3,2,5,10166.0,2:12,4000000
8474642,Lance,Bouma,1990-03-25,LW,L,2013-14,78,5,10,15,0.19,-4,82,6.1,41,59000.0,12:36,22,63,85,25.88,181,87,20,15,5,0,0,0,1071.0,0:13,1,0,1,9451.0,2:1,577500
8474646,Brandon,McMillan,1990-03-22,LW,L,2013-14,22,2,4,6,0.27,0,35,5.71,4,16612.0,12:35,7,7,14,50.0,50,7,6,2,4,0,0,0,104.0,0:4,0,0,0,1006.0,0:45,709500
8474659,Matt,Donovan,1990-05-09,D,L,2013-14,52,2,14,16,0.31,-9,86,2.33,26,56376.0,18:4,0,0,0,0.0,68,72,18,37,-19,1,5,6,5156.0,1:39,0,0,0,2455.0,0:47,875000
8474660,David,Warsofsky,1990-05-30,D,L,2013-14,6,1,1,2,0.33,1,10,10.0,0,5821.0,16:10,0,0,0,0.0,0,4,1,1,0,0,0,0,903.0,2:30,0,0,0,24.0,0:4,645833
8474668,Dale,Weise,1988-08-05,RW,R,2013-14,61,6,10,16,0.26,3,41,14.63,59,30806.0,8:25,0,4,4,0.0,103,26,17,14,3,1,0,1,296.0,0:4,0,0,0,480.0,0:7,750000
8474673,TJ,Brodie,1990-06-07,D,L,2013-14,81,4,27,31,0.38,0,104,3.85,20,116946.0,24:3,0,0,0,0.0,58,130,48,61,-13,1,6,7,8637.0,1:46,0,2,2,9557.0,1:57,2125000
8474674,James,Wright,1990-03-24,C,L,2013-14,59,0,2,2,0.03,-3,41,0.0,15,33910.0,9:34,126,143,269,46.84,63,20,22,19,3,0,0,0,101.0,0:1,0,0,0,8112.0,2:17,650000
8474679,Gustav,Nyquist,1989-09-01,RW,L,2013-14,57,28,20,48,0.84,16,153,18.3,10,57636.0,16:51,5,4,9,55.56,18,14,34,19,15,6,3,9,11091.0,3:14,0,0,0,25.0,0:0,950000
8474681,Andrei,Loktionov,1990-05-30,C,L,2013-14,68,7,15,22,0.32,-2,78,8.97,14,52984.0,12:59,154,215,369,41.73,33,15,31,11,20,2,4,6,4314.0,1:3,0,0,0,1499.0,0:22,725000
8474683,Derek,Grant,1990-04-20,C,L,2013-14,20,0,2,2,0.1,-3,31,0.0,4,11474.0,9:33,79,71,150,52.67,32,11,5,1,4,0,0,0,11.0,0:0,0,0,0,2692.0,2:14,605000
8474685,Matt,Calvert,1989-12-24,LW,L,2013-14,56,9,15,24,0.43,-1,90,10.0,53,54105.0,16:6,3,6,9,33.33,111,29,20,19,1,2,2,4,5199.0,1:32,0,0,0,5218.0,1:33,987500
8474697,Mark,Borowiecki,1989-07-12,D,L,2013-14,13,1,0,1,0.08,-2,6,16.67,48,9815.0,12:35,0,0,0,0.0,41,13,0,5,-5,0,0,0,24.0,0:1,0,0,0,1207.0,1:32,575000
8474707,Philip,Larsen,1989-12-07,D,R,2013-14,30,3,9,12,0.4,-4,47,6.38,8,30901.0,17:10,0,0,0,0.0,44,31,4,15,-11,1,4,5,4369.0,2:25,0,1,1,148.0,0:4,1025000
8474709,Matt,Martin,1989-05-08,LW,L,2013-14,79,8,6,14,0.18,-11,120,6.67,90,56401.0,11:53,3,6,9,33.33,359,42,22,15,7,0,0,0,1538.0,0:19,0,0,0,3256.0,0:41,1000000
8474715,Cam,Atkinson,1989-06-05,RW,R,2013-14,79,21,19,40,0.51,-4,216,9.72,18,74840.0,15:47,0,0,0,0.0,55,38,29,20,9,4,5,9,10529.0,2:13,1,0,1,844.0,0:10,1150000
8474716,Jared,Spurgeon,1989-11-29,D,R,2013-14,67,5,21,26,0.39,15,91,5.49,16,91017.0,22:38,0,0,0,0.0,80,107,19,21,-2,2,5,7,8531.0,2:7,0,0,0,8136.0,2:1,2666667
8474717,Mark,Barberio,1990-03-23,D,L,2013-14,49,5,5,10,0.2,10,54,9.26,28,42855.0,14:34,0,0,0,0.0,28,38,10,27,-17,1,0,1,872.0,0:17,0,0,0,1024.0,0:20,605000
8474727,Ben,Smith,1988-07-11,RW,R,2013-14,75,14,12,26,0.35,3,90,15.56,2,57319.0,12:44,200,194,394,50.76,40,58,22,12,10,1,1,2,1663.0,0:22,0,0,0,5746.0,1:16,562500
8474736,Zac,Rinaldo,1990-06-15,C,L,2013-14,67,2,2,4,0.06,-13,54,3.7,153,30944.0,7:41,2,1,3,66.67,231,12,8,4,4,0,0,0,186.0,0:2,0,0,0,1873.0,0:27,750000
8474739,Tommy,Wingels,1988-04-12,C,R,2013-14,77,16,22,38,0.49,11,163,9.82,35,74437.0,16:6,20,36,56,35.71,218,58,26,44,-18,0,5,5,5663.0,1:13,2,1,3,5857.0,1:16,775000
8474743,Zach,Redmond,1988-07-26,D,R,2013-14,10,1,2,3,0.3,1,10,10.0,0,9200.0,15:20,0,0,0,0.0,7,11,2,4,-2,0,0,0,409.0,0:40,0,0,0,34.0,0:3,715000
8474744,Sean,Collins,1988-12-29,C,L,2013-14,6,0,1,1,0.17,1,6,0.0,0,2943.0,8:10,0,0,0,0.0,9,1,2,0,2,0,0,0,16.0,0:2,0,0,0,0.0,0:0,625000
8474749,Matt,Bartkowski,1988-06-04,D,L,2013-14,64,0,18,18,0.28,22,91,0.0,30,75019.0,19:32,0,0,0,0.0,155,56,11,28,-17,0,0,0,642.0,0:10,0,0,0,6712.0,1:44,650000
8474774,Dalton,Prout,1990-03-13,D,R,2013-14,49,2,4,6,0.12,-7,56,3.57,37,50582.0,17:12,0,1,1,0.0,99,65,13,11,2,0,0,0,214.0,0:4,0,0,0,4677.0,1:35,666667
8474818,Jordie,Benn,1987-07-26,D,L,2013-14,78,3,17,20,0.26,16,91,3.3,30,89647.0,19:9,1,0,1,100.0,118,122,27,39,-12,1,1,2,2825.0,0:36,0,1,1,8030.0,1:42,700000
8474837,Mark,Cundari,1990-04-23,D,L,2013-14,4,0,0,0,0.0,-4,6,0.0,0,2587.0,10:46,0,0,0,0.0,10,4,0,3,-3,0,0,0,44.0,0:11,0,0,0,0.0,0:0,600000
8474849,Antoine,Roussel,1989-11-21,LW,L,2013-14,81,14,15,29,0.36,-1,113,12.39,209,64799.0,13:19,19,25,44,43.18,146,49,24,24,0,0,0,0,695.0,0:8,0,2,2,8143.0,1:40,612500
8474850,Brandon,Mashinter,1988-09-20,LW,L,2013-14,6,0,0,0,0.0,-1,3,0.0,10,1646.0,4:34,0,0,0,0.0,5,1,0,1,-1,0,0,0,0.0,0:0,0,0,0,0.0,0:0,605000
8474870,Tyler,Johnson,1990-07-29,C,R,2013-14,82,24,26,50,0.61,23,181,13.26,26,92420.0,18:47,614,661,1275,48.16,55,37,23,41,-18,5,5,10,12319.0,2:30,5,1,6,9980.0,2:1,756667
8474873,Brian,Lashoff,1990-07-16,D,L,2013-14,75,1,5,6,0.08,-2,38,2.63,36,64948.0,14:25,0,0,0,0.0,65,93,14,15,-1,0,0,0,55.0,0:0,0,0,0,10578.0,2:21,725000
8474884,Mike,Hoffman,1989-11-24,LW,L,2013-14,25,3,3,6,0.24,-2,61,4.92,2,19778.0,13:11,6,3,9,66.67,18,7,18,9,9,1,2,3,3469.0,2:18,0,0,0,7.0,0:0,660000
8474939,Mark,Van Guilder,1984-01-17,C,R,2013-14,1,0,0,0,0.0,0,0,,0,507.0,8:27,0,0,0,0.0,0,0,0,0,0,0,0,0,0.0,0:0,0,0,0,45.0,0:45,550000
8475060,Matt,Taormina,1986-10-20,D,L,2013-14,7,0,0,0,0.0,0,6,0.0,0,5627.0,13:23,0,0,0,0.0,5,6,2,9,-7,0,0,0,1018.0,2:25,0,0,0,182.0,0:26,650000
8475098,Tyler,Bozak,1986-03-19,C,R,2013-14,58,19,30,49,0.84,2,90,21.11,14,72897.0,20:56,681,718,1399,48.68,62,42,49,24,25,5,3,8,9384.0,2:41,1,0,1,4125.0,1:11,4200000
8475118,Matt,Gilroy,1984-07-20,D,R,2013-14,16,1,1,2,0.12,-2,27,3.7,6,15602.0,16:15,0,0,0,0.0,5,18,1,10,-9,0,0,0,1100.0,1:8,0,0,0,39.0,0:2,-111
8475119,Zach,Sill,1988-05-24,C,L,2013-14,20,0,0,0,0.0,-4,14,0.0,12,12953.0,10:47,34,56,90,37.78,57,18,4,2,2,0,0,0,117.0,0:5,0,0,0,2281.0,1:54,550000
8475147,Jordan,Schroeder,1990-09-29,LW,R,2013-14,25,3,3,6,0.24,-7,25,12.0,2,18017.0,12:0,112,132,244,45.9,20,8,7,7,0,0,1,1,1526.0,1:1,0,0,0,121.0,0:4,600000
8475148,Tim,Erixon,1991-02-24,D,L,2013-14,2,0,0,0,0.0,2,1,0.0,2,1721.0,14:20,0,0,0,0.0,1,1,0,0,0,0,0,0,62.0,0:31,0,0,0,47.0,0:23,900000
8475149,Marcus,Johansson,1990-10-06,LW,L,2013-14,80,8,36,44,0.55,-21,107,7.48,4,84184.0,17:32,95,179,274,34.67,49,27,32,49,-17,6,15,21,14410.0,3:0,0,0,0,1578.0,0:19,2000000
8475150,Jordan,Caron,1990-11-02,RW,L,2013-14,35,1,2,3,0.09,-8,52,1.92,36,22941.0,10:55,1,3,4,25.0,47,9,11,7,4,0,0,0,154.0,0:4,0,0,0,1420.0,0:40,640000
8475151,Kyle,Palmieri,1991-02-01,RW,R,2013-14,71,14,17,31,0.44,9,147,9.52,38,50874.0,11:56,9,14,23,39.13,96,31,14,17,-3,0,0,0,5535.0,1:17,0,0,0,2.0,0:0,1466667
8475153,Dylan,Olsen,1991-01-03,D,L,2013-14,44,3,9,12,0.27,-3,60,5.0,8,40753.0,15:26,0,0,0,0.0,116,55,18,15,3,0,1,1,491.0,0:11,0,0,0,3832.0,1:27,738333
8475154,Carter,Ashton,1991-04-01,RW,L,2013-14,32,0,3,3,0.09,1,23,0.0,19,12045.0,6:16,12,11,23,52.17,46,7,3,5,-2,0,0,0,60.0,0:1,0,0,0,180.0,0:5,840000
8475155,Simon,Despres,1991-07-27,D,L,2013-14,34,0,5,5,0.15,4,41,0.0,26,34154.0,16:44,0,0,0,0.0,72,46,10,15,-5,0,1,1,1557.0,0:45,0,0,0,1558.0,0:45,840000
8475157,Landon,Ferraro,1991-08-08,C,R,2013-14,4,0,0,0,0.0,0,2,0.0,2,2154.0,8:58,0,0,0,0.0,7,2,0,2,-2,0,0,0,13.0,0:3,0,0,0,304.0,1:16,685000
8475158,Ryan,O'Reilly,1991-02-07,C,L,2013-14,80,28,36,64,0.8,-1,201,13.93,2,95138.0,19:49,192,179,371,51.75,22,43,83,33,50,9,13,22,12799.0,2:39,0,0,0,5575.0,1:9,5000000
8475159,Carl,Klingberg,1991-01-28,LW,R,2013-14,3,1,0,1,0.33,2,3,33.33,0,1597.0,8:52,0,0,0,0.0,2,1,1,0,1,0,0,0,0.0,0:0,0,0,0,0.0,0:0,760000
8475160,Kyle,Clifford,1991-01-13,LW,L,2013-14,71,3,5,8,0.11,6,74,4.05,81,43286.0,10:9,6,6,12,50.0,189,13,12,16,-4,0,0,0,686.0,0:9,0,0,0,1312.0,0:18,1075000
8475161,Chris,Brown,1991-02-03,RW,R,2013-14,12,1,1,2,0.17,0,8,12.5,17,6262.0,8:41,15,25,40,37.5,22,1,2,3,-1,0,0,0,78.0,0:6,0,0,0,0.0,0:0,853333
8475163,Alex,Chiasson,1990-10-01,RW,R,2013-14,79,13,22,35,0.44,-21,144,9.03,38,71641.0,15:6,64,68,132,48.48,76,21,27,26,1,6,7,13,15921.0,3:21,0,0,0,2638.0,0:33,866667
8475164,Jakob,Silfverberg,1990-10-13,RW,R,2013-14,52,10,13,23,0.44,2,119,8.4,12,44501.0,14:15,1,11,12,8.33,31,20,17,9,8,1,0,1,4161.0,1:20,2,0,2,3249.0,1:2,863333
8475165,Anton,Lander,1991-04-24,C,L,2013-14,27,0,1,1,0.04,-10,18,0.0,4,22094.0,13:38,71,89,160,44.38,29,8,6,9,-3,0,0,0,1772.0,1:5,0,0,0,3078.0,1:54,880000
8475166,John,Tavares,1990-09-20,C,L,2013-14,59,24,42,66,1.12,-6,188,12.77,40,75196.0,21:14,554,575,1129,49.07,23,19,55,56,-1,8,17,25,14470.0,4:5,0,0,0,619.0,0:10,5500000
8475167,Victor,Hedman,1990-12-18,D,L,2013-14,75,13,42,55,0.73,5,170,7.65,53,100969.0,22:26,0,0,0,0.0,86,101,34,44,-10,3,11,14,11194.0,2:29,0,6,6,9737.0,2:9,4000000
8475168,Matt,Duchene,1991-01-16,C,L,2013-14,71,23,47,70,0.99,8,217,10.6,19,78796.0,18:29,532,526,1058,50.28,53,44,40,36,4,5,12,17,11638.0,2:43,0,0,0,1135.0,0:15,3500000
8475169,Evander,Kane,1991-08-02,LW,L,2013-14,63,19,22,41,0.65,-7,250,7.6,66,76693.0,20:17,45,60,105,42.86,173,36,28,26,2,1,4,5,8416.0,2:13,2,0,2,6960.0,1:50,5250000
8475170,Brayden,Schenn,1991-08-22,C,L,2013-14,82,20,21,41,0.5,0,178,11.24,54,77481.0,15:44,296,389,685,43.21,200,37,37,19,18,4,5,9,10758.0,2:11,0,0,0,772.0,0:9,870000
8475171,Oliver,Ekman-Larsson,1991-07-17,D,L,2013-14,80,15,29,44,0.55,-4,199,7.54,50,124297.0,25:53,0,1,1,0.0,134,80,26,36,-10,8,14,22,19646.0,4:5,0,0,0,13727.0,2:51,5500000
8475172,Nazem,Kadri,1990-10-06,C,L,2013-14,78,20,30,50,0.64,-11,148,13.51,67,81386.0,17:23,510,617,1127,45.25,141,34,44,57,-13,7,11,18,11133.0,2:22,0,0,0,697.0,0:8,2900000
8475174,Jared,Cowen,1991-01-25,D,L,2013-14,68,6,9,15,0.22,0,68,8.82,45,83690.0,20:30,0,0,0,0.0,214,99,11,45,-34,0,1,1,602.0,0:8,0,0,0,12097.0,2:57,3100000
8475175,Magnus,Paajarvi,1991-04-12,LW,L,2013-14,55,6,6,12,0.22,-6,60,10.0,6,33817.0,10:14,2,4,6,33.33,26,24,13,3,10,0,0,0,561.0,0:10,0,0,0,112.0,0:2,1200000
8475176,Ryan,Ellis,1991-01-03,D,R,2013-14,80,6,21,27,0.34,9,123,4.88,24,77123.0,16:4,0,0,0,0.0,57,97,17,42,-25,0,6,6,8411.0,1:45,0,0,0,334.0,0:4,840000
8475177,Calvin,de Haan,1991-05-09,D,L,2013-14,51,3,13,16,0.31,-7,71,4.23,30,64334.0,21:1,0,0,0,0.0,114,104,30,34,-4,1,2,3,3851.0,1:15,0,0,0,5035.0,1:38,870000
8475178,Zack,Kassian,1991-01-24,RW,R,2013-14,73,14,15,29,0.4,-4,91,15.38,124,56629.0,12:55,6,15,21,28.57,91,6,19,25,-6,1,0,1,3092.0,0:42,0,0,0,27.0,0:0,870000
8475179,Dmitry,Kulikov,1990-10-29,D,L,2013-14,81,8,11,19,0.23,-26,127,6.3,66,105429.0,21:41,0,0,0,0.0,125,92,29,47,-18,2,3,5,11619.0,2:23,1,0,1,8786.0,1:48,2500000
8475180,Peter,Holland,1991-01-14,C,L,2013-14,43,6,5,11,0.26,0,43,13.95,18,29279.0,11:20,182,213,395,46.08,46,22,25,12,13,1,0,1,582.0,0:13,0,0,0,27.0,0:0,870000
8475181,Nick,Leddy,1991-03-20,D,L,2013-14,82,7,24,31,0.38,10,123,5.69,10,80542.0,16:22,0,0,0,0.0,52,45,12,35,-23,4,6,10,9883.0,2:0,0,0,0,167.0,0:2,2700000
8475182,David,Rundblad,1990-10-08,D,R,2013-14,17,0,1,1,0.06,-4,21,0.0,6,14027.0,13:45,0,0,0,0.0,18,14,3,5,-2,0,1,1,1384.0,1:21,0,0,0,36.0,0:2,785000
8475183,Louis,Leblanc,1991-01-26,C,R,2013-14,8,0,0,0,0.0,1,7,0.0,4,4738.0,9:52,2,2,4,50.0,3,7,0,1,-1,0,0,0,78.0,0:9,0,0,0,0.0,0:0,870000
8475184,Chris,Kreider,1991-04-30,LW,L,2013-14,66,17,20,37,0.56,14,136,12.5,72,62286.0,15:43,8,11,19,42.11,146,18,21,25,-4,6,6,12,8628.0,2:10,0,0,0,102.0,0:1,800000
8475185,Jacob,Josefson,1991-03-02,C,L,2013-14,27,1,2,3,0.11,0,21,4.76,4,16415.0,10:7,83,85,168,49.4,15,4,10,5,5,0,0,0,89.0,0:3,1,0,1,1993.0,1:13,725000
8475186,John,Moore,1990-11-19,D,L,2013-14,74,4,11,15,0.2,7,115,3.48,25,68059.0,15:19,0,0,0,0.0,59,57,4,27,-23,0,2,2,4822.0,1:5,0,0,0,599.0,0:8,840000
8475188,Brayden,McNabb,1991-01-21,D,L,2013-14,12,0,0,0,0.0,1,10,0.0,6,12404.0,17:13,0,0,0,0.0,25,12,2,5,-3,0,0,0,1392.0,1:56,0,0,0,710.0,0:59,715000
8475190,Jamie,Devane,1991-02-20,LW,L,2013-14,2,0,0,0,0.0,-1,1,0.0,0,703.0,5:51,0,0,0,0.0,2,0,0,0,0,0,0,0,0.0,0:0,0,0,0,0.0,0:0,576667
8475191,Reilly,Smith,1991-04-01,RW,L,2013-14,82,20,31,51,0.62,28,146,13.7,14,72355.0,14:42,0,2,2,0.0,63,14,35,41,-6,6,8,14,8059.0,1:38,0,0,0,39.0,0:0,900000
8475192,Taylor,Beck,1991-05-13,LW,R,2013-14,7,0,0,0,0.0,-2,9,0.0,6,5393.0,12:50,0,0,0,0.0,4,5,0,2,-2,0,0,0,383.0,0:54,0,0,0,28.0,0:4,660000
8475193,Tomas,Tatar,1990-12-01,LW,L,2013-14,73,19,20,39,0.53,12,158,12.03,30,62856.0,14:21,26,26,52,50.0,81,20,41,19,22,2,4,6,10051.0,2:17,0,0,0,0.0,0:0,630000
8475194,Philip,Samuelsson,1991-07-26,D,L,2013-14,5,0,0,0,0.0,-1,5,0.0,0,4672.0,15:34,0,0,0,0.0,5,7,2,4,-2,0,0,0,17.0,0:3,0,0,0,297.0,0:59,623333
8475196,Ben,Hanowski,1990-10-18,RW,L,2013-14,11,0,2,2,0.18,-2,10,0.0,2,4783.0,7:14,1,0,1,100.0,13,1,2,3,-1,0,0,0,74.0,0:6,0,0,0,10.0,0:0,900000
8475197,Tyson,Barrie,1991-07-26,D,R,2013-14,64,13,25,38,0.59,17,101,12.87,20,71201.0,18:32,0,0,0,0.0,50,57,26,27,-1,4,6,10,10731.0,2:47,0,0,0,337.0,0:5,715000
8475198,Joonas,Nattinen,1991-01-03,C,R,2013-14,1,0,0,0,0.0,0,0,,0,105.0,1:45,0,2,2,0.0,0,1,0,0,0,0,0,0,0.0,0:0,0,0,0,0.0,0:0,631667
8475199,Eric,Gelinas,1991-05-08,D,L,2013-14,60,7,22,29,0.48,-3,124,5.65,22,60926.0,16:55,0,0,0,0.0,99,20,12,26,-14,5,12,17,8743.0,2:25,0,0,0,351.0,0:5,660000
8475200,Dmitry,Orlov,1991-07-23,D,L,2013-14,54,3,8,11,0.2,-1,59,5.08,19,63497.0,19:35,0,0,0,0.0,75,62,28,28,0,0,1,1,747.0,0:13,0,0,0,1194.0,0:22,690000
8475204,Brandon,Pirri,1991-04-10,RW,L,2013-14,49,13,12,25,0.51,6,80,16.25,8,38150.0,12:58,204,250,454,44.93,24,15,16,7,9,3,3,6,4343.0,1:28,0,0,0,0.0,0:0,618333
8475206,Stefan,Elliott,1991-01-30,D,R,2013-14,1,1,0,1,1.0,0,1,100.0,0,1011.0,16:51,0,0,0,0.0,2,0,0,0,0,0,0,0,55.0,0:55,0,0,0,8.0,0:8,843333
8475208,Brian,Dumoulin,1991-09-06,D,L,2013-14,6,0,1,1,0.17,1,3,0.0,4,6924.0,19:14,0,0,0,0.0,1,8,1,4,-3,0,0,0,900.0,2:30,0,0,0,460.0,1:16,831667
8475209,Richard,Panik,1991-02-07,RW,L,2013-14,50,3,10,13,0.26,-9,56,5.36,21,38077.0,12:41,3,5,8,37.5,70,16,16,23,-7,0,4,4,3923.0,1:18,0,0,0,207.0,0:4,740000
8475213,Drew,Shore,1991-01-29,C,R,2013-14,24,5,2,7,0.29,-1,23,21.74,8,17272.0,11:59,86,122,208,41.35,23,5,6,4,2,1,0,1,1129.0,0:47,1,0,1,2706.0,1:52,900000
8475214,Jeremy,Morin,1991-04-16,LW,R,2013-14,24,5,6,11,0.46,5,46,10.87,32,13197.0,9:9,4,2,6,66.67,20,2,9,0,9,0,0,0,458.0,0:19,0,0,0,0.0,0:0,735000
8475218,Mattias,Ekholm,1990-05-24,D,L,2013-14,62,1,8,9,0.15,-8,58,1.72,10,62558.0,16:49,0,0,0,0.0,42,55,19,33,-14,0,0,0,759.0,0:12,0,1,1,4938.0,1:19,900000
8475220,Marcus,Foligno,1991-08-10,LW,L,2013-14,74,7,12,19,0.26,-17,79,8.86,82,66877.0,15:3,146,155,301,48.5,206,43,36,19,17,0,1,1,4912.0,1:6,1,0,1,4973.0,1:7,826667
8475222,Sami,Vatanen,1991-06-03,D,R,2013-14,48,6,15,21,0.44,9,73,8.22,22,50260.0,17:27,0,0,0,0.0,66,47,15,22,-7,2,5,7,6939.0,2:24,0,0,0,563.0,0:11,785000
8475223,Linden,Vey,1991-07-17,RW,R,2013-14,18,0,5,5,0.28,0,8,0.0,0,13104.0,12:8,55,69,124,44.35,2,1,7,7,0,0,1,1,1579.0,1:27,0,1,1,1007.0,0:55,790000
8475224,Jordan,Szwarz,1991-05-14,RW,R,2013-14,26,3,0,3,0.12,-6,25,12.0,19,13489.0,8:38,1,2,3,33.33,23,7,7,1,6,0,0,0,32.0,0:1,0,0,0,1656.0,1:3,613353
8475225,Craig,Smith,1989-09-05,RW,R,2013-14,79,24,28,52,0.66,16,215,11.16,22,77733.0,16:23,3,16,19,15.79,54,21,50,49,1,7,3,10,9732.0,2:3,0,0,0,102.0,0:1,2000000
8475231,Casey,Cizikas,1991-02-27,C,L,2013-14,80,6,10,16,0.2,-12,79,7.59,30,64193.0,13:22,489,522,1011,48.37,128,48,33,18,15,1,1,2,1055.0,0:13,0,2,2,11677.0,2:25,793333
8475233,David,Savard,1990-10-22,D,R,2013-14,70,5,10,15,0.21,2,63,7.94,28,74881.0,17:49,1,0,1,100.0,149,81,12,9,3,1,3,4,2451.0,0:35,0,0,0,5647.0,1:20,709275
8475235,Nicolas,Deslauriers,1991-02-22,LW,L,2013-14,17,1,0,1,0.06,-10,30,3.33,18,13405.0,13:8,0,1,1,0.0,51,3,2,1,1,0,0,0,1783.0,1:44,0,0,0,34.0,0:2,608333
8475236,Cody,Eakin,1991-05-24,C,L,2013-14,81,16,19,35,0.43,-9,161,9.94,36,84231.0,17:19,585,638,1223,47.83,91,58,57,33,24,3,3,6,9963.0,2:3,1,0,1,7660.0,1:34,571667
8475246,Kevin,Connauton,1990-02-23,D,L,2013-14,36,1,7,8,0.22,-6,56,1.79,16,33114.0,15:19,0,0,0,0.0,43,29,9,22,-13,0,2,2,1456.0,0:40,0,0,0,430.0,0:11,683333
8475247,Michael,Latta,1991-05-25,C,R,2013-14,17,1,3,4,0.24,0,6,16.67,12,7865.0,7:42,60,55,115,52.17,14,2,3,2,1,0,0,0,87.0,0:5,0,0,0,1050.0,1:1,586667
8475248,Alexander,Urbom,1990-12-20,D,L,2013-14,20,1,1,2,0.1,1,16,6.25,19,17527.0,14:36,0,0,0,0.0,25,13,5,10,-5,0,0,0,33.0,0:1,0,1,1,2308.0,1:55,563333
8475253,Garrett,Wilson,1991-03-16,LW,L,2013-14,3,0,0,0,0.0,-1,4,0.0,0,1860.0,10:20,0,0,0,0.0,11,2,0,0,0,0,0,0,64.0,0:21,0,0,0,0.0,0:0,683333
8475254,Gabriel,Dumont,1990-10-06,C,R,2013-14,2,0,0,0,0.0,0,1,0.0,0,820.0,6:50,3,5,8,37.5,3,0,1,1,0,0,0,0,0.0,0:0,0,0,0,34.0,0:17,562500
8475260,Corban,Knight,1990-09-10,C,R,2013-14,7,1,0,1,0.14,-1,4,25.0,0,3333.0,7:56,24,27,51,47.06,9,4,1,0,1,0,0,0,118.0,0:16,0,0,0,0.0,0:0,900000
8475264,Roman,Horak,1991-05-21,C,L,2013-14,3,1,0,1,0.33,-1,2,50.0,0,1695.0,9:25,4,2,6,66.67,0,4,0,0,0,0,0,0,126.0,0:42,0,0,0,0.0,0:0,613333
8475268,Gabriel,Bourque,1990-09-23,LW,L,2013-14,74,9,17,26,0.35,-5,108,8.33,8,61441.0,13:50,0,1,1,0.0,70,34,20,21,-1,0,1,1,1922.0,0:25,0,0,0,3601.0,0:48,775000
8475275,Patrick,Wey,1991-03-21,D,R,2013-14,9,0,3,3,0.33,0,5,0.0,5,7876.0,14:35,0,0,0,0.0,11,4,1,7,-6,0,0,0,0.0,0:0,0,0,0,688.0,1:16,640000
8475279,Ben,Chiarot,1991-05-09,D,L,2013-14,1,0,0,0,0.0,-3,0,,0,647.0,10:47,0,0,0,0.0,3,0,1,0,1,0,0,0,0.0,0:0,0,0,0,0.0,0:0,618333
8475283,Lane,MacDermid,1989-08-25,LW,L,2013-14,7,0,2,2,0.29,1,1,0.0,12,2340.0,5:34,1,1,2,50.0,10,3,0,0,0,0,0,0,3.0,0:0,0,0,0,0.0,0:0,660000
8475287,Erik,Haula,1991-03-23,LW,L,2013-14,46,6,9,15,0.33,14,56,10.71,29,28004.0,10:8,161,187,348,46.26,23,17,8,5,3,0,0,0,288.0,0:6,1,0,1,3062.0,1:6,900000
8475296,Mitch,Callahan,1991-08-17,RW,R,2013-14,1,0,0,0,0.0,0,0,,0,541.0,9:1,0,0,0,0.0,2,0,1,0,1,0,0,0,0.0,0:0,0,0,0,0.0,0:0,560000
8475309,Jerry,D'Amigo,1991-02-19,RW,L,2013-14,22,1,2,3,0.14,-1,12,8.33,0,10621.0,8:2,1,3,4,25.0,23,4,6,3,3,0,0,0,0.0,0:0,0,0,0,1384.0,1:2,870000
8475314,Anders,Lee,1990-07-03,LW,L,2013-14,22,9,5,14,0.64,3,68,13.24,14,20754.0,15:43,1,5,6,16.67,48,2,9,8,1,2,0,2,3565.0,2:42,0,0,0,53.0,0:2,900000
8475321,Phil,Varone,1990-12-04,C,L,2013-14,9,1,1,2,0.22,-3,15,6.67,4,6160.0,11:24,26,30,56,46.43,7,2,0,1,-1,0,0,0,40.0,0:4,0,0,0,0.0,0:0,586667
8475323,Marcus,Kruger,1990-05-27,C,L,2013-14,81,8,20,28,0.35,6,96,8.33,36,67430.0,13:52,438,335,773,56.66,22,70,27,18,9,0,0,0,552.0,0:6,0,1,1,12411.0,2:33,1287500
8475325,Jordan,Nolan,1989-06-23,C,L,2013-14,64,6,4,10,0.16,-1,58,10.34,54,34561.0,9:0,1,3,4,25.0,100,11,5,16,-11,0,0,0,265.0,0:4,0,0,0,122.0,0:1,700000
8475332,Adam,Almquist,1991-02-27,D,L,2013-14,2,1,0,1,0.5,-1,2,50.0,0,2066.0,17:13,0,0,0,0.0,1,0,0,0,0,0,0,0,148.0,1:14,0,0,0,27.0,0:13,666667
8475414,Craig,Cunningham,1990-09-13,LW,R,2013-14,2,0,0,0,0.0,0,4,0.0,0,1138.0,9:29,3,4,7,42.86,1,0,0,0,0,0,0,0,30.0,0:15,0,0,0,35.0,0:17,615000
8475423,Darren,Archibald,1990-02-09,RW,L,2013-14,16,1,2,3,0.19,1,11,9.09,0,7485.0,7:47,0,1,1,0.0,30,9,2,1,1,0,0,0,25.0,0:1,0,0,0,16.0,0:1,660000
8475455,Brenden,Dillon,1990-11-13,D,L,2013-14,80,6,11,17,0.21,9,97,6.19,86,101248.0,21:5,0,0,0,0.0,168,149,15,52,-37,0,0,0,584.0,0:7,2,0,2,11470.0,2:23,743333
8475462,Radko,Gudas,1990-06-05,D,R,2013-14,73,3,19,22,0.3,2,114,2.63,152,83776.0,19:7,0,0,0,0.0,273,138,13,36,-23,1,3,4,3421.0,0:46,0,0,0,7550.0,1:43,991667
8475567,Julien,Brouillette,1986-12-05,D,L,2013-14,10,1,1,2,0.2,3,4,25.0,0,9331.0,15:33,0,0,0,0.0,10,11,1,5,-4,0,0,0,22.0,0:2,0,0,0,280.0,0:28,550000
8475598,Ryan,Stanton,1989-07-20,D,L,2013-14,64,1,15,16,0.25,5,65,1.54,32,56494.0,14:42,1,0,1,100.0,97,81,20,21,-1,0,0,0,271.0,0:4,0,0,0,1945.0,0:30,550000
8475602,Casey,Wellman,1987-10-18,C,R,2013-14,13,2,1,3,0.23,3,15,13.33,0,7312.0,9:22,50,47,97,51.55,9,5,3,3,0,0,0,0,50.0,0:3,0,0,0,3.0,0:0,550000
8475613,Nate,Prosser,1986-05-07,D,R,2013-14,53,2,6,8,0.15,2,30,6.67,58,46195.0,14:31,0,0,0,0.0,22,83,17,7,10,0,1,1,63.0,0:1,0,1,1,5143.0,1:37,825000
8475619,Aaron,Volpatti,1985-05-30,LW,L,2013-14,41,2,0,2,0.05,-3,18,11.11,49,18112.0,7:21,4,8,12,33.33,77,10,6,1,5,0,0,0,49.0,0:1,0,0,0,15.0,0:0,575000
8475625,Matt,Irwin,1987-11-29,D,L,2013-14,62,2,17,19,0.31,5,147,1.36,35,69990.0,18:48,0,1,1,0.0,62,93,15,44,-29,1,5,6,7498.0,2:0,0,0,0,677.0,0:10,1000000
8475637,Bobby,Butler,1987-04-26,RW,R,2013-14,2,0,1,1,0.5,1,5,0.0,2,1660.0,13:50,0,0,0,0.0,2,0,2,0,2,0,0,0,100.0,0:50,0,0,0,0.0,0:0,600000
8475640,Erik,Gustafsson,1988-12-15,D,L,2013-14,31,2,8,10,0.32,7,30,6.67,6,32589.0,17:31,0,0,0,0.0,11,50,4,16,-12,0,2,2,1291.0,0:41,0,0,0,1351.0,0:43,-111
8475648,Chris,Breen,1989-06-29,D,L,2013-14,9,0,2,2,0.22,1,4,0.0,5,5068.0,9:23,0,0,0,0.0,3,7,0,5,-5,0,0,0,0.0,0:0,0,0,0,240.0,0:26,577500
8475650,Brandon,Bollig,1987-01-31,LW,L,2013-14,82,7,7,14,0.17,-1,109,6.42,92,50555.0,10:16,1,0,1,100.0,203,22,5,6,-1,0,0,0,210.0,0:2,0,0,0,1094.0,0:13,575000
8475671,Matt,Fraser,1990-05-20,RW,L,2013-14,14,2,0,2,0.14,0,13,15.38,10,8107.0,9:39,1,1,2,50.0,10,5,1,0,1,0,0,0,162.0,0:11,0,0,0,0.0,0:0,625000
8475690,Christopher,Tanev,1989-12-20,D,R,2013-14,64,6,11,17,0.27,12,65,9.23,8,79629.0,20:44,0,0,0,0.0,25,136,17,18,-1,0,0,0,812.0,0:12,1,0,1,11551.0,3:0,1500000
8475692,Mats,Zuccarello,1987-09-01,RW,L,2013-14,77,19,40,59,0.77,11,170,11.18,32,79185.0,17:8,3,5,8,37.5,116,41,44,38,6,4,13,17,12085.0,2:36,1,0,1,2612.0,0:33,1150000
8475714,Calle,Jarnkrok,1991-09-25,C,R,2013-14,12,2,7,9,0.75,7,13,15.38,4,10129.0,14:4,58,89,147,39.46,2,4,2,2,0,0,1,1,1008.0,1:24,0,0,0,68.0,0:5,715000
8475716,Martin,Marincin,1992-02-18,D,L,2013-14,44,0,6,6,0.14,-2,28,0.0,16,50590.0,19:9,0,0,0,0.0,17,60,17,33,-16,0,1,1,1319.0,0:29,0,1,1,6175.0,2:20,730000
8475722,Jason,Zucker,1992-01-16,LW,L,2013-14,21,4,1,5,0.24,2,40,10.0,2,16364.0,12:59,0,0,0,0.0,16,11,9,9,0,1,1,2,1044.0,0:49,0,0,0,149.0,0:7,771667
8475726,Tyler,Toffoli,1992-04-24,C,R,2013-14,62,12,17,29,0.47,21,124,9.68,10,48129.0,12:56,2,7,9,22.22,57,8,23,25,-2,1,3,4,5868.0,1:34,0,0,0,308.0,0:4,716667
8475727,Ryan,Spooner,1992-01-30,C,L,2013-14,23,0,11,11,0.48,0,42,0.0,6,17678.0,12:48,59,86,145,40.69,10,6,8,3,5,0,6,6,2509.0,1:49,0,0,0,592.0,0:25,760000
8475728,Johan,Larsson,1992-07-25,C,L,2013-14,28,0,4,4,0.14,0,21,0.0,19,22601.0,13:27,135,150,285,47.37,52,19,9,3,6,0,0,0,336.0,0:12,0,0,0,1813.0,1:4,763333
8475733,Max,Reinhart,1992-02-04,C,L,2013-14,8,0,2,2,0.25,1,7,0.0,2,5137.0,10:42,2,7,9,22.22,1,0,3,1,2,0,0,0,258.0,0:32,0,0,0,64.0,0:8,618333
8475735,Greg,McKegg,1992-06-17,C,L,2013-14,1,0,0,0,0.0,0,1,0.0,0,223.0,3:43,1,5,6,16.67,2,0,0,0,0,0,0,0,0.0,0:0,0,0,0,0.0,0:0,660000
8475739,Michael,Bournival,1992-05-31,LW,L,2013-14,60,7,7,14,0.23,-6,78,8.97,18,37147.0,10:19,28,33,61,45.9,67,42,15,10,5,1,2,3,941.0,0:15,0,0,0,2329.0,0:38,660000
8475744,Evgeny,Kuznetsov,1992-05-19,C,L,2013-14,17,3,6,9,0.53,-2,22,13.64,6,13743.0,13:28,5,22,27,18.52,7,2,3,7,-4,0,2,2,1061.0,1:2,1,0,1,21.0,0:1,900000
8475745,Charlie,Coyle,1992-03-02,C,R,2013-14,70,12,18,30,0.43,-7,135,8.89,33,71783.0,17:5,192,266,458,41.92,108,37,32,28,4,2,1,3,9434.0,2:14,0,0,0,621.0,0:8,900000
8475747,Patrik,Nemeth,1992-02-08,D,L,2013-14,8,0,0,0,0.0,-3,3,0.0,6,6608.0,13:46,0,0,0,0.0,16,11,1,5,-4,0,0,0,0.0,0:0,0,0,0,359.0,0:44,763333
8475749,Christian,Thomas,1992-05-26,LW,R,2013-14,2,0,0,0,0.0,-1,1,0.0,0,862.0,7:11,0,0,0,0.0,1,1,1,0,1,0,0,0,0.0,0:0,0,0,0,0.0,0:0,808333
8475750,Jon,Merrill,1992-02-03,D,L,2013-14,52,2,9,11,0.21,-3,45,4.44,12,59986.0,19:13,0,0,0,0.0,27,41,9,11,-2,0,2,2,4622.0,1:28,0,0,0,2083.0,0:40,840000
8475752,Tyler,Pitlick,1991-11-01,C,R,2013-14,10,1,0,1,0.1,-2,9,11.11,0,5383.0,8:58,1,2,3,33.33,26,4,2,1,1,0,0,0,15.0,0:1,0,0,0,30.0,0:3,888333
8475753,Justin,Faulk,1992-03-20,D,R,2013-14,76,5,27,32,0.42,-9,152,3.29,37,106757.0,23:24,0,0,0,0.0,94,102,41,47,-6,2,6,8,9657.0,2:7,0,1,1,11061.0,2:25,840000
8475754,Brock,Nelson,1991-10-15,C,L,2013-14,72,14,12,26,0.36,-10,132,10.61,12,61613.0,14:15,191,260,451,42.35,74,38,32,23,9,3,4,7,8010.0,1:51,0,0,0,3645.0,0:50,900000
8475755,Alex,Petrovic,1992-03-03,D,R,2013-14,7,0,1,1,0.14,3,4,0.0,8,5139.0,12:14,0,0,0,0.0,24,5,0,0,0,0,0,0,0.0,0:0,0,0,0,242.0,0:34,795000
8475757,Brett,Bulmer,1992-04-26,RW,R,2013-14,5,0,0,0,0.0,-2,7,0.0,2,3207.0,10:41,0,0,0,0.0,14,2,1,0,1,0,0,0,4.0,0:0,0,0,0,0.0,0:0,780000
8475758,Devante,Smith-Pelly,1992-06-14,RW,R,2013-14,19,2,8,10,0.53,5,23,8.7,2,14413.0,12:38,0,4,4,0.0,50,13,2,7,-5,0,0,0,769.0,0:40,0,0,0,242.0,0:12,720000
8475759,Brandon,Gormley,1992-02-18,D,L,2013-14,5,0,0,0,0.0,4,4,0.0,2,4363.0,14:32,0,0,0,0.0,5,8,1,1,0,0,0,0,99.0,0:19,0,0,0,143.0,0:28,840000
8475760,Nick,Bjugstad,1992-07-17,C,R,2013-14,76,16,22,38,0.5,-14,185,8.65,16,73959.0,16:13,549,574,1123,48.89,117,23,37,28,9,0,3,3,9768.0,2:8,1,1,2,1580.0,0:20,900000
8475761,Beau,Bennett,1991-11-27,RW,R,2013-14,21,3,4,7,0.33,-2,27,11.11,0,17444.0,13:50,2,0,2,100.0,32,7,2,4,-2,0,0,0,1623.0,1:17,0,0,0,2.0,0:0,900000
8475764,Cam,Fowler,1991-12-05,D,L,2013-14,70,6,30,36,0.51,15,100,6.0,14,100224.0,23:51,0,0,0,0.0,46,122,24,36,-12,4,11,15,14232.0,3:23,1,0,1,11296.0,2:41,4000000
8475765,Vladimir,Tarasenko,1991-12-13,RW,L,2013-14,64,21,22,43,0.67,20,136,15.44,16,58266.0,15:10,2,4,6,33.33,22,9,32,20,12,5,2,7,6453.0,1:40,0,0,0,1892.0,0:29,900000
8475768,Jaden,Schwartz,1992-06-25,LW,L,2013-14,80,25,31,56,0.7,28,188,13.3,27,84134.0,17:31,44,34,78,56.41,54,32,66,15,51,5,5,10,8505.0,1:46,3,0,3,7386.0,1:32,830000
8475769,Quinton,Howden,1992-01-21,C,L,2013-14,16,4,2,6,0.38,0,23,17.39,10,13170.0,13:43,2,6,8,25.0,32,11,9,0,9,0,0,0,52.0,0:3,1,0,1,1814.0,1:53,870000
8475770,Emerson,Etem,1992-06-16,RW,L,2013-14,29,7,4,11,0.38,3,44,15.91,4,22246.0,12:47,0,1,1,0.0,50,13,8,7,1,1,0,1,1137.0,0:39,1,0,1,1742.0,1:0,870000
8475772,Riley,Sheahan,1991-12-07,C,L,2013-14,42,9,15,24,0.57,8,59,15.25,6,36413.0,14:26,251,261,512,49.02,25,16,17,9,8,2,3,5,5326.0,2:6,0,0,0,25.0,0:0,785000
8475774,Petter,Granberg,1992-08-27,D,R,2013-14,1,0,0,0,0.0,0,0,,0,706.0,11:46,0,0,0,0.0,3,1,0,0,0,0,0,0,1.0,0:1,0,0,0,24.0,0:24,800000
8475775,Tye,McGinn,1990-07-29,LW,L,2013-14,18,4,1,5,0.28,-1,16,25.0,4,12074.0,11:10,0,0,0,0.0,26,7,4,6,-2,0,0,0,831.0,0:46,0,0,0,9.0,0:0,775000
8475784,Jeff,Skinner,1992-05-16,LW,L,2013-14,71,33,21,54,0.76,-14,274,12.04,22,73246.0,17:11,23,28,51,45.1,22,8,48,43,5,11,9,20,13169.0,3:5,0,0,0,140.0,0:1,5725000
8475790,Erik,Gudbranson,1992-01-07,D,R,2013-14,65,3,6,9,0.14,-7,92,3.26,114,70126.0,17:58,0,0,0,0.0,158,91,14,19,-5,0,1,1,3349.0,0:51,0,0,0,7575.0,1:56,900000
8475791,Taylor,Hall,1991-11-14,LW,L,2013-14,75,27,53,80,1.07,-15,250,10.8,44,90062.0,20:0,37,44,81,45.68,54,41,76,100,-24,7,10,17,14295.0,3:10,0,1,1,1684.0,0:22,6000000
8475792,Brett,Connolly,1992-05-02,RW,R,2013-14,11,1,0,1,0.09,-5,12,8.33,4,7932.0,12:1,25,27,52,48.08,9,1,3,1,2,0,0,0,768.0,1:9,0,0,0,0.0,0:0,900000
8475793,Ryan,Johansen,1992-07-31,C,R,2013-14,82,33,30,63,0.77,3,237,13.92,43,86821.0,17:38,692,619,1311,52.78,114,39,39,40,-1,7,13,20,12979.0,2:38,0,0,0,3524.0,0:42,870000
8475794,Tyler,Seguin,1992-01-31,C,R,2013-14,80,37,47,84,1.05,16,294,12.59,18,92869.0,19:20,281,396,677,41.51,48,24,67,60,7,11,14,25,18063.0,3:45,0,0,0,255.0,0:3,5750000
8475795,Dylan,McIlrath,1992-04-20,D,R,2013-14,2,0,0,0,0.0,-1,0,,7,843.0,7:1,0,0,0,0.0,2,1,0,0,0,0,0,0,0.0,0:0,0,0,0,0.0,0:0,703333
8475796,Mark,Pysyk,1992-01-11,D,R,2013-14,44,1,6,7,0.16,-11,51,1.96,16,51802.0,19:37,0,0,0,0.0,37,57,12,19,-7,0,2,2,3201.0,1:12,0,0,0,5759.0,2:10,900000
8475797,Jarred,Tinordi,1992-02-20,D,L,2013-14,22,0,2,2,0.09,-2,10,0.0,40,19181.0,14:31,0,0,0,0.0,42,27,0,12,-12,0,0,0,146.0,0:6,0,0,0,2910.0,2:12,870000
8475798,Mikael,Granlund,1992-02-26,RW,L,2013-14,63,8,33,41,0.65,-3,104,7.69,22,65488.0,17:19,415,374,789,52.6,38,46,27,24,3,2,10,12,9579.0,2:32,0,0,0,1784.0,0:28,900000
8475799,Nino,Niederreiter,1992-09-08,RW,L,2013-14,81,14,22,36,0.44,12,143,9.79,44,68501.0,14:5,7,19,26,26.92,175,23,37,24,13,2,4,6,6624.0,1:21,0,0,0,35.0,0:0,870000
8475800,Teemu,Pulkkinen,1992-01-02,LW,R,2013-14,3,0,0,0,0.0,0,4,0.0,2,1344.0,7:28,0,0,0,0.0,2,0,0,0,0,0,0,0,386.0,2:8,0,0,0,0.0,0:0,698333
8475807,Joakim,Nordstrom,1992-02-25,LW,L,2013-14,16,1,2,3,0.19,-2,26,3.85,2,11218.0,11:41,10,17,27,37.04,17,7,9,2,7,0,0,0,73.0,0:4,0,0,0,1026.0,1:4,616667
8475808,Michael,Chaput,1992-04-09,C,L,2013-14,17,0,1,1,0.06,0,6,0.0,2,9072.0,8:53,42,56,98,42.86,34,10,5,1,4,0,0,0,59.0,0:3,0,0,0,139.0,0:8,706667
8475815,Julian,Melchiori,1991-12-06,D,L,2013-14,1,0,0,0,0.0,-1,0,,0,521.0,8:41,0,0,0,0.0,1,1,0,1,-1,0,0,0,0.0,0:0,0,0,0,0.0,0:0,625000
8475833,Bill,Arnold,1992-05-13,C,R,2013-14,1,0,0,0,0.0,-1,0,,0,815.0,13:35,5,4,9,55.56,1,0,0,0,0,0,0,0,0.0,0:0,0,0,0,0.0,0:0,887500
8475844,Kenny,Agostino,1992-04-30,LW,L,2013-14,8,1,1,2,0.25,-2,12,8.33,0,5324.0,11:5,0,0,0,0.0,9,3,3,3,0,0,0,0,131.0,0:16,0,0,0,0.0,0:0,845000
8475845,Justin,Florek,1990-05-18,LW,L,2013-14,4,1,1,2,0.5,1,5,20.0,0,2843.0,11:50,0,1,1,0.0,4,0,2,0,2,0,0,0,39.0,0:9,0,0,0,188.0,0:47,690000
8475848,Brendan,Gallagher,1992-05-06,RW,R,2013-14,81,19,22,41,0.51,4,211,9.0,73,77587.0,15:57,47,81,128,36.72,38,36,41,22,19,8,1,9,11853.0,2:26,0,0,0,390.0,0:4,685000
8475855,Jesper,Fast,1991-12-02,RW,R,2013-14,11,0,0,0,0.0,-5,7,0.0,2,7451.0,11:17,0,0,0,0.0,20,7,1,1,0,0,0,0,173.0,0:15,0,0,0,968.0,1:28,805000
8475878,Freddie,Hamilton,1992-01-01,C,R,2013-14,11,0,0,0,0.0,-5,13,0.0,2,6813.0,10:19,14,22,36,38.89,24,3,3,1,2,0,0,0,62.0,0:5,0,0,0,37.0,0:3,626667
8475889,Patrick,Holland,1992-01-07,RW,R,2013-14,5,0,0,0,0.0,0,2,0.0,0,2289.0,7:37,1,1,2,50.0,2,4,0,0,0,0,0,0,2.0,0:0,0,0,0,284.0,0:56,640000
8475902,Zach,Trotman,1990-08-26,D,R,2013-14,2,0,0,0,0.0,0,4,0.0,0,1800.0,15:0,0,0,0,0.0,2,0,0,1,-1,0,0,0,200.0,1:40,0,0,0,0.0,0:0,665000
8475913,Mark,Stone,1992-05-13,RW,R,2013-14,19,4,4,8,0.42,5,36,11.11,4,16502.0,14:28,1,0,1,100.0,10,7,18,6,12,1,0,1,1654.0,1:27,0,0,0,259.0,0:13,603333
8475917,Jason,Akeson,1990-06-03,RW,R,2013-14,1,0,1,1,1.0,1,2,0.0,0,802.0,13:22,0,0,0,0.0,1,0,0,0,0,0,0,0,34.0,0:34,0,0,0,32.0,0:32,715000
8476043,Ben,Street,1987-02-13,C,L,2013-14,13,0,1,1,0.08,-2,17,0.0,4,8262.0,10:35,63,74,137,45.99,14,6,5,3,2,0,0,0,402.0,0:30,0,0,0,898.0,1:9,575000
8476062,Mark,Arcobello,1988-08-12,RW,R,2013-14,41,4,14,18,0.44,-7,70,5.71,8,37081.0,15:4,206,198,404,50.99,78,23,18,13,5,1,2,3,2787.0,1:7,0,0,0,4054.0,1:38,600000
8476086,Justin,Johnson,1981-05-05,RW,R,2013-14,2,0,0,0,0.0,-1,0,,7,778.0,6:29,0,0,0,0.0,6,0,0,0,0,0,0,0,0.0,0:0,0,0,0,0.0,0:0,-111
8476116,Ryan,Garbutt,1985-08-12,C,L,2013-14,75,17,15,32,0.43,10,165,10.3,106,58790.0,13:3,4,6,10,40.0,141,47,42,21,21,0,0,0,439.0,0:5,2,0,2,6148.0,1:21,575000
8476158,Harry,Zolnierczyk,1987-09-01,LW,L,2013-14,13,2,0,2,0.15,0,12,16.67,12,7900.0,10:7,2,0,2,100.0,14,5,3,4,-1,0,0,0,0.0,0:0,0,0,0,0.0,0:0,550000
8476162,Steve,Oleksy,1986-02-04,D,R,2013-14,33,2,8,10,0.3,7,27,7.41,53,30226.0,15:15,0,0,0,0.0,46,48,8,12,-4,0,0,0,40.0,0:1,0,0,0,3591.0,1:48,541667
8476166,Taylor,Fedun,1988-06-04,D,R,2013-14,4,2,0,2,0.5,-1,6,33.33,0,2930.0,12:12,0,0,0,0.0,1,3,1,1,0,0,0,0,0.0,0:0,0,0,0,298.0,1:14,675000
8476177,Matt,Read,1986-06-14,RW,R,2013-14,75,22,18,40,0.53,-4,151,14.57,16,84592.0,18:47,12,16,28,42.86,72,54,45,22,23,0,2,2,7188.0,1:35,4,0,4,13815.0,3:4,900000
8476179,Will,Acton,1987-07-16,C,L,2013-14,30,3,2,5,0.17,-2,18,16.67,21,14648.0,8:8,98,97,195,50.26,37,14,15,4,11,0,0,0,72.0,0:2,0,0,0,3611.0,2:0,680000
8476191,Kevan,Miller,1987-11-15,D,R,2013-14,47,1,5,6,0.13,20,41,2.44,38,49243.0,17:27,0,0,0,0.0,103,85,15,8,7,0,0,0,107.0,0:2,0,0,0,5553.0,1:58,550000
8476195,Cory,Conacher,1989-12-14,C,L,2013-14,79,7,19,26,0.33,1,100,7.0,50,61342.0,12:56,9,5,14,64.29,51,27,24,14,10,1,0,1,6878.0,1:27,0,0,0,39.0,0:0,871250
8476205,Stephane,Da Costa,1989-07-11,C,R,2013-14,12,3,1,4,0.33,2,20,15.0,2,7495.0,10:24,32,47,79,40.51,14,3,7,1,6,1,0,1,492.0,0:41,0,0,0,26.0,0:2,825000
8476206,Andy,Miele,1988-04-15,C,L,2013-14,7,0,2,2,0.29,4,6,0.0,5,3927.0,9:21,15,27,42,35.71,4,2,2,1,1,0,0,0,143.0,0:20,0,0,0,0.0,0:0,675000
8476207,Brian,Gibbons,1988-02-26,LW,L,2013-14,41,5,12,17,0.41,5,29,17.24,6,29384.0,11:56,9,13,22,40.91,24,19,10,11,-1,1,0,1,884.0,0:21,0,1,1,1599.0,0:39,550000
8476209,Mike,Sislo,1988-01-20,RW,R,2013-14,14,0,0,0,0.0,-1,20,0.0,0,7437.0,8:51,5,1,6,83.33,19,4,3,1,2,0,0,0,28.0,0:2,0,0,0,429.0,0:30,550000
8476227,Joe,Whitney,1988-02-06,RW,L,2013-14,1,0,0,0,0.0,0,0,,0,480.0,8:0,0,1,1,0.0,1,0,0,0,0,0,0,0,0.0,0:0,0,0,0,0.0,0:0,567500
8476235,Justin,Fontaine,1987-11-06,RW,R,2013-14,66,13,8,21,0.32,6,79,16.46,26,48541.0,12:15,2,0,2,100.0,9,23,24,14,10,1,1,2,3885.0,0:58,0,0,0,21.0,0:0,600000
8476244,Raphael,Diaz,1986-01-09,D,R,2013-14,63,2,13,15,0.24,-2,68,2.94,16,67946.0,17:58,0,1,1,0.0,36,127,8,22,-14,0,4,4,5839.0,1:32,0,1,1,7734.0,2:2,1225000
8476289,Alexey,Marchenko,1992-01-02,D,R,2013-14,1,0,0,0,0.0,2,0,,2,801.0,13:21,0,0,0,0.0,0,0,0,0,0,0,0,0,0.0,0:0,0,0,0,57.0,0:57,666667
8476292,Ondrej,Palat,1991-03-28,LW,L,2013-14,81,23,36,59,0.73,32,165,13.94,20,87648.0,18:2,5,32,37,13.51,146,64,47,38,9,3,8,11,7914.0,1:37,2,2,4,10076.0,2:4,575000
8476302,Frank,Corrado,1993-03-26,D,R,2013-14,15,1,0,1,0.07,-2,20,5.0,4,11308.0,12:33,0,0,0,0.0,9,17,1,3,-2,0,0,0,491.0,0:32,0,0,0,236.0,0:15,591667
8476304,David,Broll,1993-01-04,LW,L,2013-14,5,0,1,1,0.2,1,3,0.0,5,2455.0,8:11,0,0,0,0.0,7,2,2,5,-3,0,0,0,19.0,0:3,0,0,0,0.0,0:0,590833
8476346,Johnny,Gaudreau,1993-08-13,LW,L,2013-14,1,1,0,1,1.0,1,1,100.0,0,911.0,15:11,0,0,0,0.0,0,0,1,0,1,0,0,0,91.0,1:31,0,0,0,0.0,0:0,925000
8476367,John,Persson,1992-05-18,LW,L,2013-14,10,1,0,1,0.1,-4,16,6.25,6,7222.0,12:2,0,2,2,0.0,18,6,1,0,1,0,0,0,13.0,0:1,0,0,0,0.0,0:0,626667
8476381,Andrew,Shaw,1991-07-20,RW,R,2013-14,80,20,19,39,0.49,12,149,13.42,76,75314.0,15:41,296,388,684,43.27,168,16,25,18,7,5,4,9,12564.0,2:37,0,0,0,1209.0,0:15,573333
8476389,Vincent,Trocheck,1993-07-11,C,R,2013-14,20,5,3,8,0.4,-11,38,13.16,6,22664.0,18:53,166,182,348,47.7,39,11,13,8,5,1,0,1,3067.0,2:33,1,0,1,2739.0,2:16,661667
8476410,Josh,Leivo,1993-05-26,LW,R,2013-14,7,1,1,2,0.29,0,4,25.0,0,4141.0,9:51,0,1,1,0.0,5,0,2,1,1,0,0,0,58.0,0:8,0,0,0,11.0,0:1,792500
8476411,Jonathan,Racine,1993-05-28,D,L,2013-14,1,0,0,0,0.0,-1,0,,2,935.0,15:35,0,0,0,0.0,1,4,0,1,-1,0,0,0,6.0,0:6,0,0,0,103.0,1:43,674167
8476419,Jean-Gabriel,Pageau,1992-11-11,C,R,2013-14,28,2,0,2,0.07,-5,31,6.45,12,17217.0,10:14,118,128,246,47.97,41,12,8,11,-3,0,0,0,6.0,0:0,0,0,0,2720.0,1:37,613333
8476423,Reid,Boucher,1993-09-08,C,L,2013-14,23,2,5,7,0.3,2,27,7.41,4,15670.0,11:21,1,2,3,33.33,17,5,6,3,3,0,0,0,1291.0,0:56,0,0,0,34.0,0:1,692500
8476427,Ty,Rattie,1993-02-05,RW,R,2013-14,2,0,0,0,0.0,-2,4,0.0,0,1326.0,11:3,0,0,0,0.0,1,0,0,1,-1,0,0,0,285.0,2:22,0,0,0,0.0,0:0,772500
8476429,Scott,Mayfield,1992-10-14,D,R,2013-14,5,0,0,0,0.0,-3,7,0.0,7,5210.0,17:22,0,0,0,0.0,7,8,2,2,0,0,0,0,10.0,0:2,0,0,0,548.0,1:49,925000
8476430,Tomas,Jurco,1992-12-28,LW,L,2013-14,36,8,7,15,0.42,0,77,10.39,14,29085.0,13:27,0,0,0,0.0,67,9,8,10,-2,2,1,3,4153.0,1:55,0,0,0,12.0,0:0,709167
8476432,Boone,Jenner,1993-06-15,C,L,2013-14,72,16,13,29,0.4,6,127,12.6,45,60823.0,14:4,14,16,30,46.67,212,37,28,26,2,4,3,7,3981.0,0:55,0,0,0,79.0,0:1,778333
8476435,Alex,Khokhlachev,1993-09-09,C,L,2013-14,1,0,0,0,0.0,0,2,0.0,2,914.0,15:14,8,9,17,47.06,1,0,1,0,1,0,0,0,30.0,0:30,0,0,0,0.0,0:0,786667
8476436,Dmitrij,Jaskin,1993-03-23,RW,L,2013-14,18,1,1,2,0.11,-3,18,5.56,8,11473.0,10:37,1,1,2,50.0,40,5,3,1,2,0,0,0,608.0,0:33,0,0,0,93.0,0:5,772500
8476438,Brandon,Saad,1992-10-27,LW,L,2013-14,78,19,28,47,0.6,20,159,11.95,20,76239.0,16:17,50,72,122,40.98,48,20,50,24,26,3,6,9,8479.0,1:48,0,2,2,3339.0,0:42,764167
8476440,Markus,Granlund,1993-04-16,C,L,2013-14,7,2,1,3,0.43,2,9,22.22,0,5075.0,12:5,28,26,54,51.85,3,1,2,2,0,0,0,0,592.0,1:24,1,0,1,246.0,0:35,767500
8476442,Matt,Nieto,1992-11-05,LW,L,2013-14,66,10,14,24,0.36,-4,124,8.06,16,55744.0,14:4,3,8,11,27.27,7,45,17,29,-12,1,3,4,3327.0,0:50,0,0,0,2263.0,0:34,759167
8476443,Xavier,Ouellet,1993-07-29,D,L,2013-14,4,0,0,0,0.0,0,4,0.0,2,3497.0,14:34,0,0,0,0.0,7,1,0,1,-1,0,0,0,21.0,0:5,0,0,0,240.0,1:0,670000
8476445,Johan,Sundstrom,1992-09-21,C,R,2013-14,11,0,1,1,0.09,0,13,0.0,6,5719.0,8:39,4,7,11,36.36,4,2,5,3,2,0,0,0,187.0,0:17,0,0,0,75.0,0:6,770000
8476450,Ryan,Sproul,1993-01-13,D,R,2013-14,1,0,0,0,0.0,0,3,0.0,0,1105.0,18:25,0,0,0,0.0,2,2,0,0,0,0,0,0,205.0,3:25,0,0,0,0.0,0:0,620000
8476451,Lucas,Lessio,1993-01-23,LW,L,2013-14,3,0,0,0,0.0,-2,4,0.0,2,2075.0,11:31,0,0,0,0.0,2,0,1,1,0,0,0,0,0.0,0:0,0,0,0,0.0,0:0,830833
8476452,Tyler,Wotherspoon,1993-03-12,D,L,2013-14,14,0,4,4,0.29,-3,3,0.0,4,11298.0,13:27,0,0,0,0.0,8,17,2,4,-2,0,0,0,2.0,0:0,0,0,0,28.0,0:2,925000
8476453,Nikita,Kucherov,1993-06-17,RW,L,2013-14,52,9,9,18,0.35,3,102,8.82,14,40919.0,13:6,1,0,1,100.0,15,19,17,17,0,3,1,4,3707.0,1:11,0,0,0,0.0,0:0,711667
8476454,Ryan,Nugent-Hopkins,1993-04-12,C,L,2013-14,80,19,37,56,0.7,-12,178,10.67,26,97890.0,20:23,543,737,1280,42.42,72,35,63,50,13,6,14,20,14368.0,2:59,0,0,0,5974.0,1:14,925000
8476455,Gabriel,Landeskog,1992-11-23,LW,L,2013-14,81,26,39,65,0.8,21,222,11.71,71,90769.0,18:40,13,5,18,72.22,176,52,64,35,29,5,5,10,11726.0,2:24,0,0,0,1021.0,0:12,925000
8476456,Jonathan,Huberdeau,1993-06-04,LW,L,2013-14,69,9,19,28,0.41,-5,108,8.33,37,64853.0,15:39,5,6,11,45.45,73,23,32,21,11,2,3,5,8226.0,1:59,0,0,0,89.0,0:1,894167
8476457,Adam,Larsson,1992-11-12,D,R,2013-14,26,1,2,3,0.12,-1,20,5.0,12,27744.0,17:47,0,0,0,0.0,41,37,4,10,-6,0,0,0,743.0,0:28,0,0,0,1406.0,0:54,925000
8476458,Ryan,Strome,1993-07-11,C,R,2013-14,37,7,11,18,0.49,-1,89,7.87,8,33720.0,15:11,165,209,374,44.12,29,8,21,22,-1,4,3,7,4988.0,2:14,0,0,0,84.0,0:2,863333
8476459,Mika,Zibanejad,1993-04-18,C,R,2013-14,69,16,17,33,0.48,-15,153,10.46,18,59323.0,14:19,183,214,397,46.1,118,28,31,18,13,3,5,8,8154.0,1:58,0,0,0,1325.0,0:19,894167
8476460,Mark,Scheifele,1993-03-15,C,R,2013-14,63,13,21,34,0.54,9,100,13.0,14,61834.0,16:21,331,454,785,42.17,63,39,31,22,9,1,3,4,7452.0,1:58,0,0,0,185.0,0:2,863333
8476461,Sean,Couturier,1992-12-07,C,L,2013-14,82,13,26,39,0.48,1,165,7.88,45,93907.0,19:5,646,707,1353,47.75,64,40,47,40,7,0,3,3,6284.0,1:16,1,4,5,16882.0,3:25,925000
8476462,Dougie,Hamilton,1993-06-17,D,R,2013-14,64,7,18,25,0.39,22,114,6.14,40,73355.0,19:6,0,0,0,0.0,73,53,18,31,-13,2,4,6,7401.0,1:55,0,0,0,2519.0,0:39,925000
8476463,Jonas,Brodin,1993-07-12,D,L,2013-14,79,8,11,19,0.24,0,74,10.81,22,113292.0,23:54,0,0,0,0.0,33,117,28,36,-8,3,4,7,6739.0,1:25,0,0,0,10768.0,2:16,925000
8476465,Ryan,Murphy,1993-03-31,D,R,2013-14,48,2,10,12,0.25,-9,81,2.47,10,52662.0,18:17,0,0,0,0.0,22,58,32,46,-14,1,2,3,7456.0,2:35,0,0,0,219.0,0:4,863333
8476466,Sven,Baertschi,1992-10-05,LW,L,2013-14,26,2,9,11,0.42,-4,30,6.67,6,22014.0,14:6,0,0,0,0.0,22,19,9,13,-4,1,3,4,1741.0,1:6,0,0,0,35.0,0:1,894167
8476467,Jamie,Oleksiak,1992-12-21,D,L,2013-14,7,0,0,0,0.0,-3,5,0.0,2,7472.0,17:47,0,0,0,0.0,16,14,1,7,-6,0,0,0,391.0,0:55,0,0,0,1054.0,2:30,894167
8476468,J.T.,Miller,1993-03-14,C,L,2013-14,30,3,3,6,0.2,-6,46,6.52,18,20615.0,11:27,26,25,51,50.98,44,17,11,7,4,0,2,2,1521.0,0:50,0,0,0,7.0,0:0,894167
8476470,Nathan,Beaulieu,1992-12-05,D,L,2013-14,17,0,2,2,0.12,6,15,0.0,8,13493.0,13:13,0,0,0,0.0,7,20,1,13,-12,0,0,0,1178.0,1:9,0,0,0,0.0,0:0,925000
8476472,Oscar,Klefbom,1993-07-20,D,L,2013-14,17,1,2,3,0.18,-6,14,7.14,0,16113.0,15:47,0,0,0,0.0,6,25,3,9,-6,0,0,0,154.0,0:9,0,0,0,634.0,0:37,894167
8476473,Connor,Murphy,1993-03-26,D,R,2013-14,30,1,7,8,0.27,5,30,3.33,10,32365.0,17:58,0,0,0,0.0,44,38,13,13,0,0,0,0,35.0,0:1,0,0,0,3273.0,1:49,863333
8476480,Vladislav,Namestnikov,1992-11-22,C,L,2013-14,4,0,0,0,0.0,-1,4,0.0,4,2273.0,9:28,12,14,26,46.15,3,1,1,1,0,0,0,0,0.0,0:0,0,0,0,0.0,0:0,925000
8476482,Nicklas,Jensen,1993-03-06,RW,L,2013-14,17,3,3,6,0.35,-1,30,10.0,10,15951.0,15:38,0,1,1,0.0,7,6,8,7,1,0,1,1,1785.0,1:45,0,0,0,66.0,0:3,863333
8476483,Rickard,Rakell,1993-05-05,C,R,2013-14,18,0,4,4,0.22,-3,22,0.0,2,12658.0,11:43,95,99,194,48.97,21,4,5,4,1,0,0,0,363.0,0:20,0,0,0,135.0,0:7,894167
8476522,Adam,Payerl,1991-03-04,C,R,2013-14,2,0,0,0,0.0,-1,4,0.0,2,1098.0,9:9,0,0,0,0.0,6,2,0,0,0,0,0,0,0.0,0:0,0,0,0,0.0,0:0,626666
8476765,Mike,Halmo,1991-05-15,LW,L,2013-14,20,1,0,1,0.05,-1,25,4.0,32,11390.0,9:29,4,16,20,20.0,52,4,4,2,2,0,0,0,231.0,0:11,0,0,0,92.0,0:4,864167
8476779,Brad,Hunt,1988-08-24,D,L,2013-14,3,0,0,0,0.0,-3,1,0.0,0,2268.0,12:36,0,0,0,0.0,0,2,1,1,0,0,0,0,183.0,1:1,0,0,0,0.0,0:0,550000
8476792,Torey,Krug,1991-04-12,D,L,2013-14,79,14,26,40,0.51,18,183,7.65,28,82997.0,17:30,1,1,2,50.0,50,77,24,35,-11,6,13,19,11923.0,2:30,0,0,0,1186.0,0:15,916667
8476798,Karl,Stollery,1987-11-21,D,L,2013-14,2,0,0,0,0.0,1,1,0.0,2,781.0,6:30,0,0,0,0.0,3,0,0,0,0,0,0,0,0.0,0:0,0,0,0,5.0,0:2,550000
8476799,Cameron,Schilling,1988-10-07,D,L,2013-14,1,0,0,0,0.0,-2,2,0.0,0,1065.0,17:45,0,0,0,0.0,2,0,0,0,0,0,0,0,0.0,0:0,0,0,0,0.0,0:0,925000
8476805,Spencer,Abbott,1988-04-30,LW,R,2013-14,1,0,0,0,0.0,-2,2,0.0,0,316.0,5:16,0,0,0,0.0,1,0,0,0,0,0,0,0,0.0,0:0,0,0,0,0.0,0:0,650000
8476806,J.T.,Brown,1990-07-02,RW,R,2013-14,63,4,15,19,0.3,-9,113,3.54,6,49268.0,13:2,7,15,22,31.82,70,32,19,12,7,0,2,2,1811.0,0:28,0,1,1,3626.0,0:57,874125
8476808,Brian,Flynn,1988-07-26,C,R,2013-14,79,6,7,13,0.16,-10,102,5.88,14,68346.0,14:25,184,205,389,47.3,51,55,28,15,13,0,0,0,572.0,0:7,1,0,1,11015.0,2:19,637500
8476819,Jeremy,Welsh,1988-04-30,C,L,2013-14,19,1,0,1,0.05,-1,13,7.69,6,7817.0,6:51,46,44,90,51.11,16,8,3,5,-2,0,0,0,62.0,0:3,0,0,0,62.0,0:3,850000
8476822,Luke,Glendening,1989-04-28,RW,R,2013-14,56,1,6,7,0.12,-8,54,1.85,22,46751.0,13:54,329,349,678,48.53,92,38,12,7,5,0,0,0,343.0,0:6,0,0,0,9136.0,2:43,575000
8476827,Chad,Billins,1989-05-26,D,L,2013-14,10,0,3,3,0.3,-3,3,0.0,0,7325.0,12:12,0,0,0,0.0,0,9,2,2,0,0,0,0,723.0,1:12,0,0,0,0.0,0:0,925000
8476850,Ryan,Murray,1993-09-27,D,L,2013-14,66,4,17,21,0.32,4,62,6.45,10,78688.0,19:52,0,0,0,0.0,26,97,12,26,-14,3,4,7,8161.0,2:3,0,1,1,6878.0,1:44,894167
8476851,Alex,Galchenyuk,1994-02-12,LW,L,2013-14,65,13,18,31,0.48,-12,110,11.82,26,56141.0,14:23,5,10,15,33.33,49,25,30,23,7,3,7,10,7940.0,2:2,0,0,0,76.0,0:1,925000
8476853,Morgan,Rielly,1994-03-09,D,L,2013-14,73,2,25,27,0.37,-13,96,2.08,12,77238.0,17:38,0,0,0,0.0,96,92,38,71,-33,1,11,12,8419.0,1:55,0,0,0,618.0,0:8,894167
8476854,Hampus,Lindholm,1994-01-20,D,L,2013-14,78,6,24,30,0.38,29,116,5.17,36,90940.0,19:25,0,1,1,0.0,54,61,22,45,-23,1,3,4,9792.0,2:5,0,0,0,1900.0,0:24,894167
8476855,Nail,Yakupov,1993-10-06,RW,L,2013-14,63,11,13,24,0.38,-33,122,9.02,36,54107.0,14:18,0,0,0,0.0,64,23,18,32,-14,4,2,6,8242.0,2:10,0,0,0,37.0,0:0,925000
8476856,Matt,Dumba,1994-07-25,D,R,2013-14,13,1,1,2,0.15,-5,12,8.33,2,9710.0,12:26,0,0,0,0.0,9,3,2,5,-3,1,1,2,1287.0,1:39,0,0,0,32.0,0:2,894167
8476871,Tanner,Pearson,1992-08-10,LW,L,2013-14,25,3,4,7,0.28,2,31,9.68,8,16213.0,10:48,1,1,2,50.0,35,9,9,9,0,1,0,1,952.0,0:38,0,0,0,179.0,0:7,735833
8476874,Olli,Maatta,1994-08-22,D,L,2013-14,78,9,20,29,0.37,8,119,7.56,14,86574.0,18:29,0,0,0,0.0,41,112,10,35,-25,3,3,6,5653.0,1:12,1,0,1,5192.0,1:6,894167
8476878,Zemgus,Girgensons,1994-01-05,C,L,2013-14,70,8,14,22,0.31,-6,115,6.96,14,64327.0,15:18,100,140,240,41.67,161,43,25,15,10,0,0,0,1589.0,0:22,1,1,2,7537.0,1:47,894167
8476879,Cody,Ceci,1993-12-21,D,R,2013-14,49,3,6,9,0.18,-5,82,3.66,14,50581.0,17:12,0,0,0,0.0,45,49,12,15,-3,0,0,0,4181.0,1:25,0,0,0,5148.0,1:45,894167
8476880,Tom,Wilson,1994-03-29,RW,R,2013-14,82,3,7,10,0.12,1,63,4.76,151,39057.0,7:56,0,3,3,0.0,197,13,17,10,7,1,0,1,477.0,0:5,0,0,0,3.0,0:0,894167
8476881,Tomas,Hertl,1993-11-12,C,L,2013-14,37,15,10,25,0.68,11,98,15.31,4,34029.0,15:19,29,22,51,56.86,39,13,18,18,0,3,0,3,4577.0,2:3,0,0,0,12.0,0:0,925000
8476882,Teuvo,Teravainen,1994-09-11,LW,L,2013-14,3,0,0,0,0.0,0,4,0.0,0,2537.0,14:5,13,12,25,52.0,1,0,4,1,3,0,0,0,298.0,1:39,0,0,0,0.0,0:0,925000
8476885,Jacob,Trouba,1994-02-26,D,R,2013-14,65,10,19,29,0.45,4,121,8.26,43,87502.0,22:26,0,0,0,0.0,95,132,31,88,-57,0,3,3,7694.0,1:58,1,0,1,11424.0,2:55,894167
8476887,Filip,Forsberg,1994-08-13,LW,R,2013-14,13,1,4,5,0.38,-8,20,5.0,4,8896.0,11:24,0,0,0,0.0,6,2,6,6,0,1,3,4,1510.0,1:56,0,0,0,0.0,0:0,894167
8476888,Mikhail,Grigorenko,1994-05-16,C,L,2013-14,18,2,1,3,0.17,-3,20,10.0,2,12344.0,11:25,53,50,103,51.46,6,5,7,7,0,0,1,1,1012.0,0:56,0,0,0,0.0,0:0,925000
8476925,Colton,Sissons,1993-11-05,C,R,2013-14,17,1,3,4,0.24,0,13,7.69,4,10830.0,10:37,70,74,144,48.61,9,9,6,2,4,0,0,0,2.0,0:0,0,0,0,715.0,0:42,635000
8476931,Jake,McCabe,1993-10-12,D,L,2013-14,7,0,1,1,0.14,-3,1,0.0,15,6390.0,15:12,0,0,0,0.0,5,10,2,0,2,0,0,0,21.0,0:3,0,0,0,365.0,0:52,925000
8476941,Connor,Carrick,1994-04-13,D,R,2013-14,34,1,5,6,0.18,-9,26,3.85,23,32584.0,15:58,0,0,0,0.0,25,56,6,18,-12,0,0,0,658.0,0:19,0,0,0,2430.0,1:11,636667
8476975,Cedric,Paquette,1993-08-13,C,L,2013-14,2,0,1,1,0.5,1,1,0.0,0,1745.0,14:32,16,13,29,55.17,2,4,0,0,0,0,0,0,0.0,0:0,0,0,0,43.0,0:21,633333
8477059,Damien,Brunner,1986-03-09,RW,R,2013-14,60,11,14,25,0.42,-11,110,10.0,26,48723.0,13:32,1,7,8,12.5,15,5,16,21,-5,4,6,10,7491.0,2:4,0,1,1,59.0,0:0,-111
8477082,Dmitry,Korobov,1989-03-12,D,L,2013-14,3,0,1,1,0.33,0,0,,2,1924.0,10:41,0,0,0,0.0,5,0,0,2,-2,0,0,0,9.0,0:3,0,0,0,32.0,0:10,-111
8477126,Jayson,Megna,1990-02-01,C,R,2013-14,36,5,4,9,0.25,1,36,13.89,6,22647.0,10:29,2,8,10,20.0,47,13,7,4,3,0,0,0,10.0,0:0,0,0,0,355.0,0:9,925000
8477201,Kellan,Lain,1989-08-11,LW,L,2013-14,9,1,0,1,0.11,1,7,14.29,21,2818.0,5:13,18,19,37,48.65,7,1,2,1,1,0,0,0,4.0,0:0,0,0,0,17.0,0:1,600000
8477205,Andrej,Sustr,1990-11-29,D,R,2013-14,43,1,7,8,0.19,3,39,2.56,16,40747.0,15:47,0,0,0,0.0,26,36,4,22,-18,0,0,0,246.0,0:5,0,2,2,3107.0,1:12,925000
8477214,Conor,Allen,1990-01-31,D,L,2013-14,3,0,0,0,0.0,-1,2,0.0,0,2599.0,14:26,0,0,0,0.0,1,1,0,0,0,0,0,0,0.0,0:0,0,0,0,0.0,0:0,925000
8477215,Danny,DeKeyser,1990-03-07,D,L,2013-14,65,4,19,23,0.35,10,84,4.76,30,84399.0,21:38,0,0,0,0.0,64,116,13,36,-23,1,3,4,6160.0,1:34,1,0,1,8702.0,2:13,925000
8477220,Nate,Schmidt,1991-07-16,D,L,2013-14,29,2,4,6,0.21,4,41,4.88,6,32528.0,18:41,0,0,0,0.0,18,35,10,21,-11,0,0,0,320.0,0:11,0,0,0,1018.0,0:35,925000
8477227,Eriah,Hayes,1988-07-07,RW,R,2013-14,15,1,0,1,0.07,-2,17,5.88,2,7051.0,7:50,9,12,21,42.86,40,10,2,3,-1,0,0,0,22.0,0:1,0,0,0,0.0,0:0,655000
8477228,Matt,Lindblad,1990-03-23,C,L,2013-14,2,0,0,0,0.0,0,0,,0,1411.0,11:45,2,0,2,100.0,0,0,1,0,1,0,0,0,0.0,0:0,0,0,0,59.0,0:29,833750
8477244,Chad,Ruhwedel,1990-05-07,D,R,2013-14,21,0,1,1,0.05,-3,35,0.0,2,22527.0,17:52,0,0,0,0.0,20,29,6,6,0,0,1,1,1022.0,0:48,0,0,0,1483.0,1:10,925000
8477289,Anton,Belov,1986-07-29,D,L,2013-14,57,1,6,7,0.12,-12,54,1.85,34,57060.0,16:41,0,0,0,0.0,103,75,7,46,-39,0,2,2,4514.0,1:19,0,0,0,1652.0,0:28,-111
8477290,Michael,Raffl,1988-12-01,LW,L,2013-14,68,9,13,22,0.32,2,101,8.91,28,53003.0,12:59,52,41,93,55.91,113,44,25,21,4,0,0,0,763.0,0:11,0,0,0,7075.0,1:44,792500
8477492,Nathan,MacKinnon,1995-09-01,C,R,2013-14,82,24,39,63,0.77,20,241,9.96,26,85333.0,17:20,194,258,452,42.92,57,45,51,28,23,8,9,17,11491.0,2:20,0,0,0,341.0,0:4,925000
8477493,Aleksander,Barkov,1995-09-02,C,L,2013-14,54,8,16,24,0.44,-3,87,9.2,10,55393.0,17:5,400,419,819,48.84,16,27,30,17,13,3,3,6,8647.0,2:40,0,0,0,427.0,0:7,925000
8477495,Seth,Jones,1994-10-03,D,R,2013-14,77,6,19,25,0.32,-23,100,6.0,24,90646.0,19:37,0,0,0,0.0,55,99,25,57,-32,2,7,9,9107.0,1:58,0,0,0,7688.0,1:39,925000
8477496,Elias,Lindholm,1994-12-02,C,R,2013-14,58,9,12,21,0.36,-14,70,12.86,4,50550.0,14:31,106,123,229,46.29,51,17,37,28,9,4,3,7,8716.0,2:30,0,0,0,190.0,0:3,925000
8477497,Sean,Monahan,1994-10-12,C,L,2013-14,75,22,12,34,0.45,-20,140,15.71,8,71901.0,15:58,476,560,1036,45.95,42,23,26,31,-5,3,4,7,9442.0,2:5,0,0,0,1128.0,0:15,925000
8477499,Rasmus,Ristolainen,1994-10-27,D,R,2013-14,34,2,2,4,0.12,-15,52,3.85,6,38998.0,19:7,0,1,1,0.0,66,32,9,19,-10,0,0,0,3351.0,1:38,0,0,0,2807.0,1:22,925000
8477501,Valeri,Nichushkin,1995-03-04,RW,L,2013-14,79,14,20,34,0.43,20,128,10.94,8,70955.0,14:58,0,1,1,0.0,86,27,25,59,-34,2,1,3,6253.0,1:19,0,0,0,54.0,0:0,925000
8477507,Nikita,Zadorov,1995-04-16,D,L,2013-14,7,1,0,1,0.14,-4,4,25.0,4,7212.0,17:10,0,0,0,0.0,25,3,1,5,-4,0,0,0,77.0,0:11,0,0,0,415.0,0:59,925000
8477666,Simon,Moser,1989-03-10,C,L,2013-14,6,1,1,2,0.33,0,7,14.29,2,3647.0,10:7,0,0,0,0.0,5,1,1,0,1,0,0,0,0.0,0:0,0,0,0,144.0,0:24,-111
8477814,Kevin,Czuczman,1991-01-09,D,L,2013-14,13,0,2,2,0.15,-5,24,0.0,14,15244.0,19:32,1,0,1,100.0,15,13,6,6,0,0,0,0,452.0,0:34,0,0,0,1288.0,1:39,925000
8477816,Michael,Zalewski,1992-08-18,LW,L,2013-14,2,0,1,1,0.5,2,2,0.0,0,1455.0,12:7,0,0,0,0.0,0,0,1,0,1,0,1,1,69.0,0:34,0,0,0,0.0,0:0,925000
8477832,Cody,Kunyk,1990-05-20,RW,L,2013-14,1,0,0,0,0.0,0,2,0.0,0,612.0,10:12,1,4,5,20.0,1,1,0,0,0,0,0,0,0.0,0:0,0,0,0,0.0,0:0,1584063
8477836,Matt,Carey,1992-02-28,LW,L,2013-14,2,1,0,1,0.5,-1,1,100.0,2,1156.0,9:38,10,11,21,47.62,2,0,0,0,0,0,0,0,52.0,0:26,0,0,0,0.0,0:0,925000
8477847,Bryce,Van Brabant,1991-11-12,LW,L,2013-14,6,0,0,0,0.0,-1,4,0.0,2,3297.0,9:9,0,0,0,0.0,17,4,2,1,1,0,0,0,4.0,0:0,0,0,0,0.0,0:0,912500
8477850,Christian,Folin,1991-02-09,D,R,2013-14,1,0,1,1,1.0,3,0,,0,1166.0,19:26,0,0,0,0.0,1,0,0,0,0,0,0,0,120.0,2:0,0,0,0,158.0,2:38,925000
