player_id,firstName,lastName,birthDate,primaryPosition,shootsCatches,season,gamesPlayed,goals,assists,points,pointsPerGame,plusMinus,shots,shootingPercentage,penaltyMinutes,timeOnIce,avgTimeOnIce,faceOffWins,faceOffLosses,faceOffTaken,faceOffPercentage,hits,blocks,takeaways,giveaways,turnoverDifferential,powerPlayGoals,powerPlayAssists,powerPlayPoints,powerPlayTimeOnIce,avgPowerPlayTimeOnIce,shortHandedGoals,shortHandedAssists,shortHandedPoints,shortHandedTimeOnIce,avgShortHandedTimeOnIce,salary
8448208,Jaromir,Jagr,1972-02-15,RW,L,2014-15,77,17,30,47,0.61,-3,169,10.06,48,81174.0,17:34,1,0,1,100.0,30,14,38,46,-8,4,7,11,10925.0,2:21,0,0,0,38.0,0:0,3500000
8458951,Sergei,Gonchar,1974-04-13,D,L,2014-15,48,1,13,14,0.29,6,46,2.17,18,50942.0,17:41,1,0,1,100.0,45,71,5,29,-24,0,4,4,5848.0,2:1,0,0,0,1157.0,0:24,5000000
8459670,Kimmo,Timonen,1975-03-18,D,L,2014-15,16,0,0,0,0.0,-3,10,0.0,2,11496.0,11:58,0,0,0,0.0,15,15,0,6,-6,0,0,0,443.0,0:27,0,0,0,44.0,0:2,2000000
8460542,Patrik,Elias,1976-04-13,C,L,2014-15,69,13,21,34,0.49,-20,114,11.4,12,73038.0,17:38,263,410,673,39.08,23,25,18,40,-22,5,4,9,8489.0,2:3,0,2,2,7487.0,1:48,5500000
8460626,Bryce,Salvador,1976-02-11,D,L,2014-15,15,0,2,2,0.13,-5,13,0.0,20,16652.0,18:30,0,0,0,0.0,22,19,1,7,-6,0,0,0,4.0,0:0,0,0,0,3633.0,4:2,3166667
8460720,Eric,Boulton,1976-08-17,LW,L,2014-15,10,2,0,2,0.2,-1,9,22.22,30,4318.0,7:11,0,0,0,0.0,10,4,1,1,0,0,0,0,19.0,0:1,0,0,0,0.0,0:0,650000
8462038,Shane,Doan,1976-10-10,RW,R,2014-15,79,14,22,36,0.46,-29,189,7.41,65,89506.0,18:52,3,8,11,27.27,189,26,43,42,1,5,5,10,12529.0,2:38,0,0,0,3241.0,0:41,5300000
8462042,Jarome,Iginla,1977-07-01,RW,R,2014-15,82,29,30,59,0.72,0,189,15.34,42,89227.0,18:8,57,71,128,44.53,99,47,31,30,1,8,5,13,13686.0,2:46,0,0,0,586.0,0:7,5333333
8462196,Stephane,Robidas,1977-03-03,D,R,2014-15,52,1,6,7,0.13,8,34,2.94,34,53257.0,17:4,0,0,0,0.0,141,75,8,16,-8,0,0,0,478.0,0:9,0,1,1,6816.0,2:11,3000000
8464956,Chris,Phillips,1978-03-09,D,L,2014-15,36,0,3,3,0.08,0,29,0.0,12,45136.0,20:53,0,0,0,0.0,70,54,7,26,-19,0,1,1,636.0,0:17,0,0,0,6456.0,2:59,2500000
8464975,Daniel,Briere,1977-10-06,C,R,2014-15,57,8,4,12,0.21,-7,69,11.59,18,41457.0,12:7,13,11,24,54.17,19,9,23,9,14,0,0,0,4327.0,1:15,0,0,0,108.0,0:1,6500000
8464977,Dainius,Zubrus,1978-06-16,C,L,2014-15,74,4,6,10,0.14,-9,72,5.56,42,65086.0,14:39,37,49,86,43.02,99,41,19,19,0,0,1,1,1220.0,0:16,0,1,1,6111.0,1:22,3100000
8464989,Matt,Cullen,1976-11-02,C,L,2014-15,62,7,18,25,0.4,8,90,7.78,16,48409.0,13:0,155,132,287,54.01,10,18,26,22,4,0,4,4,1840.0,0:29,0,0,0,2997.0,0:48,3500000
8465009,Zdeno,Chara,1977-03-18,D,L,2014-15,63,8,12,20,0.32,0,138,5.8,42,88255.0,23:20,1,0,1,100.0,125,99,14,55,-41,4,1,5,7909.0,2:5,0,3,3,11570.0,3:3,6916667
8465058,Michal,Rozsival,1978-09-03,D,R,2014-15,65,1,12,13,0.2,0,56,1.79,22,66339.0,17:0,0,0,0,0.0,103,87,17,36,-19,0,0,0,1723.0,0:26,0,0,0,2101.0,0:32,2200000
8465166,Craig,Adams,1977-04-26,RW,R,2014-15,70,1,6,7,0.1,-1,51,1.96,44,40931.0,9:44,17,23,40,42.5,183,29,6,7,-1,0,0,0,141.0,0:2,0,1,1,10728.0,2:33,700000
8465185,Willie,Mitchell,1977-04-23,D,L,2014-15,66,3,5,8,0.12,1,78,3.85,25,85848.0,21:40,0,0,0,0.0,99,144,17,34,-17,0,0,0,535.0,0:8,0,1,1,12970.0,3:16,4250000
8465951,Matt,Cooke,1978-09-07,LW,L,2014-15,29,4,6,10,0.34,0,24,16.67,13,21924.0,12:36,3,6,9,33.33,39,22,11,7,4,0,0,0,115.0,0:3,0,0,0,3605.0,2:4,2500000
8465978,Shawn,Thornton,1977-07-23,LW,R,2014-15,46,1,4,5,0.11,-13,53,1.89,50,26452.0,9:35,3,9,12,25.0,93,5,10,5,5,0,0,0,214.0,0:4,0,0,0,60.0,0:1,1200000
8466138,Joe,Thornton,1979-07-02,C,L,2014-15,78,16,49,65,0.83,-4,131,12.21,30,86225.0,18:25,554,401,955,58.01,39,26,60,91,-31,4,18,22,14724.0,3:8,0,0,0,1741.0,0:22,6750000
8466139,Patrick,Marleau,1979-09-15,C,L,2014-15,82,19,38,57,0.7,-17,233,8.15,12,96386.0,19:35,171,185,356,48.03,85,28,44,75,-31,7,17,24,16152.0,3:16,0,0,0,6897.0,1:24,6666667
8466140,Olli,Jokinen,1978-12-05,C,L,2014-15,62,4,6,10,0.16,6,110,3.64,28,49342.0,13:15,134,196,330,40.61,64,19,11,11,0,0,0,0,1502.0,0:24,0,0,0,4889.0,1:18,2500000
8466142,Eric,Brewer,1979-04-17,D,L,2014-15,44,3,8,11,0.25,-5,33,9.09,36,49328.0,18:41,0,0,0,0.0,87,72,8,16,-8,0,0,0,416.0,0:9,0,1,1,5645.0,2:8,3875000
8466148,Marian,Hossa,1979-01-12,RW,L,2014-15,82,22,39,61,0.74,17,247,8.91,32,91288.0,18:33,4,3,7,57.14,62,26,68,30,38,6,11,17,12201.0,2:28,1,0,1,7529.0,1:31,5275000
8466149,Daniel,Cleary,1978-12-18,RW,L,2014-15,17,1,1,2,0.12,-4,17,5.88,6,9316.0,9:8,2,2,4,50.0,21,9,2,1,1,0,0,0,86.0,0:5,0,0,0,387.0,0:22,1500000
8466158,Scott,Hannan,1979-01-23,D,L,2014-15,58,2,5,7,0.12,0,53,3.77,26,56767.0,16:18,0,0,0,0.0,32,69,8,16,-8,0,0,0,137.0,0:2,0,0,0,6062.0,1:44,1000000
8466160,Brenden,Morrow,1979-01-16,LW,L,2014-15,70,3,5,8,0.11,-1,28,10.71,64,39176.0,9:19,0,0,0,0.0,112,16,11,20,-9,0,0,0,457.0,0:6,0,0,0,129.0,0:1,1550000
8466251,Jason,Chimera,1979-05-02,LW,L,2014-15,77,7,12,19,0.25,-1,96,7.29,51,59763.0,12:56,43,33,76,56.58,132,18,27,15,12,0,0,0,866.0,0:11,0,0,0,6464.0,1:23,2000000
8466285,Brian,Campbell,1979-05-23,D,L,2014-15,82,3,24,27,0.33,4,118,2.54,22,114185.0,23:12,0,0,0,0.0,44,85,16,34,-18,1,11,12,14916.0,3:1,0,0,0,4967.0,1:0,7142875
8466333,Andrew,Ference,1979-03-17,D,L,2014-15,70,3,11,14,0.2,-17,58,5.17,39,79283.0,18:52,0,2,2,0.0,156,86,12,38,-26,0,0,0,370.0,0:5,0,1,1,7850.0,1:52,3250000
8466378,Martin,St. Louis,1975-06-18,RW,L,2014-15,74,21,31,52,0.7,12,144,14.58,20,77979.0,17:33,51,59,110,46.36,13,37,41,43,-2,5,8,13,12761.0,2:52,0,0,0,485.0,0:6,5625000
8466393,Pascal,Dupuis,1979-04-07,RW,L,2014-15,16,6,5,11,0.69,2,44,13.64,4,15981.0,16:38,1,0,1,100.0,20,8,6,5,1,2,1,3,1705.0,1:46,0,1,1,2083.0,2:10,3750000
8467096,Dan,Boyle,1976-07-12,D,R,2014-15,65,9,11,20,0.31,18,116,7.76,20,78953.0,20:14,0,0,0,0.0,49,79,20,33,-13,3,5,8,10280.0,2:38,0,0,0,3383.0,0:52,4500000
8467329,Vincent,Lecavalier,1980-04-21,C,L,2014-15,57,8,12,20,0.35,-7,103,7.77,36,43254.0,12:38,95,96,191,49.74,40,15,11,16,-5,1,3,4,6599.0,1:55,0,0,0,11.0,0:0,7727272
8467330,David,Legwand,1980-08-17,C,L,2014-15,80,9,18,27,0.34,1,91,9.89,32,66705.0,13:53,451,517,968,46.59,43,25,30,25,5,6,6,12,11150.0,2:19,0,2,2,8135.0,1:41,3000000
8467331,Brad,Stuart,1979-11-06,D,L,2014-15,65,3,10,13,0.2,-4,64,4.69,16,79375.0,20:21,1,0,1,100.0,177,134,15,22,-7,0,1,1,1241.0,0:19,0,0,0,9996.0,2:33,3600000
8467332,Bryan,Allen,1980-08-21,D,L,2014-15,11,0,2,2,0.18,-2,6,0.0,6,10377.0,15:43,0,0,0,0.0,20,15,0,8,-8,0,0,0,0.0,0:0,0,0,0,948.0,1:26,3500000
8467334,Manny,Malhotra,1980-05-18,C,L,2014-15,58,1,3,4,0.07,-6,46,2.17,12,37769.0,10:51,537,369,906,59.27,37,62,14,23,-9,0,0,0,148.0,0:2,0,0,0,8326.0,2:23,850000
8467338,Alex,Tanguay,1979-11-21,LW,L,2014-15,80,22,33,55,0.69,-1,104,21.15,40,87172.0,18:9,12,16,28,42.86,45,39,34,33,1,2,12,14,11467.0,2:23,1,0,1,6870.0,1:25,3500000
8467344,Robyn,Regehr,1980-04-19,D,L,2014-15,67,3,10,13,0.19,10,63,4.76,45,81713.0,20:19,0,0,0,0.0,203,83,12,34,-22,0,0,0,528.0,0:7,0,1,1,10430.0,2:35,3000000
8467346,Simon,Gagne,1980-02-29,LW,L,2014-15,23,3,1,4,0.17,0,27,11.11,4,15604.0,11:18,1,8,9,11.11,20,7,3,7,-4,0,0,0,52.0,0:2,0,0,0,566.0,0:24,600000
8467351,Scott,Gomez,1979-12-23,C,L,2014-15,58,7,27,34,0.59,-10,70,10.0,23,57466.0,16:30,367,421,788,46.57,24,15,22,37,-15,0,14,14,6620.0,1:54,0,0,0,214.0,0:3,550000
8467370,Mike,Fisher,1980-06-05,C,R,2014-15,59,19,20,39,0.66,4,111,17.12,39,65256.0,18:26,601,548,1149,52.31,125,60,27,16,11,7,3,10,9668.0,2:43,1,0,1,5828.0,1:38,4200000
8467371,Mike,Ribeiro,1980-02-10,C,L,2014-15,82,15,47,62,0.76,11,96,15.62,52,92232.0,18:44,582,766,1348,43.18,42,19,32,47,-15,1,11,12,14308.0,2:54,0,0,0,141.0,0:1,5500000
8467389,Brad,Richards,1980-05-02,C,L,2014-15,76,12,25,37,0.49,3,199,6.03,12,67889.0,14:53,399,426,825,48.36,32,27,22,31,-9,2,5,7,9318.0,2:2,0,0,0,97.0,0:1,6666666
8467396,Erik,Cole,1978-11-06,LW,L,2014-15,68,21,18,39,0.57,2,122,17.21,14,59353.0,14:32,5,11,16,31.25,134,20,24,28,-4,3,6,9,7480.0,1:50,1,0,1,1479.0,0:21,4500000
8467400,Francois,Beauchemin,1980-06-04,D,L,2014-15,64,11,12,23,0.36,17,110,10.0,48,87338.0,22:44,1,0,1,100.0,105,107,18,40,-22,2,1,3,5911.0,1:32,0,1,1,8550.0,2:13,3500000
8467407,Brian,Gionta,1979-01-18,RW,R,2014-15,69,13,22,35,0.51,-13,153,8.5,18,74745.0,18:3,69,100,169,40.83,61,31,31,20,11,3,6,9,8561.0,2:4,1,0,1,5330.0,1:17,4250000
8467423,Shawn,Horcoff,1978-09-17,C,L,2014-15,76,11,18,29,0.38,9,82,13.41,27,59369.0,13:1,237,235,472,50.21,80,25,20,22,-2,4,1,5,7430.0,1:37,0,0,0,4096.0,0:53,5500000
8467452,Rob,Scuderi,1978-12-30,D,L,2014-15,82,1,9,10,0.12,9,52,1.92,17,94198.0,19:8,0,0,0,0.0,41,110,8,44,-36,0,0,0,306.0,0:3,0,1,1,15527.0,3:9,3375000
8467493,Chris,Neil,1979-06-18,RW,R,2014-15,38,4,3,7,0.18,5,23,17.39,78,22198.0,9:44,3,2,5,60.0,136,11,4,2,2,1,0,1,342.0,0:9,0,0,0,45.0,0:1,1900000
8467496,Andrei,Markov,1978-12-20,D,L,2014-15,81,10,40,50,0.62,22,135,7.41,38,121064.0,24:54,0,0,0,0.0,53,173,46,79,-33,4,21,25,15761.0,3:14,0,1,1,12190.0,2:30,5750000
8467514,Pavel,Datsyuk,1978-07-20,C,L,2014-15,63,26,39,65,1.03,12,165,15.76,8,72014.0,19:3,601,521,1122,53.57,51,28,59,29,30,8,16,24,10852.0,2:52,0,0,0,398.0,0:6,7500000
8467545,Michael,Ryder,1980-03-31,RW,R,2014-15,47,6,13,19,0.4,-1,89,6.74,30,40835.0,14:28,2,4,6,33.33,53,14,10,15,-5,0,2,2,4175.0,1:28,0,0,0,55.0,0:1,3500000
8467875,Daniel,Sedin,1980-09-26,LW,L,2014-15,82,20,56,76,0.93,5,226,8.85,18,90316.0,18:21,2,3,5,40.0,21,16,19,36,-17,4,21,25,14772.0,3:0,0,0,0,3603.0,0:43,7000000
8467876,Henrik,Sedin,1980-09-26,C,L,2014-15,82,18,55,73,0.89,11,101,17.82,22,91570.0,18:36,704,861,1565,44.98,25,24,33,38,-5,5,20,25,14651.0,2:58,0,0,0,4023.0,0:49,7000000
8467890,Barret,Jackman,1981-03-05,D,L,2014-15,80,2,13,15,0.19,3,86,2.33,47,80717.0,16:48,0,0,0,0.0,108,126,17,30,-13,0,0,0,68.0,0:0,0,1,1,10949.0,2:16,3166667
8467899,Martin,Havlat,1981-04-19,RW,L,2014-15,40,5,9,14,0.35,-11,49,10.2,10,35538.0,14:48,0,0,0,0.0,11,11,20,12,8,3,3,6,3874.0,1:36,0,0,0,91.0,0:2,1500000
8467917,Jordan,Leopold,1980-08-03,D,L,2014-15,43,1,3,4,0.09,-6,39,2.56,19,38501.0,14:55,0,0,0,0.0,33,50,9,8,1,1,0,1,686.0,0:15,0,0,0,1065.0,0:24,2250000
8467967,Chris,Kelly,1980-11-11,C,L,2014-15,80,7,21,28,0.35,6,112,6.25,48,72676.0,15:8,262,277,539,48.61,126,61,28,16,12,0,0,0,407.0,0:5,1,1,2,8450.0,1:45,3000000
8467977,Brian,McGrattan,1981-09-02,RW,R,2014-15,8,0,0,0,0.0,-2,10,0.0,4,3186.0,6:38,0,0,0,0.0,11,1,3,0,3,0,0,0,18.0,0:2,0,0,0,0.0,0:0,750000
8467988,Ryan,Malone,1979-12-01,LW,L,2014-15,6,0,0,0,0.0,-4,6,0.0,4,3610.0,10:1,1,0,1,100.0,14,2,0,3,-3,0,0,0,800.0,2:13,0,0,0,0.0,0:0,4500000
8468001,Derek,MacKenzie,1981-06-11,C,L,2014-15,82,5,6,11,0.13,-17,72,6.94,45,61258.0,12:27,543,479,1022,53.13,273,51,26,12,14,1,0,1,906.0,0:11,0,0,0,11769.0,2:23,1300000
8468064,Martin,Erat,1981-08-29,RW,L,2014-15,79,9,23,32,0.41,-16,91,9.89,48,75203.0,15:51,0,6,6,0.0,96,25,27,26,1,3,3,6,7881.0,1:39,0,0,0,2413.0,0:30,4500000
8468083,Henrik,Zetterberg,1980-10-09,C,L,2014-15,77,17,49,66,0.86,-6,227,7.49,32,88293.0,19:6,541,523,1064,50.85,55,26,37,29,8,4,24,28,14901.0,3:13,0,0,0,407.0,0:5,6083333
8468085,Radim,Vrbata,1981-06-13,RW,R,2014-15,79,31,32,63,0.8,6,267,11.61,20,78740.0,16:36,5,4,9,55.56,44,25,33,26,7,12,11,23,13820.0,2:54,0,0,0,404.0,0:5,5000000
8468208,Joel,Ward,1980-12-02,RW,R,2014-15,82,19,15,34,0.41,-4,138,13.77,30,82960.0,16:51,60,67,127,47.24,53,38,39,19,20,6,5,11,7488.0,1:31,0,0,0,8193.0,1:39,3000000
8468309,Mark,Streit,1977-12-11,D,L,2014-15,81,9,43,52,0.64,-8,144,6.25,36,108708.0,22:22,0,0,0,0.0,63,103,16,41,-25,4,26,30,17440.0,3:35,0,0,0,1712.0,0:21,5250000
8468478,Mike,Weaver,1978-05-02,D,R,2014-15,31,0,4,4,0.13,0,8,0.0,6,26345.0,14:9,0,0,0,0.0,35,61,5,17,-12,0,0,0,3.0,0:0,0,0,0,5522.0,2:58,1750000
8468482,Dany,Heatley,1981-01-21,LW,L,2014-15,6,0,0,0,0.0,-3,8,0.0,0,4365.0,12:7,0,0,0,0.0,5,3,1,0,1,0,0,0,342.0,0:57,0,0,0,0.0,0:0,1000000
8468483,Marian,Gaborik,1982-02-14,RW,L,2014-15,69,27,20,47,0.68,7,174,15.52,16,70028.0,16:54,1,0,1,100.0,39,6,18,43,-25,11,7,18,11390.0,2:45,0,0,0,189.0,0:2,4875000
8468486,Scott,Hartnell,1982-04-18,LW,L,2014-15,77,28,32,60,0.78,1,204,13.73,100,79912.0,17:17,7,7,14,50.0,160,38,36,40,-4,8,8,16,12298.0,2:39,0,0,0,246.0,0:3,4750000
8468493,Ron,Hainsey,1981-03-24,D,L,2014-15,81,2,8,10,0.12,-14,83,2.41,16,102530.0,21:5,1,0,1,100.0,110,120,22,48,-26,0,1,1,1308.0,0:16,0,0,0,9876.0,2:1,2833333
8468498,Brooks,Orpik,1980-09-26,D,L,2014-15,78,0,19,19,0.24,5,66,0.0,66,101989.0,21:47,0,0,0,0.0,306,192,11,37,-26,0,0,0,175.0,0:2,0,0,0,13049.0,2:47,5500000
8468501,Anton,Volchenkov,1982-02-25,D,L,2014-15,46,0,7,7,0.15,4,35,0.0,14,36372.0,13:10,0,0,0,0.0,93,48,3,13,-10,0,0,0,72.0,0:1,0,0,0,3032.0,1:5,4250000
8468504,Brad,Boyes,1982-04-17,RW,R,2014-15,78,14,24,38,0.49,11,151,9.27,20,73244.0,15:39,97,76,173,56.07,60,38,41,31,10,5,4,9,9463.0,2:1,0,0,0,253.0,0:3,2625000
8468505,Steve,Ott,1982-08-19,C,L,2014-15,78,3,9,12,0.15,-8,49,6.12,86,54448.0,11:38,160,124,284,56.34,184,14,21,8,13,0,0,0,894.0,0:11,0,0,0,6886.0,1:28,2600000
8468508,Justin,Williams,1981-10-04,RW,R,2014-15,81,18,23,41,0.51,8,174,10.34,29,76885.0,15:49,3,3,6,50.0,29,24,25,57,-32,4,9,13,7875.0,1:37,0,0,0,688.0,0:8,3825000
8468509,Niklas,Kronwall,1981-01-12,D,L,2014-15,80,9,35,44,0.55,-4,101,8.91,40,114423.0,23:50,1,0,1,100.0,91,106,11,52,-41,3,20,23,15444.0,3:13,0,0,0,13702.0,2:51,4750000
8468513,Nick,Schultz,1982-08-25,D,L,2014-15,80,2,13,15,0.19,2,69,2.9,47,91425.0,19:2,0,0,0,0.0,113,166,6,23,-17,0,1,1,970.0,0:12,0,0,0,12956.0,2:41,1250000
8468518,Tomas,Kopecky,1982-02-05,RW,L,2014-15,64,2,6,8,0.12,-19,106,1.89,28,49550.0,12:54,3,1,4,75.0,88,22,11,12,-1,0,0,0,464.0,0:7,0,0,0,8819.0,2:17,3000000
8468526,Jarret,Stoll,1982-06-24,C,R,2014-15,73,6,11,17,0.23,3,83,7.23,58,67845.0,15:29,592,569,1161,50.99,167,57,11,17,-6,3,1,4,4591.0,1:2,0,2,2,6585.0,1:30,3250000
8468535,Antoine,Vermette,1982-07-20,C,L,2014-15,82,13,25,38,0.46,-25,109,11.93,40,87782.0,17:50,872,705,1577,55.29,80,50,30,36,-6,6,8,14,11192.0,2:16,0,0,0,7105.0,1:26,3750000
8468542,Paul,Martin,1981-03-05,D,L,2014-15,74,3,17,20,0.27,17,61,4.92,20,101191.0,22:47,0,0,0,0.0,60,139,24,37,-13,0,1,1,7221.0,1:37,0,0,0,11505.0,2:35,5000000
8468575,Dominic,Moore,1980-08-03,C,L,2014-15,82,10,17,27,0.33,5,116,8.62,28,67944.0,13:48,585,489,1074,54.47,55,45,30,19,11,0,1,1,204.0,0:2,2,0,2,10417.0,2:7,1500000
8468598,Lubomir,Visnovsky,1976-08-11,D,L,2014-15,53,5,15,20,0.38,-3,85,5.88,8,62097.0,19:31,0,1,1,0.0,38,61,46,46,0,2,3,5,8481.0,2:40,0,0,0,167.0,0:3,4750000
8468611,Matt,Hendricks,1981-06-17,C,L,2014-15,71,8,8,16,0.23,-14,103,7.77,76,56028.0,13:9,98,100,198,49.49,220,72,31,15,16,0,1,1,1099.0,0:15,1,0,1,9265.0,2:10,1850000
8468635,Travis,Moen,1982-04-06,LW,L,2014-15,44,3,6,9,0.2,0,34,8.82,18,24768.0,9:22,0,4,4,0.0,62,24,7,7,0,0,0,0,8.0,0:0,0,0,0,1957.0,0:44,1850000
8468639,John-Michael,Liles,1980-11-25,D,L,2014-15,57,2,20,22,0.39,-9,90,2.22,14,65489.0,19:8,0,0,0,0.0,71,74,19,38,-19,0,7,7,6598.0,1:55,0,0,0,1199.0,0:21,3875000
8468674,Deryk,Engelland,1982-04-03,D,R,2014-15,76,2,9,11,0.14,-16,51,3.92,53,65591.0,14:23,0,0,0,0.0,132,141,20,38,-18,0,0,0,39.0,0:0,0,1,1,3971.0,0:52,2916667
8468700,Paul,Gaustad,1982-02-03,C,L,2014-15,73,4,10,14,0.19,7,54,7.41,60,54459.0,12:26,619,478,1097,56.43,143,58,19,10,9,0,0,0,395.0,0:5,0,0,0,9862.0,2:15,3250000
8469455,Jason,Spezza,1983-06-13,C,R,2014-15,82,17,45,62,0.76,-7,204,8.33,28,84735.0,17:13,682,580,1262,54.04,16,26,51,75,-24,4,22,26,17996.0,3:39,0,0,0,287.0,0:3,7000000
8469457,Stephen,Weiss,1983-04-03,C,L,2014-15,52,9,16,25,0.48,-2,52,17.31,16,35391.0,11:20,10,11,21,47.62,19,12,9,18,-9,3,6,9,6626.0,2:7,0,0,0,0.0,0:0,4900000
8469459,Mikko,Koivu,1983-03-12,C,L,2014-15,80,14,34,48,0.6,2,179,7.82,38,92498.0,19:16,989,802,1791,55.22,40,41,60,26,34,4,11,15,15671.0,3:15,0,0,0,6479.0,1:20,6750000
8469462,Tuomo,Ruutu,1983-02-16,LW,L,2014-15,77,7,6,13,0.17,-3,74,9.46,28,50196.0,10:51,4,5,9,44.44,174,23,15,22,-7,0,0,0,531.0,0:6,0,0,0,1257.0,0:16,4750000
8469465,Dan,Hamhuis,1982-12-13,D,L,2014-15,59,1,22,23,0.39,0,82,1.22,44,76221.0,21:31,0,0,0,0.0,82,71,18,47,-29,1,2,3,6221.0,1:45,0,0,0,7940.0,2:14,4500000
8469466,Ales,Hemsky,1983-08-13,RW,R,2014-15,76,11,21,32,0.42,-8,140,7.86,16,62201.0,13:38,0,0,0,0.0,22,35,30,37,-7,1,7,8,9004.0,1:58,0,0,0,33.0,0:0,4000000
8469469,R.J.,Umberger,1982-05-03,C,L,2014-15,67,9,6,15,0.22,-9,96,9.38,19,55551.0,13:49,9,13,22,40.91,114,40,9,11,-2,2,0,2,5303.0,1:19,0,0,0,3935.0,0:58,4600000
8469470,Carlo,Colaiacovo,1983-01-27,D,L,2014-15,33,2,6,8,0.24,0,42,4.76,10,32640.0,16:29,0,0,0,0.0,46,33,10,18,-8,0,2,2,1383.0,0:41,0,0,0,136.0,0:4,625000
8469473,Marcel,Goc,1983-08-24,C,L,2014-15,74,3,6,9,0.12,-3,77,3.9,8,51868.0,11:40,372,313,685,54.31,87,35,18,13,5,0,0,0,1252.0,0:16,0,1,1,10166.0,2:17,1200000
8469476,Tim,Gleason,1983-01-29,D,L,2014-15,72,1,8,9,0.12,-13,54,1.85,55,70555.0,16:19,0,0,0,0.0,167,108,11,22,-11,0,0,0,117.0,0:1,0,0,0,7584.0,1:45,4000000
8469485,Derek,Roy,1983-05-04,C,L,2014-15,72,12,20,32,0.44,-13,113,10.62,24,67702.0,15:40,407,502,909,44.77,32,43,42,34,8,4,3,7,7014.0,1:37,0,0,0,1411.0,0:19,1000000
8469490,Tim,Jackman,1981-11-14,RW,R,2014-15,55,5,2,7,0.13,-4,55,9.09,86,27656.0,8:22,10,4,14,71.43,110,19,6,6,0,0,0,0,156.0,0:2,0,0,0,89.0,0:1,637500
8469492,Fedor,Tyutin,1983-07-19,D,L,2014-15,67,3,12,15,0.22,8,56,5.36,40,80094.0,19:55,0,0,0,0.0,106,117,10,23,-13,0,1,1,1335.0,0:19,0,2,2,11474.0,2:51,4500000
8469500,Michael,Cammalleri,1982-06-08,LW,L,2014-15,68,27,15,42,0.62,2,156,17.31,28,74791.0,18:19,119,163,282,42.2,30,17,29,33,-4,9,2,11,8901.0,2:10,2,0,2,5444.0,1:20,5000000
8469501,Chris,Thorburn,1983-06-03,RW,R,2014-15,81,7,7,14,0.17,-5,67,10.45,76,39301.0,8:5,36,20,56,64.29,126,29,9,12,-3,0,0,0,510.0,0:6,0,0,0,105.0,0:1,1200000
8469506,Jason,Pominville,1982-11-30,RW,R,2014-15,82,18,36,54,0.66,9,252,7.14,8,89964.0,18:17,39,48,87,44.83,44,32,35,21,14,3,11,14,16495.0,3:21,0,0,0,119.0,0:1,5600000
8469508,Jay,McClement,1983-03-02,C,L,2014-15,82,7,14,21,0.26,-7,68,10.29,17,66803.0,13:34,549,441,990,55.45,79,53,42,14,28,0,0,0,867.0,0:10,0,0,0,10738.0,2:10,1000000
8469521,Tomas,Plekanec,1982-10-31,C,L,2014-15,82,26,34,60,0.73,8,248,10.48,46,94246.0,19:9,777,780,1557,49.9,47,55,30,42,-12,7,9,16,10774.0,2:11,3,1,4,9438.0,1:55,5000000
8469531,Jay,Harrison,1982-11-03,D,L,2014-15,55,3,6,9,0.16,-1,50,6.0,65,52577.0,15:55,0,0,0,0.0,76,74,16,32,-16,1,1,2,1800.0,0:32,0,0,0,5266.0,1:35,1500000
8469542,Stephane,Veilleux,1981-11-16,LW,L,2014-15,12,1,1,2,0.17,0,9,11.11,10,5540.0,7:41,0,1,1,0.0,9,8,2,0,2,0,0,0,1.0,0:0,0,0,0,927.0,1:17,587500
8469544,Patrick,Sharp,1981-12-27,LW,R,2014-15,68,16,27,43,0.63,-8,230,6.96,33,68588.0,16:48,53,55,108,49.07,74,15,38,25,13,8,6,14,11683.0,2:51,0,0,0,126.0,0:1,5900000
8469547,Jordin,Tootoo,1983-02-02,RW,R,2014-15,68,10,5,15,0.22,1,75,13.33,72,42667.0,10:27,1,0,1,100.0,127,8,17,29,-12,1,0,1,3412.0,0:50,0,0,0,77.0,0:1,550000
8469555,Christian,Ehrhoff,1982-07-06,D,L,2014-15,49,3,11,14,0.29,8,110,2.73,26,63971.0,21:45,0,0,0,0.0,73,49,12,21,-9,0,2,2,5958.0,2:1,0,0,0,5434.0,1:50,4000000
8469591,Cody,McCormick,1983-04-18,C,R,2014-15,33,1,3,4,0.12,-9,31,3.23,40,23193.0,11:42,147,147,294,50.0,77,29,3,10,-7,0,0,0,90.0,0:2,1,0,1,4383.0,2:12,1500000
8469598,Kevin,Bieksa,1981-06-16,D,R,2014-15,60,4,10,14,0.23,0,99,4.04,77,74999.0,20:49,0,0,0,0.0,109,93,19,64,-45,0,1,1,5138.0,1:25,0,1,1,6761.0,1:52,4600000
8469619,Dennis,Seidenberg,1981-07-18,D,L,2014-15,82,3,11,14,0.17,-1,103,2.91,34,108736.0,22:6,0,0,0,0.0,212,146,8,24,-16,0,0,0,1036.0,0:12,0,0,0,12594.0,2:33,4000000
8469622,Ryane,Clowe,1982-09-30,LW,L,2014-15,13,1,3,4,0.31,-1,15,6.67,4,12224.0,15:40,0,1,1,0.0,21,1,3,3,0,0,0,0,2147.0,2:45,0,0,0,19.0,0:1,4850000
8469623,Marek,Zidlicky,1977-02-03,D,R,2014-15,84,7,27,34,0.4,-9,130,5.38,56,105619.0,20:57,0,1,1,0.0,95,92,20,44,-24,6,14,20,13235.0,2:37,0,0,0,735.0,0:8,3000000
8469638,Jussi,Jokinen,1983-04-01,LW,L,2014-15,81,8,36,44,0.54,-2,134,5.97,34,81347.0,16:44,126,124,250,50.4,52,50,29,26,3,2,7,9,10820.0,2:13,0,0,0,8447.0,1:44,4000000
8469639,Brooks,Laich,1983-06-23,C,L,2014-15,66,7,13,20,0.3,-2,106,6.6,24,58304.0,14:43,87,111,198,43.94,107,53,25,25,0,0,1,1,1507.0,0:22,0,1,1,8635.0,2:10,4500000
8469664,David,Moss,1981-12-28,RW,R,2014-15,60,4,8,12,0.2,-18,96,4.17,24,46491.0,12:54,6,7,13,46.15,115,36,18,10,8,1,1,2,1415.0,0:23,0,1,1,4902.0,1:21,800000
8469665,Johnny,Oduya,1981-10-01,D,L,2014-15,76,2,8,10,0.13,5,76,2.63,26,92504.0,20:17,0,0,0,0.0,69,123,22,44,-22,0,0,0,417.0,0:5,0,0,0,8095.0,1:46,3375000
8469707,PA,Parenteau,1983-03-24,RW,R,2014-15,56,8,14,22,0.39,0,97,8.25,30,50360.0,14:59,10,16,26,38.46,32,19,18,13,5,3,1,4,7479.0,2:13,0,0,0,78.0,0:1,4000000
8469759,Vernon,Fiddler,1980-05-09,C,L,2014-15,80,13,16,29,0.36,-5,132,9.85,34,63007.0,13:7,569,528,1097,51.87,43,61,32,21,11,3,0,3,2372.0,0:29,1,1,2,10193.0,2:7,1250000
8469760,Zbynek,Michalek,1982-12-23,D,R,2014-15,68,4,8,12,0.18,-3,86,4.65,18,84704.0,20:45,0,0,0,0.0,85,160,16,26,-10,0,0,0,178.0,0:2,0,0,0,11722.0,2:52,4000000
8469770,Dennis,Wideman,1983-03-20,D,R,2014-15,80,15,41,56,0.7,6,173,8.67,34,118284.0,24:38,0,0,0,0.0,94,184,51,92,-41,6,15,21,14814.0,3:5,0,0,0,6582.0,1:22,5250000
8470018,Matt,Ellis,1981-08-31,LW,L,2014-15,39,1,1,2,0.05,-12,29,3.45,4,19478.0,8:19,100,105,205,48.78,10,16,12,2,10,0,0,0,59.0,0:1,0,0,0,2660.0,1:8,550000
8470039,Tomas,Fleischmann,1984-05-16,LW,L,2014-15,66,8,19,27,0.41,12,131,6.11,12,58223.0,14:42,4,10,14,28.57,64,15,30,15,15,0,1,1,4555.0,1:9,0,0,0,3222.0,0:48,4500000
8470041,Rick,Nash,1984-06-16,LW,L,2014-15,79,42,27,69,0.87,29,304,13.82,36,82727.0,17:27,2,2,4,50.0,45,33,74,42,32,6,6,12,12721.0,2:41,4,1,5,6369.0,1:20,7800000
8470047,Valtteri,Filppula,1984-03-20,C,L,2014-15,82,12,36,48,0.59,-14,91,13.19,24,93562.0,19:1,621,564,1185,52.41,25,29,50,27,23,2,15,17,16664.0,3:23,0,0,0,6024.0,1:13,5000000
8470054,Keith,Ballard,1982-11-26,D,L,2014-15,14,0,1,1,0.07,-3,5,0.0,26,10126.0,12:3,0,0,0,0.0,15,20,2,5,-3,0,0,0,31.0,0:2,0,0,0,610.0,0:43,1500000
8470063,Adam,Burish,1983-01-06,RW,R,2014-15,20,1,2,3,0.15,-6,22,4.55,33,13374.0,11:8,57,50,107,53.27,11,19,4,2,2,0,0,0,79.0,0:3,0,0,0,1806.0,1:30,1850000
8470065,Ryan,Craig,1982-01-06,C,L,2014-15,2,0,0,0,0.0,0,2,0.0,0,873.0,7:16,0,0,0,0.0,2,0,0,0,0,0,0,0,0.0,0:0,0,0,0,0.0,0:0,600000
8470104,Tom,Gilbert,1983-01-10,D,R,2014-15,72,4,8,12,0.17,10,70,5.71,30,83546.0,19:20,0,0,0,0.0,55,164,11,53,-42,0,0,0,3335.0,0:46,0,0,0,8325.0,1:55,2800000
8470105,Scottie,Upshall,1983-10-07,RW,L,2014-15,63,8,7,15,0.24,-8,93,8.6,28,47938.0,12:40,34,31,65,52.31,128,27,19,7,12,0,1,1,1737.0,0:27,0,0,0,4805.0,1:16,3500000
8470110,Trevor,Daley,1983-10-09,D,L,2014-15,68,16,22,38,0.56,-13,113,14.16,34,93331.0,22:52,0,0,0,0.0,29,123,29,32,-3,6,6,12,11211.0,2:44,2,0,2,11863.0,2:54,3300000
8470120,Alexander,Semin,1984-03-03,RW,R,2014-15,57,6,13,19,0.33,-10,93,6.45,32,54459.0,15:55,3,6,9,33.33,30,17,48,34,14,0,4,4,5151.0,1:30,0,0,0,44.0,0:0,7000000
8470121,Matt,Greene,1983-05-13,D,R,2014-15,82,3,6,9,0.11,1,69,4.35,54,77741.0,15:48,0,0,0,0.0,209,129,8,48,-40,0,0,0,345.0,0:4,0,0,0,9781.0,1:59,2500000
8470144,Frans,Nielsen,1984-04-24,C,L,2014-15,78,14,29,43,0.55,8,157,8.92,12,77593.0,16:34,506,544,1050,48.19,48,80,56,38,18,4,14,18,13358.0,2:51,1,2,3,8173.0,1:44,2750000
8470151,Jay,Bouwmeester,1983-09-27,D,L,2014-15,72,2,11,13,0.18,7,92,2.17,24,97913.0,22:39,0,0,0,0.0,42,99,14,18,-4,0,4,4,5362.0,1:14,0,0,0,12192.0,2:49,5400000
8470152,Joakim,Lindstrom,1983-12-05,C,L,2014-15,53,4,6,10,0.19,-15,61,6.56,12,34584.0,10:52,7,16,23,30.43,14,5,20,13,7,2,3,5,2771.0,0:52,0,0,0,33.0,0:0,700000
8470159,Boyd,Gordon,1983-10-19,C,R,2014-15,68,6,7,13,0.19,-5,65,9.23,17,54368.0,13:19,681,537,1218,55.91,31,80,21,19,2,1,0,1,2074.0,0:30,1,1,2,9812.0,2:24,3000000
8470162,Matt,Stajan,1983-12-19,C,L,2014-15,59,7,10,17,0.29,7,46,15.22,28,42472.0,11:59,303,299,602,50.33,72,21,33,30,3,0,0,0,299.0,0:5,0,1,1,4821.0,1:21,3125000
8470169,Gregory,Campbell,1983-12-17,C,L,2014-15,70,6,6,12,0.17,1,64,9.38,45,50967.0,12:8,339,293,632,53.64,119,41,13,12,1,0,0,0,317.0,0:4,1,0,1,6389.0,1:31,1600000
8470171,Max,Talbot,1984-02-11,C,L,2014-15,81,5,13,18,0.22,-1,97,5.15,29,66147.0,13:36,76,82,158,48.1,132,51,44,16,28,0,0,0,1285.0,0:15,0,0,0,9966.0,2:3,1800000
8470176,Sean,Bergenheim,1984-02-08,LW,L,2014-15,56,9,10,19,0.34,-2,108,8.33,40,44074.0,13:7,2,4,6,33.33,73,13,34,10,24,0,2,2,1395.0,0:24,0,0,0,386.0,0:6,2750000
8470180,Eric,Nystrom,1983-02-14,LW,L,2014-15,60,7,5,12,0.2,0,60,11.67,15,47501.0,13:11,4,8,12,33.33,104,29,9,11,-2,0,0,0,183.0,0:3,1,0,1,8184.0,2:16,2500000
8470187,Johnny,Boychuk,1984-01-19,D,R,2014-15,72,9,26,35,0.49,15,192,4.69,14,93660.0,21:40,2,0,2,100.0,171,149,24,48,-24,5,10,15,11523.0,2:40,0,1,1,8828.0,2:2,3366667
8470189,David,Van Der Gulik,1983-04-20,LW,L,2014-15,1,0,0,0,0.0,0,1,0.0,0,315.0,5:15,0,0,0,0.0,1,0,0,1,-1,0,0,0,7.0,0:7,0,0,0,0.0,0:0,550000
8470201,Jiri,Hudler,1984-01-04,RW,L,2014-15,78,31,45,76,0.97,17,158,19.62,14,84284.0,18:0,21,25,46,45.65,27,14,43,32,11,6,10,16,13945.0,2:58,0,0,0,193.0,0:2,4000000
8470207,Joffrey,Lupul,1983-09-23,LW,R,2014-15,55,10,11,21,0.38,-10,97,10.31,26,51118.0,15:29,4,2,6,66.67,78,20,36,22,14,2,1,3,7135.0,2:9,0,0,0,115.0,0:2,5250000
8470222,James,Wisniewski,1984-02-21,D,R,2014-15,69,8,26,34,0.49,-13,147,5.44,44,87728.0,21:11,0,0,0,0.0,115,81,12,33,-21,7,8,15,12619.0,3:2,0,0,0,7379.0,1:46,5500000
8470230,Daniel,Paille,1984-04-15,LW,L,2014-15,71,6,7,13,0.18,-9,66,9.09,12,49046.0,11:30,2,5,7,28.57,77,34,29,26,3,0,0,0,203.0,0:2,1,1,2,5761.0,1:21,1300000
8470257,Alexander,Steen,1984-03-01,LW,L,2014-15,74,24,40,64,0.86,8,223,10.76,33,88714.0,19:58,218,215,433,50.35,32,37,39,32,7,8,16,24,14647.0,3:17,0,0,0,7773.0,1:45,5800000
8470274,Chris,Higgins,1983-06-02,LW,L,2014-15,77,12,24,36,0.47,8,171,7.02,16,72955.0,15:47,3,6,9,33.33,73,34,28,19,9,3,2,5,7872.0,1:42,0,0,0,8068.0,1:44,2500000
8470281,Duncan,Keith,1983-07-16,D,L,2014-15,80,10,35,45,0.56,12,171,5.85,20,122700.0,25:33,0,0,0,0.0,16,113,43,63,-20,3,13,16,16075.0,3:20,0,1,1,11259.0,2:20,5538462
8470289,Jim,Slater,1982-12-09,C,L,2014-15,82,5,8,13,0.16,-4,51,9.8,58,45312.0,9:12,448,303,751,59.65,134,52,13,14,-1,0,0,0,383.0,0:4,0,1,1,11144.0,2:15,1600000
8470302,Patrick,Dwyer,1983-06-22,RW,R,2014-15,71,5,7,12,0.17,-12,77,6.49,10,54413.0,12:46,5,14,19,26.32,145,38,26,14,12,0,0,0,503.0,0:7,0,1,1,8733.0,2:3,900000
8470317,Nate,Guenin,1982-12-10,D,R,2014-15,76,2,13,15,0.2,-1,38,5.26,32,76814.0,16:50,0,0,0,0.0,94,162,19,28,-9,0,0,0,153.0,0:2,0,0,0,10230.0,2:14,800000
8470318,Jonathan,Ericsson,1984-03-02,D,L,2014-15,82,3,12,15,0.18,-5,82,3.66,70,96336.0,19:34,0,0,0,0.0,114,55,13,58,-45,0,0,0,845.0,0:10,0,1,1,13160.0,2:40,4250000
8470324,Josh,Gorges,1984-08-14,D,L,2014-15,46,0,6,6,0.13,-28,28,0.0,16,61723.0,22:21,0,0,0,0.0,75,148,7,20,-13,0,0,0,2684.0,0:58,0,1,1,8179.0,2:57,3900000
8470358,Alexandre,Burrows,1981-04-11,RW,L,2014-15,70,18,15,33,0.47,0,145,12.41,68,65005.0,15:28,6,8,14,42.86,73,33,33,24,9,4,4,8,8632.0,2:3,1,0,1,5105.0,1:12,4500000
8470378,Andre,Benoit,1984-01-06,D,L,2014-15,59,1,8,9,0.15,-19,45,2.22,20,64250.0,18:8,0,0,0,0.0,38,98,10,20,-10,0,1,1,4382.0,1:14,1,0,1,4478.0,1:15,800000
8470543,Chris,Kunitz,1979-09-26,LW,L,2014-15,74,17,23,40,0.54,2,170,10.0,56,79427.0,17:53,7,6,13,53.85,211,29,31,24,7,9,7,16,13722.0,3:5,1,0,1,630.0,0:8,3850000
8470595,Eric,Staal,1984-10-29,C,L,2014-15,77,23,31,54,0.7,-13,244,9.43,41,87078.0,18:50,343,326,669,51.27,65,27,38,47,-9,7,10,17,12046.0,2:36,0,0,0,474.0,0:6,8250000
8470598,Thomas,Vanek,1984-01-19,LW,R,2014-15,80,21,31,52,0.65,-6,171,12.28,37,77801.0,16:12,10,10,20,50.0,32,13,28,52,-24,5,12,17,14425.0,3:0,0,0,0,60.0,0:0,6500000
8470599,Milan,Michalek,1984-12-07,LW,L,2014-15,66,13,21,34,0.52,3,130,10.0,33,64828.0,16:22,11,12,23,47.83,64,40,23,12,11,5,5,10,7947.0,2:0,1,0,1,6798.0,1:43,4000000
8470600,Ryan,Suter,1985-01-21,D,L,2014-15,77,2,36,38,0.49,7,150,1.33,48,134255.0,29:3,0,0,0,0.0,69,127,33,46,-13,1,10,11,17651.0,3:49,0,1,1,9532.0,2:3,7538462
8470601,Braydon,Coburn,1985-02-27,D,L,2014-15,43,1,10,11,0.26,2,46,2.17,25,51444.0,19:56,0,0,0,0.0,62,66,10,22,-12,0,0,0,342.0,0:7,0,0,0,7395.0,2:51,4500000
8470602,Dion,Phaneuf,1985-04-10,D,L,2014-15,70,3,26,29,0.41,-11,138,2.17,108,99614.0,23:43,0,0,0,0.0,166,126,30,43,-13,2,13,15,14929.0,3:33,0,1,1,11651.0,2:46,7000000
8470604,Jeff,Carter,1985-01-01,C,R,2014-15,82,28,34,62,0.76,7,218,12.84,28,88416.0,17:58,627,566,1193,52.56,76,33,29,44,-15,10,5,15,13652.0,2:46,1,1,2,6923.0,1:24,5272727
8470606,Dustin,Brown,1984-11-04,RW,R,2014-15,82,11,16,27,0.33,-17,189,5.82,26,81263.0,16:31,15,20,35,42.86,242,24,29,46,-17,1,5,6,7440.0,1:30,0,0,0,6533.0,1:19,5875000
8470607,Brent,Seabrook,1985-04-20,D,R,2014-15,82,8,23,31,0.38,-3,181,4.42,27,109122.0,22:10,0,0,0,0.0,135,141,27,65,-38,4,11,15,12007.0,2:26,0,1,1,8948.0,1:49,5800000
8470609,Steve,Bernier,1985-03-31,RW,R,2014-15,67,16,16,32,0.48,2,107,14.95,28,52004.0,12:56,1,1,2,50.0,123,47,17,14,3,4,4,8,5333.0,1:19,0,0,0,16.0,0:0,600000
8470610,Zach,Parise,1984-07-28,LW,L,2014-15,74,33,29,62,0.84,21,259,12.74,41,85197.0,19:11,2,10,12,16.67,86,56,47,24,23,11,5,16,14639.0,3:17,0,0,0,1787.0,0:24,7538462
8470611,Eric,Fehr,1985-09-07,C,R,2014-15,75,19,14,33,0.44,8,142,13.38,20,66825.0,14:51,449,414,863,52.03,84,47,48,21,27,1,0,1,809.0,0:10,1,0,1,6256.0,1:23,1500000
8470612,Ryan,Getzlaf,1985-05-10,C,R,2014-15,77,25,45,70,0.91,15,191,13.09,62,92857.0,20:5,632,617,1249,50.6,100,95,55,71,-16,3,10,13,14042.0,3:2,0,2,2,7895.0,1:42,8250000
8470613,Brent,Burns,1985-03-09,D,R,2014-15,82,17,43,60,0.73,-9,245,6.94,65,117862.0,23:57,0,0,0,0.0,148,124,46,101,-55,7,17,24,16725.0,3:23,0,0,0,9517.0,1:56,5760000
8470614,Mark,Stuart,1984-04-27,D,L,2014-15,70,2,12,14,0.2,5,51,3.92,69,80702.0,19:12,0,1,1,0.0,166,142,13,48,-35,0,0,0,112.0,0:1,0,2,2,13752.0,3:16,2625000
8470616,Ryan,Kesler,1984-08-31,C,R,2014-15,81,20,27,47,0.58,-5,205,9.76,75,94830.0,19:30,937,727,1664,56.31,169,69,47,27,20,5,6,11,12361.0,2:32,1,2,3,10734.0,2:12,5000000
8470617,Mike,Richards,1985-02-11,C,L,2014-15,53,5,11,16,0.3,-10,63,7.94,39,42503.0,13:21,289,304,593,48.74,62,10,22,32,-10,1,2,3,3999.0,1:15,0,0,0,2340.0,0:44,5750000
8470619,Brian,Boyle,1984-12-18,C,L,2014-15,82,15,9,24,0.29,3,140,10.71,54,63926.0,12:59,460,445,905,50.83,136,68,33,14,19,0,0,0,1206.0,0:14,3,0,3,11836.0,2:24,2000000
8470621,Corey,Perry,1985-05-16,RW,R,2014-15,67,33,22,55,0.82,13,193,17.1,67,72765.0,18:6,3,9,12,25.0,64,27,25,46,-21,4,3,7,11183.0,2:46,0,0,0,1000.0,0:14,8625000
8470622,Patrick,Eaves,1984-05-01,RW,R,2014-15,47,14,13,27,0.57,12,91,15.38,8,38683.0,13:43,2,3,5,40.0,69,27,18,10,8,6,3,9,5347.0,1:53,0,0,0,738.0,0:15,650000
8470626,Loui,Eriksson,1985-07-17,LW,L,2014-15,81,22,25,47,0.58,1,169,13.02,14,89798.0,18:28,4,8,12,33.33,29,23,45,24,21,6,5,11,11696.0,2:24,0,1,1,7805.0,1:36,4250000
8470630,Kevin,Klein,1984-12-13,D,R,2014-15,65,9,17,26,0.4,24,76,11.84,25,72110.0,18:29,0,1,1,0.0,126,115,15,44,-29,0,0,0,387.0,0:5,0,0,0,7079.0,1:48,2900000
8470638,Patrice,Bergeron,1985-07-24,C,R,2014-15,81,23,32,55,0.68,2,234,9.83,44,88117.0,18:7,1175,776,1951,60.23,57,60,48,29,19,4,10,14,11387.0,2:20,1,1,2,8484.0,1:44,6875000
8470640,Matt,Carle,1984-09-25,D,L,2014-15,59,4,14,18,0.31,12,73,5.48,26,72527.0,20:29,0,0,0,0.0,26,104,13,41,-28,1,0,1,2434.0,0:41,0,0,0,7218.0,2:2,5500000
8470642,Shea,Weber,1985-08-14,D,R,2014-15,78,15,30,45,0.58,15,237,6.33,72,123408.0,26:22,0,0,0,0.0,166,147,23,53,-30,5,10,15,14436.0,3:5,1,0,1,11506.0,2:27,7857143
8470644,Colin,McDonald,1984-09-30,RW,R,2014-15,18,2,6,8,0.44,-3,29,6.9,0,11348.0,10:30,2,2,4,50.0,72,6,2,5,-3,0,0,0,139.0,0:7,0,0,0,11.0,0:0,637500
8470647,B.J.,Crombeen,1985-07-10,RW,R,2014-15,58,3,3,6,0.1,-6,43,6.98,79,28169.0,8:5,1,0,1,100.0,68,12,7,5,2,0,0,0,94.0,0:1,0,0,0,48.0,0:0,1150000
8470654,Maxim,Lapierre,1985-03-29,C,R,2014-15,80,2,9,11,0.14,-15,86,2.33,32,51407.0,10:42,305,277,582,52.41,153,36,11,8,3,0,0,0,222.0,0:2,0,0,0,9431.0,1:57,1100000
8470655,David,Backes,1984-05-01,RW,R,2014-15,80,26,32,58,0.72,7,183,14.21,104,89477.0,18:38,617,513,1130,54.6,227,87,38,29,9,10,6,16,11609.0,2:25,0,0,0,8716.0,1:48,4500000
8470662,Colin,Fraser,1985-01-28,C,L,2014-15,1,0,0,0,0.0,-1,1,0.0,0,282.0,4:42,0,0,0,0.0,1,1,0,0,0,0,0,0,0.0,0:0,0,0,0,0.0,0:0,650000
8470666,Daniel,Carcillo,1985-01-28,LW,L,2014-15,39,4,4,8,0.21,3,42,9.52,54,19163.0,8:11,0,1,1,0.0,36,7,6,5,1,0,0,0,97.0,0:2,0,0,0,0.0,0:0,550000
8470667,Clarke,MacArthur,1985-04-06,LW,L,2014-15,62,16,20,36,0.58,-6,140,11.43,36,63257.0,17:0,8,14,22,36.36,70,17,31,36,-5,6,4,10,11049.0,2:58,0,0,0,1277.0,0:20,3250000
8470699,Jan,Hejda,1978-06-18,D,L,2014-15,81,1,12,13,0.16,-12,84,1.19,42,100377.0,20:39,0,0,0,0.0,170,140,22,30,-8,0,0,0,461.0,0:5,0,1,1,10876.0,2:14,3250000
8470714,Corey,Potter,1984-01-05,D,R,2014-15,6,0,0,0,0.0,-1,2,0.0,0,3478.0,9:39,0,0,0,0.0,6,5,1,4,-3,0,0,0,42.0,0:7,0,0,0,113.0,0:18,700000
8470719,Alexandre,Bolduc,1985-06-26,C,L,2014-15,3,0,0,0,0.0,-1,3,0.0,2,1919.0,10:39,10,9,19,52.63,17,1,0,0,0,0,0,0,0.0,0:0,0,0,0,0.0,0:0,600000
8470724,Kyle,Quincey,1985-08-12,D,L,2014-15,73,3,15,18,0.25,10,90,3.33,77,85315.0,19:28,0,0,0,0.0,104,82,15,24,-9,0,0,0,878.0,0:12,0,1,1,9655.0,2:12,4250000
8470729,Tyson,Strachan,1984-10-30,D,R,2014-15,46,0,5,5,0.11,-30,38,0.0,44,52397.0,18:59,0,0,0,0.0,67,105,13,24,-11,0,0,0,326.0,0:7,0,1,1,5921.0,2:8,650000
8470740,Lee,Stempniak,1983-02-04,RW,R,2014-15,71,15,13,28,0.39,8,115,13.04,20,54192.0,12:43,12,20,32,37.5,78,23,17,29,-12,0,1,1,3981.0,0:56,0,0,0,1968.0,0:27,900000
8470750,John,Mitchell,1985-01-22,C,L,2014-15,68,11,15,26,0.38,-9,105,10.48,32,64695.0,15:51,374,361,735,50.88,143,56,38,18,20,3,1,4,4023.0,0:59,1,0,1,2381.0,0:35,1800000
8470755,Brad,Richardson,1985-02-04,C,L,2014-15,45,8,13,21,0.47,0,66,12.12,34,39073.0,14:28,276,302,578,47.75,58,20,12,6,6,0,1,1,369.0,0:8,1,0,1,5297.0,1:57,1150000
8470760,Marc,Methot,1985-06-21,D,L,2014-15,45,1,10,11,0.24,22,49,2.04,18,61201.0,22:40,0,1,1,0.0,94,70,12,24,-12,0,0,0,504.0,0:11,0,0,0,4776.0,1:46,3000000
8470775,Nate,Thompson,1984-10-05,C,L,2014-15,80,5,13,18,0.22,0,87,5.75,39,63956.0,13:19,557,499,1056,52.75,204,52,26,21,5,0,0,0,696.0,0:8,1,0,1,8706.0,1:48,1600000
8470778,Drew,Miller,1984-02-17,LW,L,2014-15,82,5,8,13,0.16,-3,98,5.1,25,66123.0,13:26,6,13,19,31.58,119,99,24,11,13,0,1,1,506.0,0:6,1,0,1,15432.0,3:8,1350000
8470794,Joe,Pavelski,1984-07-11,C,R,2014-15,82,37,33,70,0.85,12,261,14.18,29,99015.0,20:7,642,505,1147,55.97,97,86,57,64,-7,19,12,31,16110.0,3:16,0,0,0,7548.0,1:32,6000000
8470798,Dylan,Reese,1984-08-29,D,R,2014-15,1,0,0,0,0.0,-1,3,0.0,0,1198.0,19:58,0,0,0,0.0,2,2,2,1,1,0,0,0,0.0,0:0,0,0,0,69.0,1:9,550000
8470803,Kyle,Brodziak,1984-05-25,C,R,2014-15,73,9,11,20,0.27,-6,86,10.47,47,57134.0,13:2,338,349,687,49.2,56,63,28,10,18,0,0,0,208.0,0:2,1,0,1,10437.0,2:22,2833333
8470828,Toby,Enstrom,1984-11-05,D,L,2014-15,60,4,19,23,0.38,13,58,6.9,36,84850.0,23:34,0,0,0,0.0,27,93,12,37,-25,1,6,7,11041.0,3:4,0,0,0,6569.0,1:49,5750000
8470834,Dustin,Byfuglien,1985-03-27,D,R,2014-15,69,18,27,45,0.65,5,209,8.61,124,93928.0,22:41,0,3,3,0.0,203,59,47,56,-9,5,12,17,15921.0,3:50,0,1,1,4989.0,1:12,5200000
8470839,Shane,O'Brien,1983-08-09,D,L,2014-15,9,0,1,1,0.11,-4,4,0.0,5,7279.0,13:28,0,0,0,0.0,36,12,0,3,-3,0,0,0,59.0,0:6,0,0,0,338.0,0:37,2000000
8470852,Matt,Moulson,1983-11-01,LW,L,2014-15,77,13,28,41,0.53,-11,156,8.33,4,81718.0,17:41,13,9,22,59.09,34,49,26,21,5,3,8,11,12685.0,2:44,0,0,0,846.0,0:10,5000000
8470854,Tanner,Glass,1983-11-29,LW,L,2014-15,66,1,5,6,0.09,-12,53,1.89,98,40562.0,10:14,7,14,21,33.33,213,32,8,15,-7,0,0,0,105.0,0:1,0,0,0,4036.0,1:1,1450000
8470867,Troy,Bodie,1985-01-25,RW,R,2014-15,5,0,0,0,0.0,0,1,0.0,5,1385.0,4:37,0,0,0,0.0,4,0,0,0,0,0,0,0,0.0,0:0,0,0,0,0.0,0:0,600000
8470871,Chris,Porter,1984-05-29,LW,L,2014-15,24,1,1,2,0.08,-3,24,4.17,6,13758.0,9:33,4,5,9,44.44,63,1,1,1,0,0,0,0,94.0,0:3,0,0,0,229.0,0:9,675000
8470877,David,Jones,1984-08-10,RW,R,2014-15,67,14,16,30,0.45,-3,114,12.28,18,57644.0,14:20,15,16,31,48.39,125,45,24,26,-2,2,0,2,3847.0,0:57,0,0,0,67.0,0:1,4000000
8470886,Clayton,Stoner,1985-02-19,D,L,2014-15,69,1,7,8,0.12,-2,68,1.47,68,73040.0,17:38,0,0,0,0.0,128,84,10,40,-30,0,0,0,425.0,0:6,0,0,0,7555.0,1:49,3250000
8470920,David,Clarkson,1984-03-31,RW,R,2014-15,61,10,5,15,0.25,-12,95,10.53,106,50507.0,13:47,25,48,73,34.25,133,19,11,12,-1,1,0,1,7007.0,1:54,0,0,0,26.0,0:0,5250000
8470966,Mark,Giordano,1983-10-03,D,L,2014-15,61,11,37,48,0.79,13,157,7.01,37,92133.0,25:10,0,0,0,0.0,59,128,35,51,-16,2,12,14,11609.0,3:10,1,0,1,7806.0,2:7,4020000
8471185,Curtis,Glencross,1982-12-28,LW,L,2014-15,71,13,22,35,0.49,2,108,12.04,45,66661.0,15:38,8,10,18,44.44,124,50,34,52,-18,4,7,11,8161.0,1:54,0,0,0,572.0,0:8,2550000
8471214,Alex,Ovechkin,1985-09-17,LW,R,2014-15,81,53,28,81,1.0,10,395,13.42,58,98784.0,20:19,2,3,5,40.0,259,32,45,58,-13,25,9,34,18556.0,3:49,0,0,0,85.0,0:1,9538462
8471215,Evgeni,Malkin,1986-07-31,C,L,2014-15,69,28,42,70,1.01,-2,212,13.21,60,78554.0,18:58,322,433,755,42.65,24,18,45,53,-8,9,17,26,15077.0,3:38,0,0,0,375.0,0:5,9500000
8471217,Andrew,Ladd,1985-12-12,LW,L,2014-15,81,24,38,62,0.77,9,224,10.71,72,97552.0,20:4,7,13,20,35.0,212,38,26,50,-24,9,10,19,15583.0,3:12,0,1,1,8716.0,1:47,4400000
8471218,Blake,Wheeler,1986-08-31,RW,R,2014-15,79,26,35,61,0.77,26,244,10.66,73,93196.0,19:39,22,26,48,45.83,128,54,35,35,0,2,10,12,15425.0,3:15,4,1,5,8223.0,1:44,5600000
8471222,Ladislav,Smid,1986-02-01,D,L,2014-15,31,0,1,1,0.03,-12,21,0.0,13,25978.0,13:58,0,0,0,0.0,51,54,4,10,-6,0,0,0,26.0,0:0,0,0,0,2090.0,1:7,3500000
8471226,Drew,Stafford,1985-10-30,RW,R,2014-15,76,18,25,43,0.57,-12,147,12.24,47,75234.0,16:29,86,88,174,49.43,81,15,21,17,4,4,5,9,10734.0,2:21,0,1,1,1840.0,0:24,4000000
8471231,Kyle,Chipchura,1986-02-19,C,L,2014-15,70,4,10,14,0.2,-23,81,4.94,82,56279.0,13:23,473,443,916,51.64,130,29,41,22,19,1,0,1,627.0,0:8,0,0,0,4308.0,1:1,875000
8471232,Lauri,Korpikoski,1986-07-28,LW,L,2014-15,69,6,15,21,0.3,-27,82,7.32,12,63128.0,15:14,11,22,33,33.33,141,48,26,15,11,5,3,8,3920.0,0:56,0,1,1,6980.0,1:41,2500000
8471233,Travis,Zajac,1985-05-13,C,R,2014-15,74,11,14,25,0.34,-3,112,9.82,29,84652.0,19:3,641,559,1200,53.42,70,35,51,32,19,4,3,7,8823.0,1:59,2,0,2,8100.0,1:49,5750000
8471236,Andrej,Meszaros,1985-10-13,D,L,2014-15,60,7,7,14,0.23,-13,67,10.45,36,64476.0,17:54,0,0,0,0.0,67,94,8,18,-10,1,0,1,5501.0,1:31,0,0,0,3206.0,0:53,4125000
8471240,Jeff,Schultz,1986-02-25,D,L,2014-15,9,0,1,1,0.11,1,7,0.0,4,9043.0,16:44,0,0,0,0.0,10,9,0,5,-5,0,0,0,20.0,0:2,0,0,0,793.0,1:28,850000
8471241,Mark,Fistric,1986-06-01,D,L,2014-15,9,0,0,0,0.0,-3,1,0.0,4,7983.0,14:47,0,0,0,0.0,28,21,4,2,2,0,0,0,18.0,0:2,0,0,0,543.0,1:0,1266666
8471242,Mike,Green,1985-10-12,D,R,2014-15,72,10,35,45,0.62,15,159,6.29,34,82544.0,19:6,0,0,0,0.0,82,93,30,61,-31,1,16,17,11925.0,2:45,0,0,0,2391.0,0:33,6083333
8471245,Dave,Bolland,1986-06-05,C,R,2014-15,53,6,17,23,0.43,4,76,7.89,48,51998.0,16:21,414,517,931,44.47,88,21,26,10,16,0,5,5,4267.0,1:20,1,0,1,5662.0,1:46,5500000
8471254,Bryan,Bickell,1986-03-09,LW,L,2014-15,80,14,14,28,0.35,5,113,12.39,38,57961.0,12:4,0,2,2,0.0,205,13,26,20,6,1,2,3,3526.0,0:44,0,0,0,3.0,0:0,4000000
8471260,Blake,Comeau,1986-02-18,LW,R,2014-15,61,16,15,31,0.51,6,147,10.88,65,55940.0,15:17,7,2,9,77.78,188,11,16,19,-3,0,1,1,3475.0,0:56,0,0,0,1094.0,0:17,700000
8471262,Carl,Soderberg,1985-10-12,C,L,2014-15,82,13,31,44,0.54,10,163,7.98,26,82705.0,16:48,369,397,766,48.17,76,36,33,27,6,5,3,8,9866.0,2:0,0,0,0,208.0,0:2,1008333
8471266,David,Booth,1984-11-24,LW,L,2014-15,59,7,6,13,0.22,-8,107,6.54,25,42272.0,11:56,6,7,13,46.15,87,8,27,12,15,0,0,0,332.0,0:5,0,1,1,4671.0,1:19,4250000
8471269,Nicklas,Grossmann,1985-01-22,D,L,2014-15,68,5,9,14,0.21,8,43,11.63,32,72037.0,17:39,0,0,0,0.0,132,89,10,23,-13,0,0,0,121.0,0:1,0,0,0,8790.0,2:9,3500000
8471273,Brandon,Dubinsky,1986-04-29,C,L,2014-15,47,13,23,36,0.77,11,100,13.0,43,50933.0,18:3,436,423,859,50.76,152,11,19,19,0,0,7,7,5606.0,1:59,1,0,1,6793.0,2:24,4200000
8471274,Alex,Goligoski,1985-07-30,D,L,2014-15,81,4,32,36,0.44,0,122,3.28,24,115723.0,23:48,0,0,0,0.0,100,157,30,83,-53,0,8,8,10167.0,2:5,0,2,2,14321.0,2:56,4600000
8471276,David,Krejci,1986-04-28,C,R,2014-15,47,7,24,31,0.66,7,70,10.0,22,51231.0,18:10,316,278,594,53.2,35,29,20,21,-1,1,7,8,6245.0,2:12,1,0,1,1638.0,0:34,5250000
8471283,Brandon,Prust,1984-03-16,LW,L,2014-15,82,4,14,18,0.22,6,78,5.13,134,63794.0,12:57,16,15,31,51.61,122,34,15,27,-12,0,0,0,664.0,0:8,0,1,1,8643.0,1:45,2500000
8471284,Andrej,Sekera,1986-06-08,D,L,2014-15,73,3,20,23,0.32,-3,100,3.0,14,96307.0,21:59,0,0,0,0.0,59,118,43,56,-13,1,5,6,8090.0,1:50,0,1,1,7495.0,1:42,2750000
8471296,Alexei,Emelin,1986-04-25,D,L,2014-15,68,3,11,14,0.21,5,43,6.98,59,80854.0,19:49,0,0,0,0.0,204,116,16,56,-40,0,0,0,345.0,0:5,0,0,0,9569.0,2:20,4100000
8471299,Peter,Regin,1986-04-16,C,L,2014-15,4,0,1,1,0.25,1,3,0.0,0,2000.0,8:20,1,1,2,50.0,3,0,3,0,3,0,0,0,61.0,0:15,0,0,0,0.0,0:0,650000
8471303,Alexander,Edler,1986-04-21,D,L,2014-15,74,8,23,31,0.42,13,175,4.57,54,106467.0,23:58,0,1,1,0.0,94,126,24,72,-48,5,9,14,13004.0,2:55,0,0,0,11536.0,2:35,5000000
8471309,Johan,Franzen,1979-12-23,RW,L,2014-15,33,7,15,22,0.67,-12,74,9.46,30,31801.0,16:3,5,10,15,33.33,45,13,4,17,-13,4,7,11,6382.0,3:13,0,0,0,63.0,0:1,3954545
8471311,Tyler,Kennedy,1986-07-15,C,R,2014-15,38,6,8,14,0.37,-2,79,7.59,10,25458.0,11:9,13,15,28,46.43,49,8,20,6,14,0,0,0,325.0,0:8,0,0,0,70.0,0:1,2350000
8471338,Torrey,Mitchell,1985-01-30,C,R,2014-15,65,6,8,14,0.22,-8,55,10.91,34,55373.0,14:11,399,415,814,49.02,58,61,25,23,2,0,0,0,442.0,0:6,0,0,0,7728.0,1:58,1900000
8471339,Ryan,Callahan,1985-03-21,RW,R,2014-15,77,24,30,54,0.7,9,191,12.57,41,81937.0,17:44,15,16,31,48.39,184,46,43,25,18,10,6,16,14078.0,3:2,0,0,0,827.0,0:10,5800000
8471346,Kris,Versteeg,1986-05-13,RW,R,2014-15,61,14,20,34,0.56,11,134,10.45,35,58009.0,15:50,15,33,48,31.25,31,22,31,24,7,2,3,5,6535.0,1:47,0,0,0,391.0,0:6,4400000
8471348,Nikita,Nikitin,1986-06-16,D,L,2014-15,42,4,6,10,0.24,-12,80,5.0,12,49490.0,19:38,0,0,0,0.0,21,49,17,35,-18,2,1,3,4359.0,1:43,0,0,0,4399.0,1:44,4500000
8471362,Mikhail,Grabovski,1984-01-31,C,L,2014-15,51,9,10,19,0.37,3,81,11.11,8,43678.0,14:16,38,45,83,45.78,11,19,26,31,-5,0,1,1,4316.0,1:24,0,0,0,27.0,0:0,5500000
8471371,Mike,Brown,1985-06-24,RW,R,2014-15,12,0,0,0,0.0,0,11,0.0,22,5907.0,8:12,4,3,7,57.14,42,7,1,0,1,0,0,0,6.0,0:0,0,0,0,0.0,0:0,1200000
8471385,Adam,Pardy,1984-03-29,D,L,2014-15,55,0,9,9,0.16,9,29,0.0,40,49562.0,15:1,0,0,0,0.0,74,59,10,35,-25,0,0,0,295.0,0:5,0,1,1,7993.0,2:25,700000
8471388,Patrick,Kaleta,1986-06-08,RW,R,2014-15,42,0,3,3,0.07,-11,25,0.0,36,22346.0,8:52,3,5,8,37.5,88,25,8,3,5,0,0,0,90.0,0:2,0,1,1,2997.0,1:11,1250000
8471390,Mike,Santorelli,1985-12-14,C,R,2014-15,79,12,21,33,0.42,0,145,8.28,14,68198.0,14:23,86,100,186,46.24,55,34,44,25,19,0,2,2,1755.0,0:22,1,1,2,2644.0,0:33,1500000
8471392,Roman,Polak,1986-04-28,D,R,2014-15,56,5,4,9,0.16,-22,61,8.2,48,70857.0,21:5,1,0,1,100.0,225,128,23,28,-5,0,0,0,285.0,0:5,0,0,0,10468.0,3:6,2750000
8471426,Troy,Brouwer,1985-08-17,RW,R,2014-15,82,21,22,43,0.52,11,145,14.48,53,86214.0,17:31,251,190,441,56.92,206,39,44,41,3,8,6,14,14642.0,2:58,2,0,2,10342.0,2:6,3666667
8471436,Matt,Hunwick,1985-05-21,D,L,2014-15,55,2,9,11,0.2,17,72,2.78,16,52192.0,15:48,0,0,0,0.0,55,43,15,27,-12,0,2,2,1854.0,0:33,0,0,0,892.0,0:16,600000
8471474,Travis,Morin,1984-01-09,C,L,2014-15,6,0,0,0,0.0,1,10,0.0,0,4355.0,12:5,28,32,60,46.67,3,0,2,1,1,0,0,0,474.0,1:19,0,0,0,0.0,0:0,550000
8471476,Daniel,Winnik,1985-03-06,LW,L,2014-15,79,9,25,34,0.43,23,97,9.28,27,78882.0,16:38,107,121,228,46.93,124,69,44,25,19,0,0,0,284.0,0:3,0,1,1,15521.0,3:16,1300000
8471482,Grant,Clitsome,1985-04-14,D,L,2014-15,24,0,4,4,0.17,4,22,0.0,8,23565.0,16:21,0,0,0,0.0,46,20,5,23,-18,0,0,0,759.0,0:31,0,0,0,1688.0,1:10,2066667
8471490,Adam,Cracknell,1985-07-15,RW,R,2014-15,17,0,1,1,0.06,-8,17,0.0,2,10146.0,9:56,20,38,58,34.48,43,6,5,3,2,0,0,0,78.0,0:4,0,0,0,570.0,0:33,600000
8471498,Jannik,Hansen,1986-03-15,RW,R,2014-15,81,16,17,33,0.41,-6,145,11.03,27,67905.0,13:58,1,5,6,16.67,80,30,42,15,27,0,0,0,2177.0,0:26,1,2,3,6387.0,1:18,2500000
8471504,Rene,Bourque,1981-12-10,RW,L,2014-15,51,6,8,14,0.27,-15,85,7.06,22,38661.0,12:38,4,6,10,40.0,71,11,6,13,-7,2,1,3,2783.0,0:54,0,0,0,161.0,0:3,3333333
8471636,Tim,Sestito,1984-08-28,LW,L,2014-15,15,0,2,2,0.13,-1,10,0.0,33,8899.0,9:53,48,58,106,45.28,22,3,3,2,1,0,0,0,5.0,0:0,0,0,0,1727.0,1:55,562500
8471657,Cody,McLeod,1984-06-26,LW,L,2014-15,82,7,5,12,0.15,-2,94,7.45,191,55024.0,11:11,1,8,9,11.11,268,43,11,6,5,0,0,0,2178.0,0:26,1,0,1,6642.0,1:21,1150000
8471664,Mason,Raymond,1985-09-17,LW,L,2014-15,57,12,11,23,0.4,-8,123,9.76,8,50663.0,14:48,0,3,3,0.0,7,13,24,28,-4,0,1,1,7031.0,2:3,0,0,0,367.0,0:6,3150000
8471669,Paul,Stastny,1985-12-27,C,L,2014-15,74,16,30,46,0.62,5,143,11.19,40,78266.0,17:37,671,487,1158,57.94,22,30,28,9,19,7,8,15,10477.0,2:21,0,0,0,4071.0,0:55,7000000
8471675,Sidney,Crosby,1987-08-07,C,L,2014-15,77,28,56,84,1.09,5,237,11.81,47,92265.0,19:58,797,800,1597,49.91,66,29,37,53,-16,10,21,31,16684.0,3:36,0,0,0,1695.0,0:22,8700000
8471676,Bobby,Ryan,1987-03-17,RW,R,2014-15,78,18,36,54,0.69,5,221,8.14,24,81772.0,17:28,4,7,11,36.36,110,33,59,41,18,4,10,14,14521.0,3:6,0,0,0,742.0,0:9,5100000
8471677,Jack,Johnson,1987-01-13,D,L,2014-15,79,8,32,40,0.51,-13,141,5.67,44,114546.0,24:9,0,0,0,0.0,157,131,18,30,-12,3,18,21,12845.0,2:42,0,0,0,14898.0,3:8,4357143
8471678,Benoit,Pouliot,1986-09-29,LW,L,2014-15,58,19,15,34,0.59,-1,105,18.1,28,57845.0,16:37,13,21,34,38.24,71,31,40,36,4,4,3,7,7097.0,2:2,1,0,1,3979.0,1:8,4000000
8471681,Jack,Skille,1987-05-19,RW,R,2014-15,45,6,2,8,0.18,-18,95,6.32,16,33813.0,12:31,3,5,8,37.5,96,15,17,2,15,0,0,0,300.0,0:6,0,0,0,194.0,0:4,750000
8471682,Devin,Setoguchi,1987-01-01,RW,R,2014-15,12,0,0,0,0.0,-7,12,0.0,4,8747.0,12:8,1,1,2,50.0,12,5,0,1,-1,0,0,0,995.0,1:22,0,0,0,50.0,0:4,750000
8471685,Anze,Kopitar,1987-08-24,C,L,2014-15,79,16,48,64,0.81,-2,134,11.94,10,91909.0,19:23,752,678,1430,52.59,105,46,29,48,-19,6,18,24,13463.0,2:50,0,0,0,7962.0,1:40,6800000
8471686,Marc,Staal,1987-01-13,D,L,2014-15,80,5,15,20,0.25,18,97,5.15,42,101459.0,21:8,1,1,2,50.0,99,123,43,43,0,0,0,0,571.0,0:7,0,2,2,10561.0,2:12,3975000
8471691,Martin,Hanzal,1987-02-20,C,L,2014-15,37,8,16,24,0.65,-1,85,9.41,31,39374.0,17:44,346,266,612,56.54,105,18,17,12,5,1,3,4,4655.0,2:5,0,1,1,2956.0,1:19,3100000
8471693,Jakub,Kindl,1987-02-10,D,L,2014-15,35,5,8,13,0.37,2,54,9.26,22,33413.0,15:54,0,0,0,0.0,31,25,2,22,-20,2,5,7,3980.0,1:53,0,0,0,139.0,0:3,2400000
8471698,T.J.,Oshie,1986-12-23,RW,R,2014-15,72,19,36,55,0.76,17,162,11.73,51,81362.0,18:50,3,10,13,23.08,99,39,48,31,17,3,10,13,10193.0,2:21,0,0,0,5717.0,1:19,4175000
8471699,Andrew,Cogliano,1987-06-14,LW,L,2014-15,82,15,14,29,0.35,5,134,11.19,14,71837.0,14:36,16,33,49,32.65,139,30,30,33,-3,0,0,0,447.0,0:5,3,0,3,8201.0,1:40,3000000
8471702,Matt,Niskanen,1986-12-06,D,R,2014-15,82,4,27,31,0.38,7,117,3.42,47,109981.0,22:21,0,0,0,0.0,143,106,34,76,-42,2,8,10,5237.0,1:3,0,1,1,11257.0,2:17,5750000
8471703,Steve,Downie,1987-04-03,RW,R,2014-15,72,14,14,28,0.39,2,104,13.46,238,53714.0,12:26,4,4,8,50.0,108,34,16,24,-8,3,2,5,6133.0,1:25,0,0,0,163.0,0:2,1000000
8471707,James,Neal,1987-09-03,LW,L,2014-15,67,23,14,37,0.55,12,221,10.41,57,72712.0,18:5,7,10,17,41.18,71,30,37,31,6,3,1,4,11609.0,2:53,0,0,0,57.0,0:0,5000000
8471709,Marc-Edouard,Vlasic,1987-03-30,D,L,2014-15,70,9,14,23,0.33,12,98,9.18,23,92869.0,22:6,0,0,0,0.0,51,112,11,31,-20,0,3,3,5902.0,1:24,0,0,0,10058.0,2:23,4250000
8471710,Taylor,Chorney,1987-04-27,D,L,2014-15,7,0,0,0,0.0,-1,4,0.0,0,5112.0,12:10,0,0,0,0.0,5,3,0,4,-4,0,0,0,355.0,0:50,0,0,0,0.0,0:0,550000
8471716,Justin,Abdelkader,1987-02-25,LW,L,2014-15,71,23,21,44,0.62,3,154,14.94,72,76296.0,17:54,7,8,15,46.67,153,28,16,29,-13,8,6,14,11969.0,2:48,0,0,0,3964.0,0:55,1800000
8471717,Adam,McQuaid,1986-10-12,D,R,2014-15,63,1,6,7,0.11,-2,60,1.67,85,69688.0,18:26,0,1,1,0.0,141,91,7,22,-15,0,0,0,271.0,0:4,0,0,0,7196.0,1:54,1566667
8471718,Marc-Andre,Cliche,1987-03-23,C,R,2014-15,74,2,5,7,0.09,-2,68,2.94,17,47091.0,10:36,377,358,735,51.29,27,28,31,16,15,0,0,0,174.0,0:2,0,0,0,9202.0,2:4,700000
8471724,Kris,Letang,1987-04-24,D,R,2014-15,69,11,43,54,0.78,12,197,5.58,79,105525.0,25:29,0,1,1,0.0,131,117,39,60,-21,2,22,24,15730.0,3:47,1,0,1,11522.0,2:46,7250000
8471729,Kris,Russell,1987-05-02,D,L,2014-15,79,4,30,34,0.43,18,111,3.6,17,113519.0,23:56,0,0,0,0.0,61,283,51,66,-15,1,13,14,11461.0,2:25,0,0,0,6238.0,1:18,2600000
8471735,Keith,Yandle,1986-09-09,D,L,2014-15,84,6,46,52,0.62,-26,232,2.59,40,115482.0,22:54,0,0,0,0.0,53,101,35,81,-46,2,27,29,20898.0,4:8,0,0,0,662.0,0:7,5250000
8471742,Cody,Franson,1987-08-08,D,R,2014-15,78,7,29,36,0.46,-7,127,5.51,28,91860.0,19:37,0,0,0,0.0,177,132,46,69,-23,5,12,17,11823.0,2:31,0,0,0,7562.0,1:36,3300000
8471748,Mark,Fraser,1986-09-29,D,L,2014-15,34,0,4,4,0.12,2,19,0.0,55,33201.0,16:16,0,0,0,0.0,85,49,1,13,-12,0,0,0,20.0,0:0,0,1,1,3724.0,1:49,550000
8471761,Chris,Butler,1986-10-27,D,L,2014-15,33,3,6,9,0.27,8,54,5.56,23,34038.0,17:11,0,0,0,0.0,31,38,5,9,-4,0,0,0,721.0,0:21,1,0,1,767.0,0:23,650000
8471762,Chris,VandeVelde,1987-03-15,C,L,2014-15,72,9,6,15,0.21,-6,70,12.86,28,50672.0,11:43,21,35,56,37.5,121,46,13,5,8,0,0,0,414.0,0:5,0,0,0,7311.0,1:41,575000
8471766,Jared,Boll,1986-05-13,RW,R,2014-15,72,1,4,5,0.07,-13,28,3.57,109,31427.0,7:16,0,2,2,0.0,131,17,5,7,-2,0,0,0,43.0,0:0,0,0,0,0.0,0:0,1700000
8471769,Niklas,Hjalmarsson,1987-06-06,D,L,2014-15,82,3,16,19,0.23,25,97,3.09,44,107675.0,21:53,0,0,0,0.0,39,127,41,70,-29,0,0,0,700.0,0:8,0,0,0,11914.0,2:25,4100000
8471794,Darren,Helm,1987-01-21,LW,L,2014-15,75,15,18,33,0.44,7,160,9.38,12,71251.0,15:50,223,198,421,52.97,132,25,33,22,11,3,4,7,6587.0,1:27,2,0,2,6907.0,1:32,2125000
8471804,Nathan,Gerbe,1987-07-24,C,L,2014-15,78,10,18,28,0.36,-14,235,4.26,34,76958.0,16:26,9,6,15,60.0,73,23,51,38,13,2,6,8,7121.0,1:31,0,0,0,4937.0,1:3,1750000
8471816,Mark,Fayne,1987-05-15,D,R,2014-15,74,2,6,8,0.11,-21,78,2.56,14,79639.0,17:56,0,0,0,0.0,81,125,21,49,-28,0,0,0,905.0,0:12,0,2,2,11084.0,2:29,3625000
8471817,Ryan,Reaves,1987-01-20,RW,R,2014-15,81,6,6,12,0.15,-3,55,10.91,116,41404.0,8:31,0,0,0,0.0,276,14,14,6,8,0,0,0,187.0,0:2,0,0,0,22.0,0:0,1125000
8471840,Brett,Sutter,1987-06-02,LW,L,2014-15,6,0,3,3,0.5,1,6,0.0,4,3351.0,9:18,0,0,0,0.0,16,1,0,0,0,0,0,0,26.0,0:4,0,0,0,267.0,0:44,600000
8471856,Joe,Vitale,1985-08-20,C,R,2014-15,70,3,6,9,0.13,-11,55,5.45,36,47163.0,11:13,354,379,733,48.29,104,65,30,11,19,0,0,0,108.0,0:1,0,0,0,9104.0,2:10,1116667
8471862,Colin,Greening,1986-03-09,C,L,2014-15,26,1,0,1,0.04,-5,39,2.56,29,15322.0,9:49,6,3,9,66.67,85,14,8,6,2,0,0,0,89.0,0:3,0,0,0,0.0,0:0,2650000
8471873,Anton,Stralman,1986-08-01,D,R,2014-15,82,9,30,39,0.48,22,138,6.52,26,107975.0,21:56,0,0,0,0.0,104,77,23,40,-17,2,12,14,12199.0,2:28,0,0,0,12705.0,2:34,4500000
8471879,Kyle,Cumiskey,1986-12-02,D,L,2014-15,7,0,0,0,0.0,-1,5,0.0,0,5584.0,13:17,0,0,0,0.0,3,11,1,2,-1,0,0,0,103.0,0:14,0,0,0,271.0,0:38,600000
8471887,Patric,Hornqvist,1987-01-01,RW,R,2014-15,64,25,26,51,0.8,12,220,11.36,38,67791.0,17:39,2,5,7,28.57,87,33,31,9,22,6,9,15,12724.0,3:18,0,0,0,222.0,0:3,4250000
8471956,Andrew,Desjardins,1986-07-27,LW,L,2014-15,69,5,5,10,0.14,-1,59,8.47,57,44460.0,10:44,158,154,312,50.64,128,35,14,18,-4,0,0,0,231.0,0:3,0,0,0,4568.0,1:6,750000
8471958,Dan,Girardi,1984-04-29,D,R,2014-15,82,4,16,20,0.24,12,111,3.6,22,111645.0,22:41,0,0,0,0.0,224,184,33,60,-27,1,2,3,7269.0,1:28,0,1,1,13694.0,2:47,5500000
8471976,David,Desharnais,1986-09-14,C,L,2014-15,82,14,34,48,0.59,22,90,15.56,24,84865.0,17:14,629,560,1189,52.9,43,49,27,20,7,2,9,11,11734.0,2:23,0,0,0,144.0,0:1,3500000
8472368,Chris,Conner,1983-12-23,RW,L,2014-15,2,0,0,0,0.0,1,3,0.0,4,1058.0,8:49,0,0,0,0.0,0,0,1,0,1,0,0,0,0.0,0:0,0,0,0,0.0,0:0,550000
8472382,Andy,Greene,1982-10-30,D,L,2014-15,82,3,19,22,0.27,1,83,3.61,20,115837.0,23:32,0,0,0,0.0,82,172,21,39,-18,0,1,1,2542.0,0:31,0,1,1,19591.0,3:58,3000000
8472394,Peter,Harrold,1983-06-08,D,R,2014-15,43,3,2,5,0.12,-10,31,9.68,4,39328.0,15:14,0,0,0,0.0,40,39,6,12,-6,0,0,0,745.0,0:17,0,0,0,4061.0,1:34,800000
8472410,Stephen,Gionta,1983-10-09,RW,R,2014-15,61,5,8,13,0.21,4,84,5.95,12,48257.0,13:11,159,235,394,40.36,92,41,19,11,8,0,0,0,332.0,0:5,0,2,2,8087.0,2:12,850000
8472424,Ryan,Hamilton,1985-04-15,LW,L,2014-15,16,1,1,2,0.12,-8,12,8.33,6,12681.0,13:12,1,3,4,25.0,27,13,2,3,-1,1,0,1,1013.0,1:3,0,0,0,180.0,0:11,600000
8473412,Bryan,Little,1987-11-12,C,R,2014-15,70,24,28,52,0.74,8,148,16.22,24,83662.0,19:55,762,789,1551,49.13,56,32,25,22,3,9,9,18,13458.0,3:12,1,0,1,8556.0,2:2,4700000
8473415,Alex,Biega,1988-04-04,D,R,2014-15,7,1,0,1,0.14,-2,7,14.29,0,6634.0,15:47,0,0,0,0.0,34,8,1,3,-2,0,0,0,80.0,0:11,0,0,0,118.0,0:16,600000
8473419,Brad,Marchand,1988-05-11,LW,L,2014-15,77,24,18,42,0.55,5,180,13.33,95,78080.0,16:54,13,20,33,39.39,72,28,52,45,7,2,0,2,4560.0,0:59,2,1,3,6408.0,1:23,4500000
8473422,Nick,Foligno,1987-10-31,LW,L,2014-15,79,31,42,73,0.92,16,182,17.03,50,89253.0,18:49,125,138,263,47.53,193,52,51,23,28,11,15,26,11989.0,2:31,0,0,0,6367.0,1:20,3083333
8473426,Mike,Weber,1987-12-16,D,L,2014-15,64,1,6,7,0.11,-22,41,2.44,68,71970.0,18:44,0,0,0,0.0,172,168,10,40,-30,0,0,0,298.0,0:4,0,1,1,9204.0,2:23,1666667
8473432,Derek,Dorsett,1986-12-20,RW,R,2014-15,79,7,18,25,0.32,4,89,7.87,175,57095.0,12:2,7,9,16,43.75,166,37,18,12,6,0,0,0,1743.0,0:22,2,0,2,2283.0,0:28,1633333
8473446,Erik,Johnson,1988-03-21,D,R,2014-15,47,12,11,23,0.49,2,115,10.43,33,68863.0,24:25,0,0,0,0.0,93,107,26,38,-12,3,3,6,7447.0,2:38,0,1,1,7021.0,2:29,3750000
8473449,Kyle,Okposo,1988-04-16,RW,R,2014-15,60,18,33,51,0.85,-8,195,9.23,12,70396.0,19:33,80,81,161,49.69,53,23,30,45,-15,6,12,18,13570.0,3:46,0,0,0,109.0,0:1,2800000
8473453,Trevor,Lewis,1987-01-08,C,R,2014-15,73,9,16,25,0.34,8,143,6.29,14,61788.0,14:6,76,101,177,42.94,192,19,16,7,9,0,0,0,1284.0,0:17,1,0,1,6244.0,1:25,1525000
8473463,Leo,Komarov,1987-01-23,C,L,2014-15,62,8,18,26,0.42,0,84,9.52,18,54683.0,14:41,95,97,192,49.48,250,25,51,18,33,0,1,1,485.0,0:7,1,2,3,9554.0,2:34,2950000
8473465,Jamie,McGinn,1988-08-05,LW,L,2014-15,19,4,2,6,0.32,-9,36,11.11,6,16838.0,14:46,1,0,1,100.0,29,7,9,7,2,1,0,1,2302.0,2:1,0,0,0,137.0,0:7,2950000
8473466,Ryan,White,1988-03-17,C,R,2014-15,34,6,6,12,0.35,4,45,13.33,30,23915.0,11:43,65,58,123,52.85,108,14,8,8,0,0,0,0,1319.0,0:38,0,1,1,735.0,0:21,575000
8473468,Eric,Gryba,1988-04-14,D,R,2014-15,75,0,12,12,0.16,11,64,0.0,97,70432.0,15:39,0,0,0,0.0,171,58,12,40,-28,0,0,0,144.0,0:1,0,0,0,11223.0,2:29,1250000
8473473,Milan,Lucic,1988-06-07,LW,L,2014-15,81,18,26,44,0.54,13,141,12.77,81,79498.0,16:21,34,42,76,44.74,259,23,31,46,-15,2,6,8,8881.0,1:49,0,0,0,251.0,0:3,6000000
8473482,Jiri,Tlusty,1988-03-16,LW,L,2014-15,72,14,17,31,0.43,-18,123,11.38,20,69210.0,16:1,5,10,15,33.33,80,37,30,21,9,6,4,10,8204.0,1:53,0,0,0,2719.0,0:37,2950000
8473485,Chris,Stewart,1987-10-30,RW,R,2014-15,81,14,22,36,0.44,-26,155,9.03,88,77182.0,15:52,10,31,41,24.39,110,16,21,33,-12,5,5,10,9479.0,1:57,0,0,0,35.0,0:0,4150000
8473492,Matt,Beleskey,1988-06-07,LW,L,2014-15,65,22,10,32,0.49,13,145,15.17,39,56462.0,14:28,8,11,19,42.11,159,25,9,32,-23,4,0,4,6000.0,1:32,0,0,0,1033.0,0:15,1350000
8473504,Cal,Clutterbuck,1987-11-18,RW,R,2014-15,76,7,9,16,0.21,1,124,5.65,60,58040.0,12:43,6,3,9,66.67,343,31,25,24,1,0,1,1,654.0,0:8,2,1,3,6601.0,1:26,2750000
8473507,Jeff,Petry,1987-12-09,D,R,2014-15,78,7,15,22,0.28,-28,126,5.56,42,99454.0,21:15,0,0,0,0.0,145,109,43,83,-40,1,3,4,6020.0,1:17,0,1,1,7998.0,1:42,3075000
8473512,Claude,Giroux,1988-01-12,C,R,2014-15,81,25,48,73,0.9,-3,279,8.96,36,99946.0,20:33,1063,815,1878,56.6,110,28,40,36,4,14,23,37,16056.0,3:18,0,0,0,3710.0,0:45,8275000
8473514,Jesse,Joensuu,1987-10-05,LW,L,2014-15,20,2,2,4,0.2,-8,18,11.11,14,12754.0,10:37,0,0,0,0.0,37,9,9,4,5,0,0,0,239.0,0:11,1,0,1,840.0,0:42,950000
8473533,Jordan,Staal,1988-09-10,C,L,2014-15,46,6,18,24,0.52,-6,92,6.52,14,51204.0,18:33,499,386,885,56.38,85,15,39,24,15,1,6,7,5506.0,1:59,0,0,0,563.0,0:12,6000000
8473534,Patrik,Berglund,1988-06-02,C,L,2014-15,77,12,15,27,0.35,-2,145,8.28,26,67345.0,14:34,160,169,329,48.63,93,26,37,13,24,0,1,1,3647.0,0:47,0,0,0,3990.0,0:51,3700000
8473536,James,Sheppard,1988-04-25,C,L,2014-15,71,7,11,18,0.25,-4,79,8.86,37,56473.0,13:15,278,277,555,50.09,121,43,42,33,9,0,1,1,2877.0,0:40,0,0,0,188.0,0:2,1300000
8473537,Viktor,Stalberg,1986-01-17,LW,L,2014-15,25,2,8,10,0.4,0,27,7.41,18,17827.0,11:53,1,0,1,100.0,54,10,7,5,2,0,0,0,48.0,0:1,0,0,0,48.0,0:1,3000000
8473542,Tom,Sestito,1987-09-28,LW,L,2014-15,3,0,1,1,0.33,1,1,0.0,7,1123.0,6:14,0,0,0,0.0,10,0,0,0,0,0,0,0,0.0,0:0,0,0,0,0.0,0:0,750000
8473544,Derick,Brassard,1987-09-22,C,L,2014-15,80,19,41,60,0.75,9,168,11.31,34,83496.0,17:23,671,705,1376,48.76,106,13,42,38,4,6,12,18,13186.0,2:44,0,0,0,1161.0,0:14,5000000
8473546,Michael,Grabner,1987-10-05,RW,L,2014-15,34,8,5,13,0.38,4,63,12.7,4,26388.0,12:56,0,2,2,0.0,62,21,25,17,8,0,0,0,72.0,0:2,0,0,0,2597.0,1:16,3000000
8473548,Phil,Kessel,1987-10-02,RW,R,2014-15,82,25,36,61,0.74,-34,280,8.93,30,92463.0,18:47,2,3,5,40.0,18,13,34,64,-30,8,17,25,18175.0,3:41,0,0,0,53.0,0:0,8000000
8473560,Korbinian,Holzer,1988-02-16,D,R,2014-15,34,0,6,6,0.18,3,32,0.0,25,34890.0,17:6,0,0,0,0.0,117,53,11,26,-15,0,0,0,53.0,0:1,0,0,0,4811.0,2:21,787500
8473563,Nicklas,Backstrom,1987-11-23,C,L,2014-15,82,18,60,78,0.95,5,153,11.76,40,101008.0,20:31,862,747,1609,53.57,91,52,55,36,19,3,30,33,15243.0,3:5,0,0,0,4743.0,0:57,6700000
8473564,Michael,Frolik,1988-02-17,RW,L,2014-15,82,19,23,42,0.51,4,206,9.22,18,86125.0,17:30,14,27,41,34.15,63,41,58,34,24,3,4,7,7955.0,1:37,3,0,3,7805.0,1:35,3300000
8473565,Brian,Strait,1988-01-04,D,L,2014-15,52,2,5,7,0.13,-1,59,3.39,32,57315.0,18:22,0,1,1,0.0,124,85,14,24,-10,0,0,0,162.0,0:3,0,1,1,5460.0,1:45,775000
8473571,Jamie,McBain,1988-02-25,D,R,2014-15,26,3,6,9,0.35,4,18,16.67,4,19792.0,12:41,0,0,0,0.0,21,28,3,6,-3,1,2,3,2729.0,1:44,0,0,0,0.0,0:0,550000
8473573,Artem,Anisimov,1988-05-24,C,L,2014-15,52,7,20,27,0.52,-6,88,7.95,8,51108.0,16:22,102,127,229,44.54,33,26,24,21,3,0,4,4,5022.0,1:36,0,3,3,6265.0,2:0,3283333
8473574,Shawn,Matthias,1988-02-19,LW,L,2014-15,78,18,9,27,0.35,-3,132,13.64,16,61332.0,13:6,84,103,187,44.92,66,33,36,18,18,1,0,1,435.0,0:5,0,1,1,5824.0,1:14,1750000
8473579,Nikolay,Kulemin,1986-07-14,LW,L,2014-15,82,15,16,31,0.38,7,115,13.04,21,73162.0,14:52,7,17,24,29.17,129,58,53,29,24,0,0,0,1205.0,0:14,3,1,4,8654.0,1:45,4187500
8473584,Andrew,MacDonald,1986-09-07,D,L,2014-15,58,2,10,12,0.21,-5,62,3.23,41,69647.0,20:0,0,0,0,0.0,35,86,12,25,-13,1,4,5,4886.0,1:24,0,0,0,5620.0,1:36,5000000
8473588,Erik,Condra,1986-08-06,RW,R,2014-15,68,9,14,23,0.34,13,106,8.49,30,58969.0,14:27,2,7,9,22.22,33,53,37,19,18,0,0,0,425.0,0:6,1,1,2,9111.0,2:13,1250000
8473589,Chris,Summers,1988-02-05,D,L,2014-15,20,0,3,3,0.15,-12,15,0.0,8,17095.0,14:14,0,0,0,0.0,49,26,1,6,-5,0,0,0,40.0,0:2,0,0,0,1768.0,1:28,600000
8473604,Jonathan,Toews,1988-04-29,C,L,2014-15,81,28,38,66,0.81,30,192,14.58,36,95076.0,19:33,947,728,1675,56.54,56,16,45,34,11,6,11,17,16437.0,3:22,2,1,3,6720.0,1:22,6300000
8473618,Mathieu,Perreault,1988-01-05,C,L,2014-15,62,18,23,41,0.66,7,129,13.95,38,60471.0,16:15,226,212,438,51.6,78,13,43,21,22,5,7,12,11247.0,3:1,0,0,0,190.0,0:3,3000000
8473646,Ryan,Carter,1983-08-03,LW,L,2014-15,53,3,10,13,0.25,3,47,6.38,55,32089.0,10:5,29,41,70,41.43,77,30,14,2,12,0,0,0,132.0,0:2,1,0,1,5276.0,1:39,725000
8473658,Victor,Bartley,1988-02-17,D,L,2014-15,37,0,10,10,0.27,1,28,0.0,26,29825.0,13:26,0,0,0,0.0,77,53,2,9,-7,0,0,0,26.0,0:0,0,0,0,1316.0,0:35,666667
8473673,David,Schlemko,1987-05-07,D,L,2014-15,44,1,3,4,0.09,1,45,2.22,12,40474.0,15:19,0,0,0,0.0,45,84,6,19,-13,0,2,2,1232.0,0:28,0,0,0,2942.0,1:6,1187500
8473682,Andrew,Ebbett,1983-01-02,C,L,2014-15,24,1,5,6,0.25,1,21,4.76,2,12968.0,9:0,39,47,86,45.35,10,12,6,3,3,0,0,0,123.0,0:5,0,0,0,1252.0,0:52,550000
8473700,Ryan,Wilson,1987-02-03,D,L,2014-15,3,0,0,0,0.0,-3,3,0.0,0,2017.0,11:12,0,0,0,0.0,6,3,0,3,-3,0,0,0,10.0,0:3,0,0,0,240.0,1:20,2250000
8473722,John,Scott,1982-09-26,LW,L,2014-15,38,3,1,4,0.11,0,19,15.79,87,16990.0,7:27,0,0,0,0.0,94,14,7,11,-4,0,0,0,3.0,0:0,0,0,0,0.0,0:0,700000
8473911,Steven,Pinizzotto,1984-04-26,RW,R,2014-15,18,2,2,4,0.22,1,15,13.33,30,8563.0,7:55,0,0,0,0.0,32,2,2,1,1,0,0,0,18.0,0:1,0,0,0,283.0,0:15,650000
8473914,Mark,Letestu,1985-02-04,C,R,2014-15,54,7,6,13,0.24,-9,63,11.11,0,43216.0,13:20,319,284,603,52.9,51,24,21,7,14,0,1,1,1577.0,0:29,1,0,1,8729.0,2:41,1250000
8473933,Ben,Lovejoy,1984-02-20,D,R,2014-15,60,2,12,14,0.23,-4,86,2.33,25,69986.0,19:26,0,0,0,0.0,170,105,15,22,-7,0,0,0,824.0,0:13,0,2,2,6914.0,1:55,1100000
8473942,Trevor,Smith,1985-02-08,C,L,2014-15,54,2,3,5,0.09,-9,46,4.35,12,35847.0,11:3,293,268,561,52.23,75,25,18,8,10,0,0,0,462.0,0:8,0,0,0,5252.0,1:37,550000
8473962,Teddy,Purcell,1985-09-08,LW,R,2014-15,82,12,22,34,0.41,-33,146,8.22,24,84430.0,17:9,4,3,7,57.14,24,19,46,35,11,5,7,12,11164.0,2:16,0,0,0,5486.0,1:6,4500000
8473970,Rob,Klinkhammer,1986-08-12,LW,L,2014-15,69,5,4,9,0.13,-4,64,7.81,27,46441.0,11:13,10,27,37,27.03,236,12,13,12,1,0,0,0,301.0,0:4,0,0,0,208.0,0:3,625000
8473986,Alex,Killorn,1989-09-14,LW,L,2014-15,71,15,23,38,0.54,8,130,11.54,36,72105.0,16:55,35,45,80,43.75,60,21,29,39,-10,1,2,3,8703.0,2:2,1,0,1,3615.0,0:50,2550000
8473989,Luke,Gazdic,1989-07-25,LW,L,2014-15,40,2,1,3,0.08,-4,26,7.69,43,17739.0,7:23,0,0,0,0.0,76,15,1,7,-6,0,0,0,37.0,0:0,0,0,0,0.0,0:0,800000
8473991,Karl,Alzner,1988-09-24,D,L,2014-15,82,5,16,21,0.26,14,72,6.94,20,95607.0,19:25,0,0,0,0.0,120,165,15,35,-20,0,0,0,94.0,0:1,0,0,0,10747.0,2:11,2800000
8473992,Justin,Falk,1988-10-11,D,L,2014-15,18,1,1,2,0.11,-9,18,5.56,14,11685.0,10:49,0,0,0,0.0,12,19,1,7,-6,0,0,0,12.0,0:0,0,0,0,1037.0,0:57,700000
8473994,Jamie,Benn,1989-07-18,LW,L,2014-15,82,35,52,87,1.06,1,253,13.83,64,98144.0,19:56,298,278,576,51.74,120,50,76,50,26,10,13,23,17549.0,3:34,2,3,5,7274.0,1:28,5250000
8474000,Steven,Kampfer,1988-09-24,D,R,2014-15,25,2,2,4,0.16,-4,28,7.14,12,25795.0,17:11,0,0,0,0.0,49,33,6,6,0,0,1,1,642.0,0:25,0,0,0,1583.0,1:3,550000
8474001,TJ,Galiardi,1988-04-22,LW,L,2014-15,38,1,0,1,0.03,-8,35,2.86,2,23850.0,10:27,2,9,11,18.18,38,14,11,7,4,0,0,0,195.0,0:5,0,0,0,4962.0,2:10,700000
8474008,Paul,Carey,1988-09-24,C,L,2014-15,10,0,1,1,0.1,2,5,0.0,0,4727.0,7:52,0,3,3,0.0,12,2,3,0,3,0,0,0,0.0,0:0,0,0,0,0.0,0:0,715000
8474009,Nick,Bonino,1988-04-20,C,L,2014-15,75,15,24,39,0.52,7,149,10.07,22,76143.0,16:55,590,655,1245,47.39,31,90,54,24,30,1,4,5,8402.0,1:52,0,0,0,8844.0,1:57,1900000
8474013,Ian,Cole,1989-02-21,D,L,2014-15,74,5,12,17,0.23,14,83,6.02,51,70962.0,15:58,0,0,0,0.0,73,99,12,23,-11,0,1,1,2335.0,0:31,0,0,0,1385.0,0:18,825000
8474025,Eric,Tangradi,1989-02-10,LW,L,2014-15,7,0,0,0,0.0,-3,5,0.0,17,3245.0,7:43,1,0,1,100.0,12,4,0,2,-2,0,0,0,0.0,0:0,0,0,0,0.0,0:0,675000
8474027,Justin,Braun,1987-02-10,D,R,2014-15,70,1,22,23,0.33,8,94,1.06,48,88335.0,21:1,0,0,0,0.0,79,130,19,36,-17,0,2,2,2167.0,0:30,0,0,0,9125.0,2:10,1250000
8474031,Kevin,Shattenkirk,1989-01-29,D,R,2014-15,56,8,36,44,0.79,19,135,5.93,52,75800.0,22:33,0,0,0,0.0,42,86,25,35,-10,4,21,25,11568.0,3:26,0,0,0,5941.0,1:46,4250000
8474034,Patrick,Maroon,1988-04-23,LW,L,2014-15,71,9,25,34,0.48,-5,120,7.5,82,60845.0,14:16,7,14,21,33.33,120,10,16,25,-9,1,6,7,9299.0,2:10,0,0,0,28.0,0:0,575000
8474037,James,van Riemsdyk,1989-05-04,LW,L,2014-15,82,27,29,56,0.68,-33,248,10.89,43,93893.0,19:5,21,33,54,38.89,83,29,46,27,19,9,10,19,17499.0,3:33,1,0,1,3133.0,0:38,4250000
8474038,Paul,Byron,1989-04-27,LW,L,2014-15,57,6,13,19,0.33,-2,62,9.68,8,49481.0,14:28,34,63,97,35.05,101,24,46,23,23,1,0,1,1700.0,0:29,0,2,2,4486.0,1:18,600000
8474040,Sam,Gagner,1989-08-10,C,R,2014-15,81,15,26,41,0.51,-28,183,8.2,28,83796.0,17:14,361,410,771,46.82,63,19,36,34,2,6,6,12,11010.0,2:15,0,0,0,108.0,0:1,4800000
8474048,Keith,Aulie,1989-06-11,D,L,2014-15,31,0,1,1,0.03,-3,25,0.0,66,26605.0,14:18,0,0,0,0.0,59,37,4,12,-8,0,0,0,69.0,0:2,0,0,0,1286.0,0:41,800000
8474052,Chris,Terry,1989-04-07,LW,L,2014-15,57,11,9,20,0.35,-4,71,15.49,14,43509.0,12:43,6,5,11,54.55,44,17,21,20,1,3,1,4,4051.0,1:11,0,0,0,2.0,0:0,600000
8474053,Logan,Couture,1989-03-28,C,L,2014-15,82,27,40,67,0.82,-6,263,10.27,12,93836.0,19:4,477,513,990,48.18,85,71,56,72,-16,6,18,24,15817.0,3:12,2,0,2,7190.0,1:27,6000000
8474056,P.K.,Subban,1989-05-13,D,R,2014-15,82,15,45,60,0.73,21,170,8.82,74,128920.0,26:12,0,0,0,0.0,97,142,29,112,-83,8,13,21,18132.0,3:41,0,0,0,10637.0,2:9,9000000
8474061,Anthony,Peluso,1989-04-18,RW,R,2014-15,49,1,1,2,0.04,-3,23,4.35,86,17278.0,5:52,0,1,1,0.0,100,5,4,11,-7,0,0,0,111.0,0:2,0,0,0,10.0,0:0,562500
8474062,Riley,Nash,1989-05-09,C,R,2014-15,68,8,17,25,0.37,-10,94,8.51,12,66556.0,16:18,488,470,958,50.94,88,46,52,29,23,1,5,6,6805.0,1:40,0,0,0,6872.0,1:41,575000
8474066,Thomas,Hickey,1989-02-08,D,L,2014-15,81,2,20,22,0.27,-12,82,2.44,26,91984.0,18:55,1,1,2,50.0,117,136,39,55,-16,0,0,0,1050.0,0:12,0,2,2,9130.0,1:52,675000
8474068,Kyle,Turris,1989-08-14,C,R,2014-15,82,24,40,64,0.78,5,215,11.16,36,94544.0,19:12,737,735,1472,50.07,48,40,48,46,2,4,12,16,14912.0,3:1,1,0,1,3611.0,0:44,3500000
8474074,Paul,Postma,1989-02-22,D,R,2014-15,42,2,4,6,0.14,1,40,5.0,16,35605.0,14:7,0,0,0,0.0,17,28,17,22,-5,2,0,2,2653.0,1:3,0,0,0,252.0,0:6,712500
8474089,Brad,Malone,1989-05-20,C,L,2014-15,65,7,8,15,0.23,-8,65,10.77,74,39587.0,10:9,30,19,49,61.22,162,16,16,19,-3,0,0,0,354.0,0:5,0,0,0,1476.0,0:22,650000
8474090,Brendan,Smith,1989-02-08,D,L,2014-15,76,4,9,13,0.17,-2,88,4.55,68,81583.0,17:53,0,0,0,0.0,60,68,19,47,-28,0,2,2,1058.0,0:13,0,0,0,5588.0,1:13,1262500
8474091,Brandon,Sutter,1989-02-14,C,R,2014-15,80,21,12,33,0.41,6,180,11.67,14,83155.0,17:19,688,671,1359,50.63,86,48,41,33,8,3,2,5,7298.0,1:31,4,0,4,11061.0,2:18,3300000
8474094,Matt,Halischuk,1988-06-01,RW,R,2014-15,47,3,5,8,0.17,5,59,5.08,6,27480.0,9:44,1,0,1,100.0,55,24,11,9,2,0,0,0,321.0,0:6,0,0,0,948.0,0:20,725000
8474095,Dana,Tyrell,1989-04-23,C,L,2014-15,3,0,0,0,0.0,-1,1,0.0,0,1249.0,6:56,0,0,0,0.0,5,3,0,0,0,0,0,0,0.0,0:0,0,0,0,0.0,0:0,655000
8474096,Nick,Spaling,1988-09-19,C,L,2014-15,82,9,18,27,0.33,-2,90,10.0,26,74974.0,15:14,84,90,174,48.28,134,45,24,13,11,1,0,1,1301.0,0:15,0,0,0,9127.0,1:51,2200000
8474098,Colton,Sceviour,1989-04-20,C,R,2014-15,71,9,17,26,0.37,1,113,7.96,13,54172.0,12:42,30,41,71,42.25,77,41,24,21,3,0,4,4,4471.0,1:2,0,0,0,1289.0,0:18,650000
8474100,Dwight,King,1989-07-05,LW,L,2014-15,81,13,13,26,0.32,-3,127,10.24,21,69962.0,14:23,3,2,5,60.0,124,14,20,23,-3,0,1,1,2226.0,0:27,0,1,1,4214.0,0:52,1950000
8474102,David,Perron,1988-05-28,LW,R,2014-15,81,17,24,41,0.51,-25,196,8.67,62,84214.0,17:19,3,9,12,25.0,171,21,35,35,0,3,6,9,12824.0,2:38,0,0,0,63.0,0:0,3812500
8474113,TJ,Brennan,1989-04-03,D,L,2014-15,6,0,1,1,0.17,-7,11,0.0,9,6052.0,16:48,0,0,0,0.0,2,5,1,5,-4,0,1,1,1297.0,3:36,0,0,0,165.0,0:27,600000
8474125,Carl,Gunnarsson,1986-11-09,D,L,2014-15,61,2,10,12,0.2,10,54,3.7,2,66117.0,18:3,0,0,0,0.0,42,114,11,13,-2,0,1,1,1070.0,0:17,0,0,0,4588.0,1:15,3150000
8474130,Corey,Tropp,1989-07-25,RW,R,2014-15,61,1,7,8,0.13,-14,22,4.55,76,32038.0,8:45,1,1,2,50.0,80,28,12,10,2,0,0,0,160.0,0:2,0,0,0,19.0,0:0,625000
8474134,Yannick,Weber,1988-09-23,D,R,2014-15,65,11,10,21,0.32,4,117,9.4,30,67032.0,17:11,0,0,0,0.0,66,62,14,35,-21,5,3,8,5663.0,1:27,0,0,0,2547.0,0:39,850000
8474135,Brett,Bellemore,1988-06-25,D,R,2014-15,49,2,8,10,0.2,1,26,7.69,27,48149.0,16:22,0,0,0,0.0,148,54,9,28,-19,0,0,0,100.0,0:2,0,0,0,2892.0,0:59,600000
8474141,Patrick,Kane,1988-11-19,RW,L,2014-15,61,27,37,64,1.05,10,186,14.52,10,72654.0,19:51,3,4,7,42.86,22,14,36,30,6,6,16,22,13460.0,3:40,0,0,0,147.0,0:2,6300000
8474145,Robert,Bortuzzo,1989-03-18,D,R,2014-15,51,3,5,8,0.16,-9,56,5.36,93,46249.0,15:6,1,0,1,100.0,157,61,3,9,-6,0,0,0,419.0,0:8,0,0,0,3052.0,0:59,600000
8474150,Mikael,Backlund,1989-03-17,C,L,2014-15,52,10,17,27,0.52,4,103,9.71,14,55363.0,17:44,423,452,875,48.34,41,32,58,42,16,0,1,1,5259.0,1:41,2,0,2,4517.0,1:26,1500000
8474151,Ryan,McDonagh,1989-06-13,D,L,2014-15,71,8,25,33,0.46,23,148,5.41,26,98545.0,23:7,0,0,0,0.0,77,139,40,60,-20,3,9,12,9846.0,2:18,0,3,3,11148.0,2:37,4700000
8474157,Max,Pacioretty,1988-11-20,LW,L,2014-15,80,37,30,67,0.84,38,302,12.25,32,93091.0,19:23,2,7,9,22.22,106,38,43,43,0,7,4,11,12381.0,2:34,3,2,5,7504.0,1:33,4500000
8474161,Jakub,Voracek,1989-08-15,RW,L,2014-15,82,22,59,81,0.99,1,221,9.95,78,91478.0,18:35,6,3,9,66.67,55,28,34,42,-8,11,22,33,16064.0,3:15,0,0,0,180.0,0:2,4250000
8474162,Jake,Muzzin,1989-02-21,D,L,2014-15,76,10,31,41,0.54,-4,173,5.78,22,103511.0,22:41,0,0,0,0.0,186,108,18,68,-50,4,10,14,11649.0,2:33,0,1,1,4197.0,0:55,1000000
8474164,Jonathon,Blum,1989-01-30,D,R,2014-15,4,0,1,1,0.25,-3,3,0.0,2,2368.0,9:52,0,0,0,0.0,1,2,0,1,-1,0,0,0,21.0,0:5,0,0,0,57.0,0:14,675000
8474166,Alec,Martinez,1987-07-26,D,L,2014-15,56,6,16,22,0.39,9,103,5.83,10,66967.0,19:55,0,0,0,0.0,95,117,11,38,-27,1,3,4,6533.0,1:56,0,0,0,5374.0,1:35,1100000
8474168,Joakim,Andersson,1989-02-05,C,L,2014-15,68,3,5,8,0.12,-4,74,4.05,22,47445.0,11:37,192,183,375,51.2,27,24,8,13,-5,0,0,0,420.0,0:6,0,0,0,8833.0,2:9,732500
8474176,Carl,Hagelin,1988-08-23,LW,L,2014-15,82,17,18,35,0.43,18,185,9.19,46,74941.0,15:13,6,11,17,35.29,85,36,51,43,8,1,0,1,434.0,0:5,0,1,1,9641.0,1:57,2250000
8474189,Lars,Eller,1989-05-08,C,L,2014-15,77,15,12,27,0.35,-6,150,10.0,42,71607.0,15:29,405,379,784,51.66,76,37,29,30,-1,1,1,2,2160.0,0:28,0,2,2,6221.0,1:20,3500000
8474190,Wayne,Simmonds,1988-08-26,RW,R,2014-15,75,28,22,50,0.67,-5,188,14.89,66,75635.0,16:48,4,1,5,80.0,168,36,33,29,4,14,10,24,14188.0,3:9,0,0,0,35.0,0:0,3975000
8474192,Matt,Frattin,1988-01-03,RW,R,2014-15,9,0,0,0,0.0,0,6,0.0,4,3810.0,7:3,1,0,1,100.0,4,4,0,1,-1,0,0,0,11.0,0:1,0,0,0,13.0,0:1,800000
8474207,Nick,Holden,1987-05-15,D,L,2014-15,78,5,9,14,0.18,-11,94,5.32,28,92697.0,19:48,0,0,0,0.0,156,96,24,34,-10,2,4,6,8658.0,1:51,0,0,0,9019.0,1:55,600000
8474218,Jason,Demers,1988-06-09,D,R,2014-15,81,5,20,25,0.31,-3,99,5.05,71,92952.0,19:7,0,0,0,0.0,118,85,37,49,-12,2,3,5,7835.0,1:36,0,0,0,8262.0,1:42,3400000
8474230,Micheal,Haley,1986-03-30,C,L,2014-15,4,0,0,0,0.0,-1,1,0.0,11,1802.0,7:30,2,0,2,100.0,6,1,0,0,0,0,0,0,0.0,0:0,0,0,0,0.0,0:0,600000
8474250,Zack,Smith,1988-04-05,LW,L,2014-15,37,2,1,3,0.08,-8,38,5.26,18,26714.0,12:2,103,128,231,44.59,64,13,15,7,8,0,0,0,434.0,0:11,0,0,0,2141.0,0:57,1887500
8474291,Jay,Beagle,1985-10-16,C,R,2014-15,62,10,10,20,0.32,6,84,11.9,20,47649.0,12:48,217,167,384,56.51,73,33,30,6,24,0,0,0,110.0,0:1,0,1,1,6937.0,1:51,900000
8474497,Michael,Kostka,1985-11-28,D,R,2014-15,7,0,1,1,0.14,1,7,0.0,0,6462.0,15:23,0,0,0,0.0,6,9,2,5,-3,0,0,0,27.0,0:3,0,0,0,284.0,0:40,650000
8474516,Bryan,Lerg,1986-01-20,C,L,2014-15,2,1,0,1,0.5,-1,8,12.5,0,1512.0,12:36,4,0,4,100.0,3,0,0,1,-1,0,0,0,122.0,1:1,0,0,0,2.0,0:1,575000
8474519,Jack,Hillen,1986-01-24,D,L,2014-15,38,0,5,5,0.13,-1,24,0.0,10,29322.0,12:51,0,0,0,0.0,38,53,6,9,-3,0,0,0,66.0,0:1,0,0,0,125.0,0:3,700000
8474520,Jason,Garrison,1984-11-13,D,L,2014-15,70,4,26,30,0.43,27,111,3.6,19,84041.0,20:0,0,0,0,0.0,46,94,21,29,-8,1,10,11,7034.0,1:40,0,0,0,9384.0,2:14,4600000
8474535,Chris,Mueller,1986-03-06,C,R,2014-15,7,1,1,2,0.29,-1,10,10.0,0,4390.0,10:27,38,26,64,59.38,3,1,1,2,-1,1,0,1,789.0,1:52,0,0,0,0.0,0:0,600000
8474563,Drew,Doughty,1989-12-08,D,R,2014-15,82,7,39,46,0.56,3,219,3.2,56,142660.0,28:59,0,1,1,0.0,152,144,12,80,-68,1,16,17,16931.0,3:26,0,1,1,13031.0,2:38,7000000
8474564,Steven,Stamkos,1990-02-07,C,R,2014-15,82,43,29,72,0.88,2,268,16.04,49,95289.0,19:22,469,474,943,49.73,91,35,34,37,-3,13,12,25,17468.0,3:33,0,0,0,1010.0,0:12,7500000
8474565,Alex,Pietrangelo,1990-01-18,D,R,2014-15,81,7,39,46,0.57,-2,195,3.59,28,123487.0,25:24,0,0,0,0.0,70,161,33,38,-5,1,11,12,11864.0,2:26,0,0,0,14974.0,3:4,6500000
8474567,Zach,Bogosian,1990-07-15,D,R,2014-15,62,3,17,20,0.32,-6,125,2.4,78,88015.0,23:39,0,0,0,0.0,189,90,14,38,-24,0,2,2,5943.0,1:35,0,0,0,9339.0,2:30,5142857
8474568,Luke,Schenn,1989-11-02,D,R,2014-15,58,3,11,14,0.24,-2,67,4.48,18,62883.0,18:4,0,0,0,0.0,194,89,7,39,-32,0,0,0,270.0,0:4,0,0,0,8010.0,2:18,3600000
8474569,Colin,Wilson,1989-10-20,C,L,2014-15,77,20,22,42,0.55,19,172,11.63,22,74897.0,16:12,71,107,178,39.89,52,33,29,32,-3,3,4,7,11460.0,2:28,0,0,0,97.0,0:1,2000000
8474570,Cody,Hodgson,1990-02-18,C,R,2014-15,78,6,7,13,0.17,-28,127,4.72,12,60120.0,12:50,173,204,377,45.89,40,21,24,16,8,0,1,1,6247.0,1:20,0,0,0,36.0,0:0,4250000
8474571,Mikkel,Boedker,1989-12-16,LW,L,2014-15,45,14,14,28,0.62,-10,79,17.72,6,47206.0,17:29,0,2,2,0.0,66,9,24,14,10,3,9,12,7659.0,2:50,0,0,0,240.0,0:5,2550000
8474573,Josh,Bailey,1989-10-02,RW,L,2014-15,70,15,26,41,0.59,3,140,10.71,12,70479.0,16:46,30,36,66,45.45,66,36,53,47,6,2,2,4,6905.0,1:38,0,0,0,682.0,0:9,3300000
8474574,Tyler,Myers,1990-02-01,D,R,2014-15,71,7,21,28,0.39,-6,124,5.65,77,104963.0,24:38,0,0,0,0.0,65,132,44,54,-10,2,4,6,12374.0,2:54,0,2,2,11096.0,2:36,5500000
8474576,Zach,Boychuk,1989-10-04,LW,L,2014-15,31,3,3,6,0.19,0,35,8.57,4,19764.0,10:37,0,0,0,0.0,40,9,9,3,6,0,0,0,487.0,0:15,0,0,0,3.0,0:0,600000
8474577,Joe,Colborne,1990-01-30,C,L,2014-15,64,8,20,28,0.44,7,67,11.94,43,59214.0,15:25,176,160,336,52.38,158,35,25,33,-8,1,4,5,5571.0,1:27,1,0,1,2817.0,0:44,1275000
8474578,Erik,Karlsson,1990-05-31,D,R,2014-15,82,21,45,66,0.8,7,292,7.19,42,134095.0,27:15,0,0,0,0.0,93,89,59,99,-40,6,24,30,23624.0,4:48,0,0,0,2763.0,0:33,6500000
8474579,Luca,Sbisa,1990-01-30,D,L,2014-15,76,3,8,11,0.14,-8,79,3.8,46,85623.0,18:46,0,0,0,0.0,151,128,14,46,-32,0,0,0,424.0,0:5,0,0,0,9211.0,2:1,2175000
8474581,Jake,Gardiner,1990-07-04,D,L,2014-15,79,4,20,24,0.3,-23,100,4.0,24,99415.0,20:58,0,0,0,0.0,109,83,39,66,-27,0,8,8,11847.0,2:29,0,0,0,1085.0,0:13,4050000
8474584,Michael,Del Zotto,1990-06-24,D,L,2014-15,64,10,22,32,0.5,-5,119,8.4,34,84189.0,21:55,0,0,0,0.0,153,128,14,36,-22,1,7,8,6668.0,1:44,1,0,1,7407.0,1:55,1300000
8474586,Jordan,Eberle,1990-05-15,C,R,2014-15,81,24,39,63,0.78,-16,183,13.11,24,92545.0,19:2,1,5,6,16.67,62,36,37,73,-36,6,15,21,12744.0,2:37,0,0,0,394.0,0:4,6000000
8474589,Tyler,Ennis,1989-10-06,LW,L,2014-15,78,20,26,46,0.59,-19,185,10.81,37,89459.0,19:6,67,116,183,36.61,87,35,30,21,9,6,11,17,14257.0,3:2,1,0,1,1302.0,0:16,4600000
8474590,John,Carlson,1990-01-10,D,R,2014-15,82,12,43,55,0.67,11,193,6.22,28,113518.0,23:4,0,0,0,0.0,74,200,41,88,-47,3,13,16,8552.0,1:44,1,0,1,14554.0,2:57,3966667
8474594,Slava,Voynov,1990-01-15,D,R,2014-15,6,0,2,2,0.33,0,5,0.0,2,8347.0,23:11,0,0,0,0.0,11,8,1,8,-7,0,1,1,978.0,2:43,0,1,1,986.0,2:44,4166666
8474597,Cody,Goloubef,1989-11-30,D,R,2014-15,36,0,9,9,0.25,12,23,0.0,19,33621.0,15:33,0,0,0,0.0,44,32,3,14,-11,0,0,0,113.0,0:3,0,1,1,1853.0,0:51,625000
8474600,Roman,Josi,1990-06-01,D,L,2014-15,81,15,40,55,0.68,15,201,7.46,26,128665.0,26:28,0,1,1,0.0,53,209,25,45,-20,3,12,15,15099.0,3:6,0,3,3,11860.0,2:26,4000000
8474602,Justin,Schultz,1990-07-06,D,R,2014-15,81,6,25,31,0.38,-17,122,4.92,12,109891.0,22:36,1,0,1,100.0,41,114,20,69,-49,0,12,12,13602.0,2:47,0,0,0,1678.0,0:20,3675000
8474603,Eric,O'Dell,1990-06-21,C,R,2014-15,11,0,1,1,0.09,0,6,0.0,19,4906.0,7:26,18,23,41,43.9,14,0,8,4,4,0,0,0,81.0,0:7,0,0,0,0.0,0:0,650000
8474605,Patrick,Wiercioch,1990-09-12,D,L,2014-15,56,3,10,13,0.23,3,79,3.8,28,60669.0,18:3,0,0,0,0.0,50,44,10,47,-37,1,4,5,8059.0,2:23,0,0,0,558.0,0:9,2000000
8474606,Colby,Robak,1990-04-24,D,L,2014-15,12,0,1,1,0.08,2,8,0.0,2,10021.0,13:55,0,0,0,0.0,16,10,2,8,-6,0,0,0,49.0,0:4,0,0,0,516.0,0:43,675000
8474610,Zac,Dalpe,1989-11-01,C,R,2014-15,21,1,2,3,0.14,-11,29,3.45,4,11689.0,9:16,20,13,33,60.61,15,8,5,3,2,0,0,0,75.0,0:3,0,0,0,0.0,0:0,700000
8474612,Travis,Hamonic,1990-08-16,D,R,2014-15,71,5,28,33,0.46,15,132,3.79,85,92827.0,21:47,0,0,0,0.0,213,131,27,56,-29,1,7,8,5076.0,1:11,0,0,0,8009.0,1:52,3857143
8474613,Derek,Stepan,1990-06-18,C,R,2014-15,68,16,39,55,0.81,26,155,10.32,22,74178.0,18:10,543,689,1232,44.07,36,27,46,32,14,3,7,10,10881.0,2:40,2,3,5,6503.0,1:35,3075000
8474618,Marco,Scandella,1990-02-23,D,L,2014-15,64,11,12,23,0.36,8,112,9.82,56,83420.0,21:43,0,0,0,0.0,90,100,30,31,-1,1,4,5,2167.0,0:33,0,1,1,9211.0,2:23,1025000
8474625,Jimmy,Hayes,1989-11-21,RW,R,2014-15,72,19,16,35,0.49,-4,166,11.45,20,65416.0,15:8,4,5,9,44.44,147,12,22,19,3,4,7,11,8608.0,1:59,0,0,0,178.0,0:2,925000
8474627,Jori,Lehtera,1987-12-23,C,L,2014-15,75,14,30,44,0.59,21,103,13.59,48,72948.0,16:12,543,518,1061,51.18,43,35,40,17,23,2,5,7,10434.0,2:19,1,1,2,1866.0,0:24,2750000
8474628,Michael,Stone,1990-06-07,D,R,2014-15,81,3,15,18,0.22,-24,144,2.08,60,101418.0,20:52,1,0,1,100.0,202,189,12,23,-11,0,5,5,5378.0,1:6,0,0,0,8195.0,1:41,1150000
8474638,Andrew,Campbell,1988-02-04,D,L,2014-15,33,0,1,1,0.03,-13,28,0.0,10,34723.0,17:32,0,0,0,0.0,67,58,2,6,-4,0,0,0,16.0,0:0,0,0,0,5812.0,2:56,550000
8474641,Adam,Henrique,1990-02-06,C,L,2014-15,75,16,27,43,0.57,-6,127,12.6,34,79846.0,17:44,270,249,519,52.02,59,44,31,21,10,5,11,16,7778.0,1:43,0,1,1,8341.0,1:51,4000000
8474642,Lance,Bouma,1990-03-25,LW,L,2014-15,78,16,18,34,0.44,10,104,15.38,54,65567.0,14:0,29,45,74,39.19,264,82,22,25,-3,0,1,1,268.0,0:3,0,1,1,8302.0,1:46,775000
8474646,Brandon,McMillan,1990-03-22,LW,L,2014-15,58,1,3,4,0.07,-19,51,1.96,16,36429.0,10:28,10,13,23,43.48,91,23,15,2,13,0,0,0,133.0,0:2,0,0,0,4774.0,1:22,625000
8474659,Matt,Donovan,1990-05-09,D,L,2014-15,12,0,3,3,0.25,4,12,0.0,0,12653.0,17:34,0,0,0,0.0,22,16,3,11,-8,0,0,0,803.0,1:6,0,0,0,174.0,0:14,826875
8474660,David,Warsofsky,1990-05-30,D,L,2014-15,4,0,1,1,0.25,1,7,0.0,0,4262.0,17:45,0,0,0,0.0,2,2,0,1,-1,0,0,0,469.0,1:57,0,0,0,317.0,1:19,600000
8474661,Michal,Jordan,1990-07-17,D,L,2014-15,38,2,4,6,0.16,-7,44,4.55,4,36355.0,15:56,0,0,0,0.0,35,61,8,19,-11,2,0,2,2344.0,1:1,0,0,0,174.0,0:4,550000
8474668,Dale,Weise,1988-08-05,RW,R,2014-15,79,10,19,29,0.37,21,91,10.99,34,57741.0,12:10,5,7,12,41.67,145,34,26,12,14,0,0,0,459.0,0:5,0,0,0,2874.0,0:36,1025000
8474673,TJ,Brodie,1990-06-07,D,L,2014-15,81,11,30,41,0.51,15,133,8.27,30,122510.0,25:12,0,0,0,0.0,27,178,71,88,-17,3,6,9,10656.0,2:11,1,2,3,9998.0,2:3,2125000
8474679,Gustav,Nyquist,1989-09-01,RW,L,2014-15,82,27,27,54,0.66,-11,195,13.85,26,81951.0,16:39,1,8,9,11.11,43,31,34,32,2,14,10,24,14804.0,3:0,0,0,0,84.0,0:1,950000
8474685,Matt,Calvert,1989-12-24,LW,L,2014-15,56,13,10,23,0.41,1,93,13.98,28,53739.0,15:59,6,4,10,60.0,92,20,26,19,7,0,0,0,3014.0,0:53,0,1,1,6698.0,1:59,987500
8474688,Greg,Pateryn,1990-06-20,D,R,2014-15,17,0,0,0,0.0,0,10,0.0,6,12907.0,12:39,0,0,0,0.0,48,18,0,10,-10,0,0,0,98.0,0:5,0,0,0,522.0,0:30,562500
8474697,Mark,Borowiecki,1989-07-12,D,L,2014-15,63,1,10,11,0.17,15,30,3.33,107,60142.0,15:54,0,0,0,0.0,233,102,9,21,-12,0,0,0,125.0,0:1,0,0,0,8307.0,2:11,575000
8474709,Matt,Martin,1989-05-08,LW,L,2014-15,78,8,6,14,0.18,-4,90,8.89,114,52741.0,11:16,5,5,10,50.0,382,36,24,27,-3,0,0,0,655.0,0:8,0,0,0,222.0,0:2,1000000
8474715,Cam,Atkinson,1989-06-05,RW,R,2014-15,78,22,18,40,0.51,-2,212,10.38,22,79518.0,16:59,4,5,9,44.44,55,39,40,22,18,7,3,10,10816.0,2:18,1,0,1,4578.0,0:58,1150000
8474716,Jared,Spurgeon,1989-11-29,D,R,2014-15,66,9,16,25,0.38,3,128,7.03,6,89586.0,22:37,0,0,0,0.0,48,124,31,30,1,3,3,6,8020.0,2:1,0,0,0,8639.0,2:10,2666667
8474717,Mark,Barberio,1990-03-23,D,L,2014-15,52,1,6,7,0.13,-4,53,1.89,16,52362.0,16:46,0,0,0,0.0,35,46,13,20,-7,0,0,0,200.0,0:3,0,0,0,2523.0,0:48,874125
8474722,Luke,Witkowski,1990-04-14,RW,R,2014-15,16,0,0,0,0.0,0,10,0.0,15,14579.0,15:11,0,0,0,0.0,37,20,2,10,-8,0,0,0,8.0,0:0,0,0,0,686.0,0:42,627500
8474727,Ben,Smith,1988-07-11,RW,R,2014-15,80,7,7,14,0.18,2,92,7.61,2,62650.0,13:3,310,284,594,52.19,72,75,22,16,6,0,0,0,698.0,0:8,0,0,0,10164.0,2:7,1500000
8474736,Zac,Rinaldo,1990-06-15,C,L,2014-15,58,1,5,6,0.1,-9,45,2.22,102,31035.0,8:55,1,2,3,33.33,216,20,9,9,0,0,0,0,255.0,0:4,0,0,0,945.0,0:16,750000
8474739,Tommy,Wingels,1988-04-12,C,R,2014-15,75,15,21,36,0.48,-7,158,9.49,40,74119.0,16:28,70,84,154,45.45,263,55,33,40,-7,4,6,10,6737.0,1:29,1,0,1,5749.0,1:16,2475000
8474743,Zach,Redmond,1988-07-26,D,R,2014-15,59,5,15,20,0.34,-1,93,5.38,24,60696.0,17:8,0,0,0,0.0,59,76,20,17,3,1,5,6,5302.0,1:29,0,0,0,1096.0,0:18,750000
8474744,Sean,Collins,1988-12-29,C,L,2014-15,8,0,2,2,0.25,0,4,0.0,2,4960.0,10:20,2,3,5,40.0,18,0,0,0,0,0,0,0,27.0,0:3,0,0,0,0.0,0:0,620000
8474748,Andrew,MacWilliam,1990-03-25,D,L,2014-15,12,0,2,2,0.17,-6,5,0.0,12,11090.0,15:24,0,1,1,0.0,35,20,2,4,-2,0,0,0,11.0,0:0,0,0,0,2046.0,2:50,875000
8474749,Matt,Bartkowski,1988-06-04,D,L,2014-15,47,0,4,4,0.09,-6,67,0.0,37,47774.0,16:56,0,0,0,0.0,88,24,6,25,-19,0,0,0,218.0,0:4,0,0,0,3156.0,1:7,1250000
8474772,Stu,Bickel,1986-10-02,D,R,2014-15,9,0,1,1,0.11,1,3,0.0,46,2937.0,5:26,0,0,0,0.0,10,9,1,2,-1,0,0,0,0.0,0:0,0,0,0,0.0,0:0,600000
8474774,Dalton,Prout,1990-03-13,D,R,2014-15,63,0,8,8,0.13,-14,64,0.0,85,69610.0,18:24,0,0,0,0.0,166,84,3,18,-15,0,0,0,226.0,0:3,0,0,0,8841.0,2:20,1075000
8474793,Justin,Hodgman,1988-06-27,C,R,2014-15,5,1,0,1,0.2,-2,3,33.33,2,3419.0,11:23,25,21,46,54.35,8,0,0,2,-2,1,0,1,220.0,0:44,0,0,0,0.0,0:0,550000
8474818,Jordie,Benn,1987-07-26,D,L,2014-15,73,2,14,16,0.22,-5,70,2.86,34,79128.0,18:3,0,1,1,0.0,92,121,16,44,-28,0,2,2,2979.0,0:40,0,0,0,7952.0,1:48,700000
8474849,Antoine,Roussel,1989-11-21,LW,L,2014-15,80,13,12,25,0.31,-20,113,11.5,148,69705.0,14:31,3,14,17,17.65,115,71,31,38,-7,0,3,3,3012.0,0:37,0,0,0,8522.0,1:46,2000000
8474870,Tyler,Johnson,1990-07-29,C,R,2014-15,77,29,43,72,0.94,33,203,14.29,24,79641.0,17:14,537,566,1103,48.69,64,36,26,31,-5,8,9,17,10386.0,2:14,0,0,0,8127.0,1:45,3333333
8474873,Brian,Lashoff,1990-07-16,D,L,2014-15,11,0,2,2,0.18,4,7,0.0,6,8768.0,13:17,0,0,0,0.0,7,14,3,2,1,0,0,0,0.0,0:0,0,0,0,930.0,1:24,725000
8474884,Mike,Hoffman,1989-11-24,LW,L,2014-15,79,27,21,48,0.61,16,199,13.57,14,68986.0,14:33,7,7,14,50.0,40,33,57,45,12,1,2,3,8285.0,1:44,0,0,0,289.0,0:3,750000
8475098,Tyler,Bozak,1986-03-19,C,R,2014-15,82,23,26,49,0.6,-34,154,14.94,44,94206.0,19:8,944,831,1775,53.18,83,46,68,23,45,12,6,18,17358.0,3:31,2,0,2,3433.0,0:41,4200000
8475119,Zach,Sill,1988-05-24,C,L,2014-15,63,1,3,4,0.06,-5,43,2.33,84,31687.0,8:22,46,47,93,49.46,173,27,15,6,9,0,0,0,241.0,0:3,0,0,0,2924.0,0:46,550000
8475147,Jordan,Schroeder,1990-09-29,LW,R,2014-15,25,3,5,8,0.32,9,48,6.25,2,16284.0,10:51,0,0,0,0.0,24,6,13,5,8,0,0,0,10.0,0:0,0,0,0,131.0,0:5,600000
8475148,Tim,Erixon,1991-02-24,D,L,2014-15,42,2,5,7,0.17,-7,36,5.56,14,38348.0,15:13,0,0,0,0.0,34,32,8,10,-2,1,4,5,5094.0,2:1,0,0,0,1667.0,0:39,600000
8475149,Marcus,Johansson,1990-10-06,LW,L,2014-15,82,20,27,47,0.57,6,138,14.49,10,81057.0,16:28,7,9,16,43.75,69,18,29,30,-1,3,12,15,14380.0,2:55,0,0,0,182.0,0:2,2000000
8475150,Jordan,Caron,1990-11-02,RW,L,2014-15,30,0,0,0,0.0,-2,12,0.0,18,14464.0,8:2,0,1,1,0.0,41,8,1,3,-2,0,0,0,59.0,0:1,0,0,0,49.0,0:1,600000
8475151,Kyle,Palmieri,1991-02-01,RW,R,2014-15,57,14,15,29,0.51,-2,112,12.5,37,48211.0,14:5,6,6,12,50.0,97,24,15,27,-12,5,6,11,5867.0,1:42,0,0,0,11.0,0:0,1466667
8475153,Dylan,Olsen,1991-01-03,D,L,2014-15,44,2,6,8,0.18,-7,44,4.55,20,41984.0,15:54,0,0,0,0.0,77,52,9,9,0,0,1,1,1533.0,0:34,0,0,0,4653.0,1:45,775000
8475154,Carter,Ashton,1991-04-01,RW,L,2014-15,7,0,0,0,0.0,-3,4,0.0,0,2614.0,6:13,1,4,5,20.0,6,3,2,1,1,0,0,0,0.0,0:0,0,0,0,32.0,0:4,850500
8475155,Simon,Despres,1991-07-27,D,L,2014-15,75,3,20,23,0.31,11,103,2.91,86,75897.0,16:51,0,1,1,0.0,233,101,11,30,-19,0,1,1,1897.0,0:25,0,0,0,3714.0,0:49,900000
8475157,Landon,Ferraro,1991-08-08,C,R,2014-15,3,1,0,1,0.33,1,4,25.0,0,2157.0,11:59,0,0,0,0.0,3,3,3,0,3,0,0,0,2.0,0:0,0,0,0,0.0,0:0,550000
8475158,Ryan,O'Reilly,1991-02-07,C,L,2014-15,82,17,38,55,0.67,-5,171,9.94,12,97026.0,19:43,713,621,1334,53.45,38,48,98,26,72,2,10,12,12915.0,2:37,1,1,2,8867.0,1:48,6000000
8475160,Kyle,Clifford,1991-01-13,LW,L,2014-15,80,6,9,15,0.19,5,117,5.13,87,51544.0,10:44,2,4,6,33.33,200,14,17,20,-3,0,0,0,505.0,0:6,0,0,0,170.0,0:2,1075000
8475161,Chris,Brown,1991-02-03,RW,R,2014-15,5,1,0,1,0.2,1,4,25.0,2,1938.0,6:27,1,2,3,33.33,6,1,0,2,-2,0,0,0,2.0,0:0,0,0,0,0.0,0:0,853333
8475162,Mat,Clark,1990-10-17,D,R,2014-15,7,0,1,1,0.14,2,2,0.0,6,5364.0,12:46,0,0,0,0.0,10,5,1,2,-1,0,0,0,0.0,0:0,0,0,0,457.0,1:5,550000
8475163,Alex,Chiasson,1990-10-01,RW,R,2014-15,76,11,15,26,0.34,-5,105,10.48,67,60996.0,13:22,3,18,21,14.29,93,20,22,9,13,3,3,6,8728.0,1:54,0,1,1,3851.0,0:50,866667
8475164,Jakob,Silfverberg,1990-10-13,RW,R,2014-15,81,13,26,39,0.48,15,189,6.88,24,76115.0,15:39,23,27,50,46.0,42,37,41,19,22,2,2,4,2880.0,0:35,1,2,3,8527.0,1:45,850000
8475165,Anton,Lander,1991-04-24,C,L,2014-15,38,6,14,20,0.53,-12,61,9.84,14,34227.0,15:0,226,225,451,50.11,59,12,8,18,-10,4,3,7,4707.0,2:3,0,0,0,1959.0,0:51,600000
8475166,John,Tavares,1990-09-20,C,L,2014-15,82,38,48,86,1.05,5,278,13.67,46,101712.0,20:40,753,689,1442,52.22,48,37,94,109,-15,13,18,31,18218.0,3:42,0,1,1,162.0,0:1,5500000
8475167,Victor,Hedman,1990-12-18,D,L,2014-15,59,10,28,38,0.64,12,115,8.7,40,80301.0,22:41,0,0,0,0.0,51,110,29,66,-37,3,8,11,8884.0,2:30,0,0,0,8489.0,2:23,4000000
8475168,Matt,Duchene,1991-01-16,C,L,2014-15,82,21,34,55,0.67,3,207,10.14,16,91373.0,18:34,635,582,1217,52.18,43,74,49,34,15,2,5,7,11322.0,2:18,0,0,0,763.0,0:9,6000000
8475169,Evander,Kane,1991-08-02,LW,L,2014-15,37,10,12,22,0.59,-1,126,7.94,56,42874.0,19:18,30,37,67,44.78,119,14,18,19,-1,4,2,6,4806.0,2:9,1,2,3,3956.0,1:46,5250000
8475170,Brayden,Schenn,1991-08-22,C,L,2014-15,82,18,29,47,0.57,-5,156,11.54,34,84034.0,17:4,86,98,184,46.74,199,38,28,31,-3,7,12,19,14688.0,2:59,0,0,0,191.0,0:2,2500000
8475171,Oliver,Ekman-Larsson,1991-07-17,D,L,2014-15,82,23,20,43,0.52,-18,264,8.71,40,124047.0,25:12,0,0,0,0.0,167,77,30,46,-16,10,10,20,19115.0,3:53,1,0,1,12630.0,2:34,5500000
8475172,Nazem,Kadri,1990-10-06,C,L,2014-15,73,18,21,39,0.53,-7,176,10.23,28,77099.0,17:36,528,616,1144,46.15,118,23,44,43,1,3,4,7,10832.0,2:28,1,0,1,701.0,0:9,2900000
8475174,Jared,Cowen,1991-01-25,D,L,2014-15,54,3,6,9,0.17,-11,47,6.38,45,58808.0,18:9,0,0,0,0.0,159,76,13,33,-20,0,0,0,342.0,0:6,0,0,0,6920.0,2:8,3100000
8475175,Magnus,Paajarvi,1991-04-12,LW,L,2014-15,10,0,1,1,0.1,-2,9,0.0,6,5878.0,9:47,1,0,1,100.0,8,0,0,1,-1,0,1,1,193.0,0:19,0,0,0,0.0,0:0,1200000
8475176,Ryan,Ellis,1991-01-03,D,R,2014-15,58,9,18,27,0.47,8,118,7.63,27,66057.0,18:58,0,0,0,0.0,41,74,21,27,-6,2,4,6,7652.0,2:11,0,0,0,2289.0,0:39,2500000
8475177,Calvin,de Haan,1991-05-09,D,L,2014-15,65,1,11,12,0.18,3,92,1.09,24,74140.0,19:0,0,0,0,0.0,140,130,19,44,-25,0,1,1,742.0,0:11,1,0,1,6793.0,1:44,1966667
8475178,Zack,Kassian,1991-01-24,RW,R,2014-15,42,10,6,16,0.38,-5,55,18.18,81,31798.0,12:37,0,6,6,0.0,88,2,10,14,-4,1,0,1,1647.0,0:39,0,0,0,44.0,0:1,1750000
8475179,Dmitry,Kulikov,1990-10-29,D,L,2014-15,73,3,19,22,0.3,0,83,3.61,48,93344.0,21:18,0,0,0,0.0,114,105,17,26,-9,1,5,6,6543.0,1:29,0,1,1,11094.0,2:31,4333333
8475180,Peter,Holland,1991-01-14,C,L,2014-15,62,11,14,25,0.4,0,93,11.83,31,54019.0,14:31,312,373,685,45.55,99,21,67,21,46,1,2,3,4143.0,1:6,1,1,2,6313.0,1:41,775000
8475181,Nick,Leddy,1991-03-20,D,L,2014-15,78,10,27,37,0.47,18,120,8.33,14,95293.0,20:21,0,0,0,0.0,73,90,39,42,-3,1,11,12,11411.0,2:26,0,1,1,3166.0,0:40,2700000
8475182,David,Rundblad,1990-10-08,D,R,2014-15,49,3,11,14,0.29,17,58,5.17,12,37630.0,12:47,0,0,0,0.0,23,38,10,29,-19,0,1,1,1653.0,0:33,0,0,0,32.0,0:0,785000
8475184,Chris,Kreider,1991-04-30,LW,L,2014-15,80,21,25,46,0.57,24,180,11.67,88,75415.0,15:42,9,12,21,42.86,162,17,25,46,-21,7,1,8,9028.0,1:52,0,0,0,4.0,0:0,2475000
8475185,Jacob,Josefson,1991-03-02,C,L,2014-15,62,6,5,11,0.18,0,61,9.84,24,46245.0,12:25,289,297,586,49.32,55,30,15,14,1,0,2,2,1911.0,0:30,3,0,3,6884.0,1:51,800000
8475186,John,Moore,1990-11-19,D,L,2014-15,57,2,9,11,0.19,-4,77,2.6,30,55769.0,16:18,0,0,0,0.0,77,52,7,23,-16,0,4,4,4471.0,1:18,0,0,0,725.0,0:12,850500
8475188,Brayden,McNabb,1991-01-21,D,L,2014-15,71,2,22,24,0.34,11,74,2.7,52,67730.0,15:53,1,0,1,100.0,175,56,12,45,-33,0,5,5,4567.0,1:4,0,0,0,3117.0,0:43,650000
8475191,Reilly,Smith,1991-04-01,RW,L,2014-15,81,13,27,40,0.49,7,143,9.09,20,74846.0,15:24,2,6,8,25.0,74,39,34,34,0,1,10,11,8712.0,1:47,0,0,0,81.0,0:1,1400000
8475192,Taylor,Beck,1991-05-13,LW,R,2014-15,62,8,8,16,0.26,-4,78,10.26,18,44379.0,11:55,5,5,10,50.0,61,23,15,10,5,2,0,2,2469.0,0:39,0,0,0,1564.0,0:25,550000
8475193,Tomas,Tatar,1990-12-01,LW,L,2014-15,82,29,27,56,0.68,6,211,13.74,28,79818.0,16:13,6,6,12,50.0,90,18,27,40,-13,9,10,19,12257.0,2:29,0,0,0,34.0,0:0,2750000
8475194,Philip,Samuelsson,1991-07-26,D,L,2014-15,4,0,0,0,0.0,-3,4,0.0,0,4052.0,16:53,0,0,0,0.0,2,4,0,1,-1,0,0,0,0.0,0:0,0,0,0,658.0,2:44,550000
8475197,Tyson,Barrie,1991-07-26,D,R,2014-15,80,12,41,53,0.66,5,139,8.63,26,102554.0,21:21,0,0,0,0.0,80,90,40,47,-7,2,14,16,14232.0,2:57,0,0,0,982.0,0:12,2600000
8475199,Eric,Gelinas,1991-05-08,D,L,2014-15,61,6,13,19,0.31,-2,112,5.36,42,60247.0,16:27,0,0,0,0.0,82,50,13,28,-15,3,6,9,8135.0,2:13,0,0,0,303.0,0:4,900000
8475204,Brandon,Pirri,1991-04-10,RW,L,2014-15,49,22,2,24,0.49,6,143,15.38,14,43423.0,14:46,86,89,175,49.14,39,13,18,12,6,7,0,7,5073.0,1:43,0,0,0,167.0,0:3,925000
8475206,Stefan,Elliott,1991-01-30,D,R,2014-15,5,0,0,0,0.0,-2,10,0.0,2,4180.0,13:56,0,0,0,0.0,2,5,1,2,-1,0,0,0,445.0,1:29,0,0,0,0.0,0:0,850500
8475208,Brian,Dumoulin,1991-09-06,D,L,2014-15,8,1,0,1,0.12,0,4,25.0,2,7522.0,15:40,0,0,0,0.0,11,9,0,3,-3,0,0,0,196.0,0:24,0,0,0,363.0,0:45,831667
8475209,Richard,Panik,1991-02-07,RW,L,2014-15,76,11,6,17,0.22,-8,87,12.64,49,53100.0,11:38,2,5,7,28.57,101,57,30,20,10,2,0,2,3627.0,0:47,0,0,0,2167.0,0:28,735000
8475213,Drew,Shore,1991-01-29,C,R,2014-15,11,1,2,3,0.27,-5,13,7.69,0,7038.0,10:39,29,30,59,49.15,10,4,1,1,0,0,0,0,187.0,0:17,0,0,0,170.0,0:15,900000
8475214,Jeremy,Morin,1991-04-16,LW,R,2014-15,43,2,4,6,0.14,1,73,2.74,28,26314.0,10:11,2,3,5,40.0,45,5,14,9,5,0,0,0,608.0,0:14,0,0,0,1.0,0:0,800000
8475218,Mattias,Ekholm,1990-05-24,D,L,2014-15,80,7,11,18,0.22,12,86,8.14,52,91242.0,19:0,0,0,0,0.0,57,102,30,45,-15,1,1,2,2985.0,0:37,0,0,0,7260.0,1:30,1037500
8475220,Marcus,Foligno,1991-08-10,LW,L,2014-15,57,8,12,20,0.35,-5,66,12.12,50,55490.0,16:13,57,75,132,43.18,193,48,28,25,3,0,1,1,3133.0,0:54,0,1,1,4725.0,1:22,1875000
8475222,Sami,Vatanen,1991-06-03,D,R,2014-15,67,12,25,37,0.55,5,122,9.84,36,86277.0,21:27,1,1,2,50.0,75,123,27,48,-21,7,10,17,12558.0,3:7,1,0,1,7137.0,1:46,1262500
8475223,Linden,Vey,1991-07-17,RW,R,2014-15,75,10,14,24,0.32,-3,61,16.39,18,59271.0,13:10,215,287,502,42.83,14,9,25,28,-3,4,2,6,8411.0,1:52,0,0,0,71.0,0:0,735000
8475224,Jordan,Szwarz,1991-05-14,RW,R,2014-15,9,1,0,1,0.11,-2,8,12.5,2,7273.0,13:28,0,0,0,0.0,5,9,1,0,1,0,0,0,14.0,0:1,0,0,0,1216.0,2:15,630000
8475225,Craig,Smith,1989-09-05,RW,R,2014-15,82,23,21,44,0.54,11,252,9.13,44,77443.0,15:44,12,18,30,40.0,77,17,41,53,-12,6,3,9,12130.0,2:27,0,0,0,53.0,0:0,2000000
8475231,Casey,Cizikas,1991-02-27,C,L,2014-15,70,9,9,18,0.26,-2,90,10.0,24,52571.0,12:31,446,409,855,52.16,144,50,42,22,20,0,1,1,479.0,0:6,2,0,2,6032.0,1:26,1000000
8475233,David,Savard,1990-10-22,D,R,2014-15,82,11,25,36,0.44,0,112,9.82,71,112884.0,22:56,1,0,1,100.0,195,105,14,22,-8,3,7,10,9597.0,1:57,0,0,0,14117.0,2:52,1300000
8475235,Nicolas,Deslauriers,1991-02-22,LW,L,2014-15,82,5,10,15,0.18,-24,76,6.58,71,58407.0,11:52,0,1,1,0.0,261,36,9,8,1,0,0,0,539.0,0:6,0,1,1,3218.0,0:39,637500
8475236,Cody,Eakin,1991-05-24,C,L,2014-15,78,19,21,40,0.51,-1,142,13.38,26,80465.0,17:11,656,636,1292,50.77,62,59,68,41,27,2,2,4,6221.0,1:19,2,1,3,9179.0,1:57,1900000
8475243,Ryan,Bourque,1991-01-03,C,L,2014-15,1,0,0,0,0.0,-1,1,0.0,0,709.0,11:49,0,0,0,0.0,0,0,1,0,1,0,0,0,0.0,0:0,0,0,0,24.0,0:24,562500
8475246,Kevin,Connauton,1990-02-23,D,L,2014-15,62,9,12,21,0.34,5,96,9.38,35,60324.0,16:12,0,0,0,0.0,83,48,11,33,-22,0,3,3,6133.0,1:38,0,0,0,97.0,0:1,683333
8475247,Michael,Latta,1991-05-25,C,R,2014-15,53,0,6,6,0.11,4,24,0.0,68,26643.0,8:22,160,175,335,47.76,91,14,15,11,4,0,0,0,69.0,0:1,0,0,0,336.0,0:6,575000
8475250,Andrej,Nestrasil,1991-02-22,C,L,2014-15,54,7,13,20,0.37,-1,82,8.54,8,43259.0,13:21,55,39,94,58.51,54,17,31,13,18,2,3,5,4415.0,1:21,0,0,0,7.0,0:0,550000
8475253,Garrett,Wilson,1991-03-16,LW,L,2014-15,2,0,0,0,0.0,-2,5,0.0,0,1061.0,8:50,0,0,0,0.0,5,1,0,0,0,0,0,0,22.0,0:11,0,0,0,0.0,0:0,715000
8475254,Gabriel,Dumont,1990-10-06,C,R,2014-15,3,0,0,0,0.0,-1,4,0.0,0,1642.0,9:7,11,2,13,84.62,8,2,0,0,0,0,0,0,0.0,0:0,0,0,0,32.0,0:10,562500
8475260,Corban,Knight,1990-09-10,C,R,2014-15,2,0,0,0,0.0,0,2,0.0,0,768.0,6:24,9,2,11,81.82,4,1,0,0,0,0,0,0,0.0,0:0,0,0,0,0.0,0:0,900000
8475266,Tomas,Vincour,1990-11-19,C,R,2014-15,7,0,1,1,0.14,-1,2,0.0,2,3013.0,7:10,0,0,0,0.0,5,4,1,2,-1,0,0,0,0.0,0:0,0,0,0,0.0,0:0,600000
8475268,Gabriel,Bourque,1990-09-23,LW,L,2014-15,69,3,10,13,0.19,-13,76,3.95,10,49739.0,12:0,3,3,6,50.0,141,44,27,14,13,0,0,0,1164.0,0:16,0,0,0,4746.0,1:8,775000
8475274,Seth,Helgeson,1990-10-08,D,L,2014-15,22,0,2,2,0.09,4,11,0.0,18,17772.0,13:27,0,0,0,0.0,42,18,3,9,-6,0,0,0,8.0,0:0,0,0,0,1515.0,1:8,595000
8475279,Ben,Chiarot,1991-05-09,D,L,2014-15,40,2,6,8,0.2,5,37,5.41,22,40855.0,17:1,0,0,0,0.0,70,51,8,25,-17,0,0,0,122.0,0:3,0,0,0,1992.0,0:49,600000
8475287,Erik,Haula,1991-03-23,LW,L,2014-15,72,7,7,14,0.19,-7,92,7.61,32,52490.0,12:9,260,313,573,45.38,31,42,38,10,28,1,0,1,335.0,0:4,0,1,1,9227.0,2:8,900000
8475294,Rasmus,Rissanen,1991-07-13,D,L,2014-15,6,0,0,0,0.0,-5,3,0.0,4,5392.0,14:58,0,0,0,0.0,25,7,0,3,-3,0,0,0,14.0,0:2,0,0,0,283.0,0:47,575000
8475295,Brandon,Kozun,1990-03-08,RW,R,2014-15,20,2,2,4,0.2,-3,8,25.0,6,9493.0,7:54,1,1,2,50.0,21,4,7,4,3,0,0,0,43.0,0:2,0,0,0,544.0,0:27,550000
8475309,Jerry,D'Amigo,1991-02-19,RW,L,2014-15,9,0,0,0,0.0,-4,7,0.0,2,5254.0,9:43,0,0,0,0.0,8,7,3,0,3,0,0,0,16.0,0:1,0,0,0,690.0,1:16,850500
8475310,Curtis,McKenzie,1991-02-22,LW,L,2014-15,36,4,1,5,0.14,-8,41,9.76,48,24912.0,11:32,3,5,8,37.5,85,13,10,13,-3,0,0,0,89.0,0:2,0,0,0,126.0,0:3,645000
8475314,Anders,Lee,1990-07-03,LW,L,2014-15,76,25,16,41,0.54,9,197,12.69,33,65633.0,14:23,1,0,1,100.0,169,29,23,23,0,5,1,6,10054.0,2:12,0,0,0,181.0,0:2,850500
8475321,Phil,Varone,1990-12-04,C,L,2014-15,28,3,2,5,0.18,-14,28,10.71,10,22588.0,13:26,147,179,326,45.09,30,22,8,14,-6,0,0,0,1309.0,0:46,0,0,0,0.0,0:0,586667
8475323,Marcus,Kruger,1990-05-27,C,L,2014-15,81,7,10,17,0.21,-5,126,5.56,32,63609.0,13:5,357,313,670,53.28,29,50,30,9,21,0,0,0,122.0,0:1,0,0,0,10801.0,2:13,1287500
8475325,Jordan,Nolan,1989-06-23,C,L,2014-15,60,6,3,9,0.15,-6,44,13.64,54,35872.0,9:57,1,5,6,16.67,102,11,11,16,-5,0,0,0,310.0,0:5,0,0,0,24.0,0:0,700000
8475342,Oliver,Lauridsen,1989-03-24,D,L,2014-15,1,0,0,0,0.0,-1,2,0.0,10,626.0,10:26,0,0,0,0.0,2,0,0,1,-1,0,0,0,0.0,0:0,0,0,0,81.0,1:21,600000
8475414,Craig,Cunningham,1990-09-13,LW,R,2014-15,51,3,4,7,0.14,-7,54,5.56,4,32048.0,10:28,69,67,136,50.74,107,31,8,2,6,0,0,0,175.0,0:3,1,0,1,2915.0,0:57,600000
8475430,Brandon,Manning,1990-06-04,D,L,2014-15,11,0,3,3,0.27,3,10,0.0,7,11327.0,17:9,0,0,0,0.0,19,13,0,6,-6,0,0,0,158.0,0:14,0,0,0,1697.0,2:34,700000
8475455,Brenden,Dillon,1990-11-13,D,L,2014-15,80,2,8,10,0.12,-13,91,2.2,77,93941.0,19:34,0,0,0,0.0,154,139,15,51,-36,0,0,0,557.0,0:6,1,1,2,6485.0,1:21,1250000
8475461,Andrew,Agozzino,1991-01-03,LW,L,2014-15,1,0,1,1,1.0,1,1,0.0,0,585.0,9:45,0,2,2,0.0,1,0,1,0,1,0,0,0,0.0,0:0,0,0,0,0.0,0:0,590000
8475462,Radko,Gudas,1990-06-05,D,R,2014-15,31,2,3,5,0.16,-5,63,3.17,34,31620.0,17:0,0,0,0,0.0,115,63,9,12,-3,0,0,0,129.0,0:4,0,0,0,1250.0,0:40,991667
8475598,Ryan,Stanton,1989-07-20,D,L,2014-15,54,3,8,11,0.2,9,59,5.08,35,51857.0,16:0,0,0,0,0.0,93,113,10,31,-21,0,0,0,111.0,0:2,0,0,0,4154.0,1:16,550000
8475613,Nate,Prosser,1986-05-07,D,R,2014-15,63,2,5,7,0.11,-1,38,5.26,32,48368.0,12:47,0,0,0,0.0,34,102,7,13,-6,0,0,0,106.0,0:1,0,0,0,7348.0,1:56,700000
8475619,Aaron,Volpatti,1985-05-30,LW,L,2014-15,2,0,0,0,0.0,0,1,0.0,0,1154.0,9:37,0,0,0,0.0,3,1,0,1,-1,0,0,0,0.0,0:0,0,0,0,0.0,0:0,575000
8475625,Matt,Irwin,1987-11-29,D,L,2014-15,53,8,11,19,0.36,3,93,8.6,18,54122.0,17:1,0,0,0,0.0,55,65,14,26,-12,1,2,3,4242.0,1:20,0,0,0,480.0,0:9,1000000
8475650,Brandon,Bollig,1987-01-31,LW,L,2014-15,62,1,4,5,0.08,-9,67,1.49,88,31987.0,8:35,3,2,5,60.0,137,23,15,16,-1,0,0,0,223.0,0:3,0,0,0,135.0,0:2,1250000
8475671,Matt,Fraser,1990-05-20,RW,L,2014-15,60,8,4,12,0.2,-16,92,8.7,17,40385.0,11:13,3,4,7,42.86,111,20,13,16,-3,1,0,1,1636.0,0:27,0,0,0,36.0,0:0,625000
8475690,Christopher,Tanev,1989-12-20,D,R,2014-15,70,2,18,20,0.29,8,53,3.77,12,88540.0,21:4,0,0,0,0.0,23,170,26,49,-23,0,2,2,2184.0,0:31,0,0,0,11542.0,2:44,2000000
8475692,Mats,Zuccarello,1987-09-01,RW,L,2014-15,78,15,34,49,0.63,17,154,9.74,45,80772.0,17:15,16,21,37,43.24,120,42,60,41,19,0,6,6,9189.0,1:57,0,0,0,1774.0,0:22,3500000
8475714,Calle,Jarnkrok,1991-09-25,C,R,2014-15,74,7,11,18,0.24,2,95,7.37,18,57051.0,12:50,296,345,641,46.18,32,21,18,10,8,0,0,0,914.0,0:12,0,1,1,6702.0,1:30,715000
8475715,Oscar,Lindberg,1991-10-29,C,L,2014-15,1,0,0,0,0.0,0,2,0.0,0,498.0,8:18,2,3,5,40.0,3,0,0,1,-1,0,0,0,0.0,0:0,0,0,0,0.0,0:0,675000
8475716,Martin,Marincin,1992-02-18,D,L,2014-15,41,1,4,5,0.12,-4,38,2.63,16,45871.0,18:38,1,0,1,100.0,17,59,16,38,-22,0,0,0,282.0,0:6,0,0,0,4221.0,1:42,730000
8475722,Jason,Zucker,1992-01-16,LW,L,2014-15,51,21,5,26,0.51,-9,124,16.94,18,46082.0,15:3,2,5,7,28.57,67,13,21,19,2,1,0,1,2597.0,0:50,1,0,1,3449.0,1:7,900250
8475723,Petr,Straka,1992-06-15,RW,L,2014-15,3,0,2,2,0.67,1,2,0.0,0,1702.0,9:27,0,0,0,0.0,4,1,1,1,0,0,0,0,0.0,0:0,0,0,0,0.0,0:0,925000
8475726,Tyler,Toffoli,1992-04-24,C,R,2014-15,76,23,26,49,0.64,25,200,11.5,37,66526.0,14:35,4,5,9,44.44,86,11,37,32,5,3,2,5,6592.0,1:26,5,1,6,4531.0,0:59,716667
8475727,Ryan,Spooner,1992-01-30,C,L,2014-15,29,8,10,18,0.62,2,73,10.96,2,25296.0,14:32,100,120,220,45.45,17,5,8,11,-3,3,2,5,4797.0,2:45,0,0,0,165.0,0:5,760000
8475728,Johan,Larsson,1992-07-25,C,L,2014-15,39,6,10,16,0.41,0,50,12.0,12,33968.0,14:30,150,191,341,43.99,59,19,10,12,-2,1,3,4,2986.0,1:16,0,0,0,242.0,0:6,763333
8475732,Danny,Biega,1991-09-29,D,R,2014-15,10,0,2,2,0.2,-5,7,0.0,0,9685.0,16:8,0,0,0,0.0,27,7,1,7,-6,0,0,0,19.0,0:1,0,0,0,7.0,0:0,755000
8475733,Max,Reinhart,1992-02-04,C,L,2014-15,4,0,0,0,0.0,-3,3,0.0,0,1941.0,8:5,6,23,29,20.69,1,3,0,0,0,0,0,0,0.0,0:0,0,0,0,0.0,0:0,618333
8475735,Greg,McKegg,1992-06-17,C,L,2014-15,3,0,0,0,0.0,0,1,0.0,0,1654.0,9:11,17,16,33,51.52,3,2,0,0,0,0,0,0,21.0,0:7,0,0,0,0.0,0:0,660000
8475739,Michael,Bournival,1992-05-31,LW,L,2014-15,29,3,2,5,0.17,3,27,11.11,4,13725.0,7:53,4,1,5,80.0,26,10,6,7,-1,0,0,0,76.0,0:2,0,0,0,295.0,0:10,660000
8475744,Evgeny,Kuznetsov,1992-05-19,C,L,2014-15,80,11,26,37,0.46,10,127,8.66,24,63989.0,13:19,304,377,681,44.64,43,15,32,24,8,4,9,13,6609.0,1:22,0,0,0,98.0,0:1,900000
8475745,Charlie,Coyle,1992-03-02,C,R,2014-15,82,11,24,35,0.43,13,120,9.17,39,71602.0,14:33,334,384,718,46.52,137,52,24,20,4,1,2,3,6275.0,1:16,0,0,0,268.0,0:3,900000
8475747,Patrik,Nemeth,1992-02-08,D,L,2014-15,22,0,3,3,0.14,0,16,0.0,6,21398.0,16:12,0,0,0,0.0,28,21,3,8,-5,0,0,0,104.0,0:4,0,0,0,1510.0,1:8,763333
8475749,Christian,Thomas,1992-05-26,LW,R,2014-15,18,1,0,1,0.06,-2,26,3.85,7,9823.0,9:5,0,1,1,0.0,8,3,5,0,5,0,0,0,174.0,0:9,0,0,0,0.0,0:0,808333
8475750,Jon,Merrill,1992-02-03,D,L,2014-15,66,2,12,14,0.21,-14,47,4.26,24,81395.0,20:33,0,0,0,0.0,59,89,18,32,-14,2,2,4,3934.0,0:59,0,1,1,6958.0,1:45,840000
8475752,Tyler,Pitlick,1991-11-01,C,R,2014-15,17,2,0,2,0.12,-3,18,11.11,4,12692.0,12:26,5,4,9,55.56,55,17,4,6,-2,0,0,0,210.0,0:12,0,0,0,43.0,0:2,725000
8475753,Justin,Faulk,1992-03-20,D,R,2014-15,82,15,34,49,0.6,-19,238,6.3,30,120176.0,24:25,0,0,0,0.0,157,114,70,50,20,7,13,20,13352.0,2:42,2,0,2,9766.0,1:59,4833333
8475754,Brock,Nelson,1991-10-15,C,L,2014-15,82,20,22,42,0.51,6,190,10.53,24,78145.0,15:52,354,445,799,44.31,99,52,53,37,16,10,5,15,13341.0,2:42,0,0,0,4660.0,0:56,900000
8475755,Alex,Petrovic,1992-03-03,D,R,2014-15,33,0,3,3,0.09,-4,29,0.0,34,32194.0,16:15,0,0,0,0.0,76,34,4,12,-8,0,0,0,371.0,0:11,0,0,0,1560.0,0:47,795000
8475758,Devante,Smith-Pelly,1992-06-14,RW,R,2014-15,74,6,14,20,0.27,-1,104,5.77,24,63396.0,14:16,23,60,83,27.71,205,49,18,26,-8,0,1,1,4087.0,0:55,1,1,2,5163.0,1:9,800000
8475759,Brandon,Gormley,1992-02-18,D,L,2014-15,27,2,2,4,0.15,-7,39,5.13,10,24822.0,15:19,0,0,0,0.0,26,32,6,7,-1,1,0,1,882.0,0:32,0,0,0,2636.0,1:37,840000
8475760,Nick,Bjugstad,1992-07-17,C,R,2014-15,72,24,19,43,0.6,-7,207,11.59,38,71635.0,16:34,486,508,994,48.89,148,29,23,28,-5,7,5,12,10010.0,2:19,0,0,0,2233.0,0:31,900000
8475761,Beau,Bennett,1991-11-27,RW,R,2014-15,49,4,8,12,0.24,-1,81,4.94,16,36713.0,12:29,0,2,2,0.0,68,13,9,17,-8,0,0,0,2208.0,0:45,0,0,0,47.0,0:0,900000
8475763,Kevin,Hayes,1992-05-08,C,L,2014-15,79,17,28,45,0.57,15,111,15.32,22,61814.0,13:2,247,434,681,36.27,57,33,45,40,5,1,4,5,2888.0,0:36,1,0,1,2120.0,0:26,900000
8475764,Cam,Fowler,1991-12-05,D,L,2014-15,80,7,27,34,0.42,4,87,8.05,14,101490.0,21:8,0,0,0,0.0,47,107,23,52,-29,1,8,9,11555.0,2:24,1,1,2,8682.0,1:48,4000000
8475765,Vladimir,Tarasenko,1991-12-13,RW,L,2014-15,77,37,36,73,0.95,27,264,14.02,31,81426.0,17:37,0,3,3,0.0,32,18,35,19,16,8,10,18,12221.0,2:38,0,0,0,620.0,0:8,900000
8475767,Joey,Hishon,1991-10-20,C,L,2014-15,13,1,1,2,0.15,-1,19,5.26,0,7888.0,10:6,35,43,78,44.87,3,7,5,2,3,0,0,0,755.0,0:58,0,0,0,9.0,0:0,850500
8475768,Jaden,Schwartz,1992-06-25,LW,L,2014-15,75,28,35,63,0.84,13,184,15.22,16,82107.0,18:14,68,78,146,46.58,54,46,59,26,33,8,8,16,10546.0,2:20,0,2,2,5088.0,1:7,2350000
8475770,Emerson,Etem,1992-06-16,RW,L,2014-15,45,5,5,10,0.22,-6,77,6.49,4,33058.0,12:14,2,2,4,50.0,63,20,12,11,1,0,0,0,802.0,0:17,0,0,0,1249.0,0:27,870000
8475772,Riley,Sheahan,1991-12-07,C,L,2014-15,79,13,23,36,0.46,-3,123,10.57,16,74145.0,15:38,484,486,970,49.9,21,20,22,28,-6,5,6,11,11355.0,2:23,0,0,0,2773.0,0:35,950000
8475774,Petter,Granberg,1992-08-27,D,R,2014-15,7,0,0,0,0.0,1,1,0.0,6,4806.0,11:26,0,0,0,0.0,16,7,2,3,-1,0,0,0,2.0,0:0,0,0,0,983.0,2:20,800000
8475775,Tye,McGinn,1990-07-29,LW,L,2014-15,51,2,5,7,0.14,0,60,3.33,21,30914.0,10:6,1,1,2,50.0,71,17,8,11,-3,0,0,0,256.0,0:5,0,0,0,61.0,0:1,600000
8475780,Chris,Wagner,1991-05-27,RW,R,2014-15,9,0,0,0,0.0,-2,7,0.0,2,4746.0,8:47,33,22,55,60.0,22,3,1,0,1,0,0,0,0.0,0:0,0,0,0,253.0,0:28,900000
8475784,Jeff,Skinner,1992-05-16,LW,L,2014-15,77,18,13,31,0.4,-24,235,7.66,18,74142.0,16:2,21,25,46,45.65,47,12,62,42,20,4,3,7,9734.0,2:6,0,0,0,41.0,0:0,5725000
8475790,Erik,Gudbranson,1992-01-07,D,R,2014-15,76,4,9,13,0.17,-4,110,3.64,58,84898.0,18:37,0,0,0,0.0,212,75,6,33,-27,0,4,4,4029.0,0:53,0,0,0,9948.0,2:10,2500000
8475791,Taylor,Hall,1991-11-14,LW,L,2014-15,53,14,24,38,0.72,-1,158,8.86,40,61119.0,19:13,45,53,98,45.92,67,37,35,56,-21,3,3,6,7962.0,2:30,0,0,0,770.0,0:14,6000000
8475792,Brett,Connolly,1992-05-02,RW,R,2014-15,55,12,5,17,0.31,3,83,14.46,48,40105.0,12:9,18,25,43,41.86,90,13,9,6,3,2,1,3,6516.0,1:58,0,0,0,146.0,0:2,850500
8475793,Ryan,Johansen,1992-07-31,C,R,2014-15,82,26,45,71,0.87,-6,202,12.87,40,95951.0,19:30,851,787,1638,51.95,84,33,60,53,7,7,19,26,14115.0,2:52,2,0,2,6596.0,1:20,4000000
8475794,Tyler,Seguin,1992-01-31,C,R,2014-15,71,37,40,77,1.08,-1,280,13.21,20,83288.0,19:33,275,236,511,53.82,63,26,45,45,0,13,16,29,16461.0,3:51,0,0,0,237.0,0:3,5750000
8475796,Mark,Pysyk,1992-01-11,D,R,2014-15,7,2,1,3,0.43,4,4,50.0,2,7635.0,18:10,0,0,0,0.0,1,11,1,2,-1,0,0,0,164.0,0:23,0,0,0,393.0,0:56,900000
8475797,Jarred,Tinordi,1992-02-20,D,L,2014-15,13,0,2,2,0.15,-5,5,0.0,19,9412.0,12:4,0,0,0,0.0,20,18,1,4,-3,0,0,0,0.0,0:0,0,0,0,297.0,0:22,870000
8475798,Mikael,Granlund,1992-02-26,RW,L,2014-15,68,8,31,39,0.57,17,99,8.08,20,73019.0,17:53,476,508,984,48.37,47,45,34,24,10,0,8,8,8813.0,2:9,0,0,0,1791.0,0:26,900000
8475799,Nino,Niederreiter,1992-09-08,RW,L,2014-15,80,24,13,37,0.46,2,149,16.11,28,69817.0,14:32,2,5,7,28.57,155,32,28,16,12,6,2,8,7426.0,1:32,1,0,1,2163.0,0:27,2666667
8475800,Teemu,Pulkkinen,1992-01-02,LW,R,2014-15,31,5,3,8,0.26,5,67,7.46,10,21344.0,11:28,0,0,0,0.0,3,4,2,4,-2,1,1,2,4480.0,2:24,0,0,0,0.0,0:0,698333
8475807,Joakim,Nordstrom,1992-02-25,LW,L,2014-15,38,0,3,3,0.08,-5,42,0.0,4,25008.0,10:58,2,8,10,20.0,73,17,12,3,9,0,0,0,97.0,0:2,0,0,0,1338.0,0:35,616667
8475808,Michael,Chaput,1992-04-09,C,L,2014-15,33,1,4,5,0.15,-8,23,4.35,21,20194.0,10:11,143,151,294,48.64,59,20,4,3,1,0,0,0,144.0,0:4,0,0,0,1883.0,0:57,706667
8475810,Bryan,Rust,1992-05-11,RW,R,2014-15,14,1,1,2,0.14,-3,34,2.94,4,10102.0,12:1,0,0,0,0.0,21,3,2,6,-4,0,0,0,412.0,0:29,0,0,0,12.0,0:0,652500
8475816,Stanislav,Galiev,1992-01-17,RW,R,2014-15,2,1,0,1,0.5,1,2,50.0,0,1126.0,9:23,0,0,0,0.0,3,0,2,1,1,0,0,0,18.0,0:9,0,0,0,0.0,0:0,595000
8475826,Justin,Shugg,1991-12-24,RW,R,2014-15,3,0,0,0,0.0,0,3,0.0,2,1025.0,5:41,0,0,0,0.0,3,0,0,1,-1,0,0,0,7.0,0:2,0,0,0,0.0,0:0,600000
8475829,John,Ramage,1991-02-07,D,R,2014-15,1,0,0,0,0.0,-1,4,0.0,0,1090.0,18:10,0,0,0,0.0,2,1,0,0,0,0,0,0,0.0,0:0,0,0,0,0.0,0:0,690000
8475842,Sam,Carrick,1992-02-04,C,R,2014-15,16,1,1,2,0.12,1,17,5.88,9,6225.0,6:29,38,53,91,41.76,30,1,7,1,6,0,0,0,0.0,0:0,0,0,0,160.0,0:10,631667
8475848,Brendan,Gallagher,1992-05-06,RW,R,2014-15,82,24,23,47,0.57,18,254,9.45,31,81612.0,16:35,43,56,99,43.43,48,49,43,18,25,3,5,8,12020.0,2:26,0,0,0,153.0,0:1,685000
8475855,Jesper,Fast,1991-12-02,RW,R,2014-15,58,6,8,14,0.24,-1,52,11.54,8,41079.0,11:48,4,16,20,20.0,102,28,13,5,8,0,1,1,132.0,0:2,0,0,0,3830.0,1:6,805000
8475868,Anthony,Bitetto,1990-07-15,D,L,2014-15,7,0,0,0,0.0,-1,2,0.0,7,4947.0,11:46,1,0,1,100.0,9,3,1,3,-2,0,0,0,15.0,0:2,0,0,0,14.0,0:2,605000
8475869,Brandon,Davidson,1991-08-21,D,L,2014-15,12,1,0,1,0.08,-5,7,14.29,0,10899.0,15:8,0,0,0,0.0,18,22,0,4,-4,0,0,0,29.0,0:2,0,0,0,980.0,1:21,615000
8475878,Freddie,Hamilton,1992-01-01,C,R,2014-15,18,1,0,1,0.06,-2,11,9.09,0,8183.0,7:34,24,37,61,39.34,25,3,2,1,1,0,0,0,165.0,0:9,0,0,0,125.0,0:6,626667
8475902,Zach,Trotman,1990-08-26,D,R,2014-15,27,1,4,5,0.19,-2,46,2.17,0,26581.0,16:24,0,0,0,0.0,44,33,2,6,-4,0,0,0,1151.0,0:42,0,0,0,1254.0,0:46,625000
8475906,John,Klingberg,1992-08-14,D,R,2014-15,65,11,29,40,0.62,5,98,11.22,32,85182.0,21:50,0,0,0,0.0,54,77,32,59,-27,2,10,12,11462.0,2:56,0,0,0,590.0,0:9,713333
8475907,Micheal,Ferland,1992-04-20,LW,L,2014-15,26,2,3,5,0.19,1,34,5.88,16,16417.0,10:31,0,0,0,0.0,67,10,19,11,8,0,1,1,545.0,0:20,0,0,0,41.0,0:1,611667
8475913,Mark,Stone,1992-05-13,RW,R,2014-15,80,26,38,64,0.8,21,157,16.56,14,81702.0,17:1,7,11,18,38.89,49,53,98,43,55,5,8,13,11490.0,2:23,1,0,1,6697.0,1:23,603333
8475917,Jason,Akeson,1990-06-03,RW,R,2014-15,13,0,0,0,0.0,-1,9,0.0,8,6279.0,8:3,1,1,2,50.0,11,4,1,3,-2,0,0,0,177.0,0:13,0,0,0,7.0,0:0,575000
8475958,Michael,Sgarbossa,1992-07-25,C,L,2014-15,3,0,1,1,0.33,0,2,0.0,10,1277.0,7:5,9,11,20,45.0,0,1,0,0,0,0,0,0,1.0,0:0,0,0,0,0.0,0:0,556667
8475996,Brendan,Shinnimin,1991-01-07,C,L,2014-15,12,0,1,1,0.08,-1,10,0.0,8,7945.0,11:2,42,59,101,41.58,12,4,4,4,0,0,0,0,80.0,0:6,0,0,0,0.0,0:0,667500
8476043,Ben,Street,1987-02-13,C,L,2014-15,3,0,0,0,0.0,0,4,0.0,0,2087.0,11:35,17,15,32,53.12,3,0,1,2,-1,0,0,0,0.0,0:0,0,0,0,0.0,0:0,650000
8476062,Mark,Arcobello,1988-08-12,RW,R,2014-15,77,17,14,31,0.4,-10,129,13.18,20,68407.0,14:48,471,468,939,50.16,111,27,39,43,-4,1,3,4,4017.0,0:52,0,1,1,2687.0,0:34,600000
8476116,Ryan,Garbutt,1985-08-12,C,L,2014-15,67,8,17,25,0.37,-9,143,5.59,55,54535.0,13:33,16,9,25,64.0,82,48,27,21,6,0,0,0,440.0,0:6,1,0,1,6252.0,1:33,1800000
8476147,Kael,Mouillierat,1987-12-09,LW,L,2014-15,6,1,1,2,0.33,-3,1,100.0,8,3124.0,8:40,16,18,34,47.06,8,3,4,0,4,0,0,0,9.0,0:1,0,0,0,0.0,0:0,675000
8476158,Harry,Zolnierczyk,1987-09-01,LW,L,2014-15,2,0,0,0,0.0,-1,1,0.0,0,1335.0,11:7,0,2,2,0.0,6,1,1,0,1,0,0,0,0.0,0:0,0,0,0,89.0,0:44,650000
8476162,Steve,Oleksy,1986-02-04,D,R,2014-15,1,0,0,0,0.0,-1,1,0.0,0,731.0,12:11,0,0,0,0.0,2,0,0,0,0,0,0,0,0.0,0:0,0,0,0,0.0,0:0,541667
8476166,Taylor,Fedun,1988-06-04,D,R,2014-15,7,0,4,4,0.57,0,12,0.0,4,7135.0,16:59,0,0,0,0.0,0,8,3,2,1,0,2,2,768.0,1:49,0,0,0,99.0,0:14,575000
8476177,Matt,Read,1986-06-14,RW,R,2014-15,80,8,22,30,0.38,-4,142,5.63,14,84319.0,17:33,11,10,21,52.38,108,55,32,33,-1,2,3,5,7735.0,1:36,0,1,1,9641.0,2:0,3625000
8476179,Will,Acton,1987-07-16,C,L,2014-15,3,0,0,0,0.0,-2,2,0.0,5,1928.0,10:42,4,4,8,50.0,3,3,2,0,2,0,0,0,3.0,0:1,0,0,0,243.0,1:21,680000
8476191,Kevan,Miller,1987-11-15,D,R,2014-15,41,2,5,7,0.17,20,37,5.41,15,44362.0,18:2,0,0,0,0.0,87,60,7,15,-8,0,0,0,15.0,0:0,0,0,0,6899.0,2:48,800000
8476195,Cory,Conacher,1989-12-14,C,L,2014-15,15,1,2,3,0.2,-3,23,4.35,14,12132.0,13:28,1,2,3,33.33,19,7,6,3,3,0,0,0,689.0,0:45,0,0,0,11.0,0:0,600000
8476207,Brian,Gibbons,1988-02-26,LW,L,2014-15,25,0,5,5,0.2,2,21,0.0,8,20735.0,13:49,4,5,9,44.44,14,17,7,5,2,0,1,1,987.0,0:39,0,0,0,2751.0,1:50,750000
8476209,Mike,Sislo,1988-01-20,RW,R,2014-15,10,0,1,1,0.1,-2,13,0.0,2,7327.0,12:12,0,0,0,0.0,12,2,2,0,2,0,0,0,2.0,0:0,0,0,0,811.0,1:21,562500
8476214,Brandon,DeFazio,1988-09-13,LW,L,2014-15,2,0,0,0,0.0,0,2,0.0,0,713.0,5:56,0,0,0,0.0,0,0,1,0,1,0,0,0,0.0,0:0,0,0,0,0.0,0:0,600000
8476227,Joe,Whitney,1988-02-06,RW,L,2014-15,4,1,0,1,0.25,-1,1,100.0,0,1650.0,6:52,0,0,0,0.0,5,0,0,0,0,0,0,0,0.0,0:0,0,0,0,3.0,0:0,567500
8476235,Justin,Fontaine,1987-11-06,RW,R,2014-15,71,9,22,31,0.44,13,104,8.65,12,50930.0,11:57,1,1,2,50.0,9,27,22,13,9,0,2,2,1497.0,0:21,0,0,0,2570.0,0:36,1000000
8476244,Raphael,Diaz,1986-01-09,D,R,2014-15,56,2,2,4,0.07,-3,52,3.85,10,40397.0,12:1,0,0,0,0.0,24,67,12,17,-5,1,0,1,3287.0,0:58,0,0,0,18.0,0:0,700000
8476279,Jyrki,Jokipakka,1991-08-20,D,L,2014-15,51,0,10,10,0.2,-2,40,0.0,8,50523.0,16:30,0,0,0,0.0,42,66,16,37,-21,0,0,0,178.0,0:3,0,0,0,2985.0,0:58,666667
8476289,Alexey,Marchenko,1992-01-02,D,R,2014-15,13,1,1,2,0.15,1,7,14.29,2,12036.0,15:25,0,0,0,0.0,9,10,4,4,0,0,0,0,91.0,0:7,0,0,0,567.0,0:43,666667
8476292,Ondrej,Palat,1991-03-28,LW,L,2014-15,75,16,47,63,0.84,31,139,11.51,24,78441.0,17:25,10,25,35,28.57,124,50,43,43,0,3,8,11,10541.0,2:20,1,1,2,7984.0,1:46,3333333
8476300,Nikita,Nesterov,1993-03-28,D,L,2014-15,27,2,5,7,0.26,6,44,4.55,16,26008.0,16:3,0,0,0,0.0,42,17,16,14,2,1,1,2,872.0,0:32,0,0,0,306.0,0:11,742500
8476302,Frank,Corrado,1993-03-26,D,R,2014-15,10,1,0,1,0.1,-7,8,12.5,0,9401.0,15:40,0,0,0,0.0,15,12,1,5,-4,0,0,0,207.0,0:20,0,0,0,187.0,0:18,591667
8476312,Josh,Manson,1991-10-07,D,R,2014-15,28,0,3,3,0.11,1,26,0.0,31,30969.0,18:26,0,0,0,0.0,44,24,9,17,-8,0,0,0,87.0,0:3,0,0,0,2642.0,1:34,925000
8476336,Iiro,Pakarinen,1991-08-25,RW,R,2014-15,17,1,2,3,0.18,-4,34,2.94,2,10338.0,10:8,1,0,1,100.0,51,3,0,2,-2,0,2,2,896.0,0:52,0,0,0,32.0,0:1,817500
8476344,Tyler,Graovac,1993-04-27,C,L,2014-15,3,0,0,0,0.0,0,4,0.0,0,1660.0,9:13,6,16,22,27.27,0,2,2,0,2,0,0,0,0.0,0:0,0,0,0,0.0,0:0,747500
8476346,Johnny,Gaudreau,1993-08-13,LW,L,2014-15,80,24,40,64,0.8,11,167,14.37,14,85041.0,17:43,3,5,8,37.5,14,27,67,78,-11,8,13,21,13457.0,2:48,0,0,0,26.0,0:0,925000
8476356,Tobias,Rieder,1993-01-10,C,L,2014-15,72,13,8,21,0.29,-19,189,6.88,14,72994.0,16:53,1,4,5,20.0,123,37,40,11,29,0,2,2,6083.0,1:24,3,0,3,5487.0,1:16,853333
8476363,Brian,Ferlin,1992-06-03,RW,R,2014-15,7,0,1,1,0.14,0,6,0.0,0,3694.0,8:47,0,1,1,0.0,20,0,1,0,1,0,0,0,26.0,0:3,0,0,0,0.0,0:0,875000
8476381,Andrew,Shaw,1991-07-20,RW,R,2014-15,79,15,11,26,0.33,-8,146,10.27,67,70852.0,14:56,357,355,712,50.14,127,33,17,16,1,5,1,6,12958.0,2:44,0,0,0,428.0,0:5,2000000
8476386,Shane,Prince,1992-11-16,LW,L,2014-15,2,0,1,1,0.5,1,2,0.0,0,1257.0,10:28,0,0,0,0.0,2,0,0,0,0,0,0,0,0.0,0:0,0,0,0,0.0,0:0,876667
8476389,Vincent,Trocheck,1993-07-11,C,R,2014-15,50,7,15,22,0.44,9,89,7.87,24,42016.0,14:0,234,247,481,48.65,93,19,21,8,13,1,0,1,2718.0,0:54,0,0,0,300.0,0:6,661667
8476392,Adam,Lowry,1993-03-29,C,L,2014-15,80,11,12,23,0.29,1,104,10.58,46,66015.0,13:45,402,449,851,47.24,256,32,25,14,11,0,3,3,2715.0,0:33,1,0,1,3046.0,0:38,828333
8476393,Nick,Cousins,1993-07-20,C,L,2014-15,11,0,0,0,0.0,1,6,0.0,2,5819.0,8:49,23,29,52,44.23,13,5,5,2,3,0,0,0,115.0,0:10,0,0,0,0.0,0:0,842500
8476394,Michael,Paliotta,1993-04-06,D,R,2014-15,1,0,1,1,1.0,0,2,0.0,0,765.0,12:45,0,0,0,0.0,0,2,0,0,0,0,0,0,0.0,0:0,0,0,0,0.0,0:0,925000
8476403,Klas,Dahlbeck,1991-07-06,D,L,2014-15,23,1,3,4,0.17,-8,20,5.0,8,24370.0,17:39,0,0,0,0.0,64,46,9,4,5,0,0,0,6.0,0:0,0,0,0,3581.0,2:35,613333
8476404,Andy,Andreoff,1991-05-17,LW,L,2014-15,18,2,1,3,0.17,1,14,14.29,18,9254.0,8:34,32,29,61,52.46,33,0,7,4,3,0,0,0,112.0,0:6,0,0,0,10.0,0:0,550000
8476406,Nick,Shore,1992-09-26,C,R,2014-15,34,1,6,7,0.21,0,33,3.03,10,22617.0,11:5,127,109,236,53.81,51,14,8,2,6,0,1,1,628.0,0:18,0,0,0,820.0,0:24,925000
8476410,Josh,Leivo,1993-05-26,LW,R,2014-15,9,1,0,1,0.11,-1,10,10.0,4,4133.0,7:39,0,2,2,0.0,5,0,7,0,7,0,0,0,53.0,0:5,0,0,0,0.0,0:0,792500
8476419,Jean-Gabriel,Pageau,1992-11-11,C,R,2014-15,50,10,9,19,0.38,4,97,10.31,9,42562.0,14:11,335,346,681,49.19,158,20,19,13,6,0,0,0,529.0,0:10,2,0,2,5861.0,1:57,613333
8476423,Reid,Boucher,1993-09-08,C,L,2014-15,11,1,0,1,0.09,-4,20,5.0,0,7352.0,11:8,0,0,0,0.0,9,5,7,1,6,0,0,0,54.0,0:4,0,0,0,0.0,0:0,692500
8476426,David,Musil,1993-04-09,D,L,2014-15,4,0,2,2,0.5,-2,3,0.0,2,4753.0,19:48,0,0,0,0.0,5,8,1,2,-1,0,0,0,18.0,0:4,0,0,0,354.0,1:28,894167
8476427,Ty,Rattie,1993-02-05,RW,R,2014-15,11,0,2,2,0.18,0,8,0.0,2,6006.0,9:6,0,0,0,0.0,15,4,0,0,0,0,0,0,409.0,0:37,0,0,0,0.0,0:0,772500
8476428,Rocco,Grimaldi,1993-02-08,C,R,2014-15,7,1,0,1,0.14,1,18,5.56,4,5296.0,12:36,6,8,14,42.86,7,1,3,0,3,0,0,0,158.0,0:22,0,0,0,0.0,0:0,925000
8476430,Tomas,Jurco,1992-12-28,LW,L,2014-15,63,3,15,18,0.29,6,92,3.26,14,43508.0,11:30,0,2,2,0.0,97,11,19,16,3,1,1,2,4293.0,1:8,0,0,0,0.0,0:0,709167
8476431,Adam,Clendening,1992-10-26,D,R,2014-15,21,1,3,4,0.19,2,17,5.88,10,20963.0,16:38,0,0,0,0.0,9,22,2,14,-12,1,2,3,2607.0,2:4,0,0,0,44.0,0:2,742500
8476432,Boone,Jenner,1993-06-15,C,L,2014-15,31,9,8,17,0.55,-5,83,10.84,12,33982.0,18:16,151,155,306,49.35,102,25,18,17,1,2,3,5,4095.0,2:12,0,0,0,2411.0,1:17,778333
8476435,Alex,Khokhlachev,1993-09-09,C,L,2014-15,3,0,0,0,0.0,-2,1,0.0,0,1476.0,8:12,9,8,17,52.94,1,0,0,1,-1,0,0,0,170.0,0:56,0,0,0,0.0,0:0,786667
8476436,Dmitrij,Jaskin,1993-03-23,RW,L,2014-15,54,13,5,18,0.33,7,108,12.04,16,43636.0,13:28,3,4,7,42.86,146,21,16,11,5,3,0,3,3442.0,1:3,0,0,0,95.0,0:1,772500
8476437,Victor,Rask,1993-03-01,C,L,2014-15,80,11,22,33,0.41,-14,172,6.4,16,78416.0,16:20,468,450,918,50.98,42,36,46,34,12,2,9,11,11994.0,2:29,0,0,0,2117.0,0:26,680833
8476438,Brandon,Saad,1992-10-27,LW,L,2014-15,82,23,29,52,0.63,7,203,11.33,12,84886.0,17:15,38,50,88,43.18,53,29,46,29,17,2,8,10,10782.0,2:11,0,0,0,5319.0,1:4,764167
8476439,Brett,Ritchie,1993-07-01,RW,R,2014-15,31,6,3,9,0.29,-1,78,7.69,12,26014.0,13:59,1,3,4,25.0,89,5,9,10,-1,0,1,1,4269.0,2:17,0,0,0,5.0,0:0,814167
8476440,Markus,Granlund,1993-04-16,C,L,2014-15,48,8,10,18,0.38,-4,65,12.31,16,38504.0,13:22,193,331,524,36.83,44,24,27,16,11,1,1,2,1487.0,0:30,0,0,0,2515.0,0:52,767500
8476442,Matt,Nieto,1992-11-05,LW,L,2014-15,72,10,17,27,0.38,-12,135,7.41,20,65903.0,15:15,0,1,1,0.0,24,38,38,36,2,1,3,4,4134.0,0:57,0,1,1,4342.0,1:0,759167
8476443,Xavier,Ouellet,1993-07-29,D,L,2014-15,21,2,1,3,0.14,4,27,7.41,2,20652.0,16:23,0,0,0,0.0,11,13,2,8,-6,0,0,0,185.0,0:8,0,0,0,707.0,0:33,670000
8476447,Miikka,Salomaki,1993-03-09,RW,L,2014-15,1,1,0,1,1.0,1,4,25.0,0,649.0,10:49,0,0,0,0.0,7,1,0,0,0,0,0,0,0.0,0:0,0,0,0,55.0,0:55,780833
8476448,William,Karlsson,1993-01-08,C,L,2014-15,21,3,2,5,0.24,3,29,10.34,2,15412.0,12:13,93,104,197,47.21,18,7,8,9,-1,0,1,1,2423.0,1:55,0,0,0,28.0,0:1,830833
8476449,Scott,Harrington,1993-03-10,D,L,2014-15,10,0,0,0,0.0,-10,9,0.0,4,9480.0,15:48,0,0,0,0.0,12,10,1,1,0,0,0,0,258.0,0:25,0,0,0,738.0,1:13,589167
8476451,Lucas,Lessio,1993-01-23,LW,L,2014-15,26,2,3,5,0.19,-10,44,4.55,8,19899.0,12:45,0,2,2,0.0,59,6,7,7,0,0,0,0,431.0,0:16,0,0,0,0.0,0:0,830833
8476452,Tyler,Wotherspoon,1993-03-12,D,L,2014-15,1,0,0,0,0.0,-3,1,0.0,0,1219.0,20:19,0,0,0,0.0,0,2,0,0,0,0,0,0,0.0,0:0,0,0,0,276.0,4:36,925000
8476453,Nikita,Kucherov,1993-06-17,RW,L,2014-15,82,29,36,65,0.79,38,191,15.18,37,73559.0,14:57,0,2,2,0.0,65,28,22,47,-25,2,13,15,10861.0,2:12,0,0,0,132.0,0:1,711667
8476454,Ryan,Nugent-Hopkins,1993-04-12,C,L,2014-15,76,24,32,56,0.74,-12,189,12.7,25,94123.0,20:38,620,736,1356,45.72,92,37,54,43,11,2,12,14,12396.0,2:43,0,1,1,7485.0,1:38,6000000
8476455,Gabriel,Landeskog,1992-11-23,LW,L,2014-15,82,23,36,59,0.72,-2,214,10.75,79,91047.0,18:30,16,29,45,35.56,169,73,52,34,18,8,9,17,12247.0,2:29,0,0,0,2269.0,0:27,5571429
8476456,Jonathan,Huberdeau,1993-06-04,LW,L,2014-15,79,15,39,54,0.68,10,169,8.88,38,79385.0,16:44,2,6,8,25.0,68,24,34,23,11,0,12,12,11121.0,2:20,0,0,0,620.0,0:7,894167
8476457,Adam,Larsson,1992-11-12,D,R,2014-15,64,3,21,24,0.38,2,91,3.3,34,80497.0,20:57,0,0,0,0.0,92,120,21,30,-9,0,0,0,1224.0,0:19,0,3,3,12145.0,3:9,900000
8476458,Ryan,Strome,1993-07-11,C,R,2014-15,81,17,33,50,0.62,23,179,9.5,47,74834.0,15:23,149,170,319,46.71,92,21,38,52,-14,1,7,8,10326.0,2:7,1,0,1,2990.0,0:36,863333
8476459,Mika,Zibanejad,1993-04-18,C,R,2014-15,80,20,26,46,0.57,0,150,13.33,20,78899.0,16:26,615,646,1261,48.77,149,26,34,27,7,4,10,14,12903.0,2:41,0,0,0,1440.0,0:18,894167
8476460,Mark,Scheifele,1993-03-15,C,R,2014-15,82,15,34,49,0.6,11,170,8.82,24,91455.0,18:35,492,656,1148,42.86,100,61,54,45,9,3,10,13,11872.0,2:24,0,0,0,2480.0,0:30,863333
8476461,Sean,Couturier,1992-12-07,C,L,2014-15,82,15,22,37,0.45,4,148,10.14,28,90470.0,18:23,643,687,1330,48.35,72,35,40,30,10,1,5,6,7722.0,1:34,1,1,2,11409.0,2:19,1750000
8476462,Dougie,Hamilton,1993-06-17,D,R,2014-15,72,10,32,42,0.58,-3,188,5.32,41,92171.0,21:20,0,0,0,0.0,106,53,24,45,-21,5,10,15,10822.0,2:30,0,0,0,5026.0,1:9,925000
8476463,Jonas,Brodin,1993-07-12,D,L,2014-15,71,3,14,17,0.24,21,95,3.16,8,102978.0,24:10,0,0,0,0.0,31,128,33,33,0,0,2,2,4064.0,0:57,0,1,1,9584.0,2:14,925000
8476465,Ryan,Murphy,1993-03-31,D,R,2014-15,37,4,9,13,0.35,-11,61,6.56,8,40605.0,18:17,0,0,0,0.0,20,37,20,30,-10,3,2,5,4627.0,2:5,0,0,0,82.0,0:2,863333
8476466,Sven,Baertschi,1992-10-05,LW,L,2014-15,18,2,4,6,0.33,-3,15,13.33,10,10456.0,9:40,0,0,0,0.0,8,7,7,5,2,0,0,0,279.0,0:15,0,0,0,0.0,0:0,894167
8476467,Jamie,Oleksiak,1992-12-21,D,L,2014-15,36,1,7,8,0.22,0,36,2.78,8,28942.0,13:23,0,0,0,0.0,82,46,9,22,-13,0,0,0,127.0,0:3,0,0,0,2312.0,1:4,894167
8476468,J.T.,Miller,1993-03-14,C,L,2014-15,58,10,13,23,0.4,5,92,10.87,23,44195.0,12:41,93,112,205,45.37,89,28,27,23,4,2,1,3,3117.0,0:53,0,0,0,70.0,0:1,894167
8476470,Nathan,Beaulieu,1992-12-05,D,L,2014-15,64,1,8,9,0.14,6,62,1.61,45,60285.0,15:41,0,0,0,0.0,50,69,8,47,-39,0,2,2,2849.0,0:44,0,0,0,957.0,0:14,925000
8476472,Oscar,Klefbom,1993-07-20,D,L,2014-15,60,2,18,20,0.33,-21,98,2.04,4,79196.0,21:59,0,0,0,0.0,45,102,48,48,0,0,2,2,1651.0,0:27,0,0,0,6289.0,1:44,894167
8476473,Connor,Murphy,1993-03-26,D,R,2014-15,73,4,3,7,0.1,-27,72,5.56,42,73587.0,16:48,0,1,1,0.0,137,142,8,25,-17,0,0,0,227.0,0:3,0,0,0,7557.0,1:43,863333
8476476,Joe,Morrow,1992-12-09,D,L,2014-15,15,1,0,1,0.07,3,20,5.0,4,15021.0,16:41,0,0,0,0.0,18,22,2,3,-1,0,0,0,330.0,0:22,0,0,0,431.0,0:28,863333
8476477,Matt,Puempel,1993-01-24,LW,L,2014-15,13,2,1,3,0.23,6,14,14.29,8,6265.0,8:1,0,1,1,0.0,9,1,3,0,3,0,0,0,0.0,0:0,0,0,0,31.0,0:2,863333
8476478,Stuart,Percy,1993-05-18,D,L,2014-15,9,0,3,3,0.33,-4,13,0.0,2,9762.0,18:4,0,0,0,0.0,14,13,7,12,-5,0,2,2,789.0,1:27,0,0,0,941.0,1:44,863333
8476479,Phillip,Danault,1993-02-24,C,L,2014-15,2,0,0,0,0.0,0,2,0.0,0,1140.0,9:30,6,14,20,30.0,3,0,0,0,0,0,0,0,142.0,1:11,0,0,0,0.0,0:0,863333
8476480,Vladislav,Namestnikov,1992-11-22,C,L,2014-15,43,9,7,16,0.37,1,46,19.57,13,30948.0,11:59,70,85,155,45.16,41,13,16,9,7,1,1,2,2001.0,0:46,0,0,0,1175.0,0:27,925000
8476482,Nicklas,Jensen,1993-03-06,RW,L,2014-15,5,0,0,0,0.0,-1,7,0.0,0,2867.0,9:33,0,0,0,0.0,7,4,0,1,-1,0,0,0,36.0,0:7,0,0,0,0.0,0:0,863333
8476483,Rickard,Rakell,1993-05-05,C,R,2014-15,71,9,22,31,0.44,6,105,8.57,10,53557.0,12:34,310,355,665,46.62,79,22,18,33,-15,2,7,9,5536.0,1:17,0,0,0,36.0,0:0,894167
8476495,Seth,Griffith,1993-01-04,C,R,2014-15,30,6,4,10,0.33,-2,33,18.18,6,24198.0,13:26,3,6,9,33.33,14,13,12,6,6,1,2,3,3168.0,1:45,0,0,0,28.0,0:0,759167
8476536,Colin,Smith,1993-06-20,C,R,2014-15,1,0,0,0,0.0,0,1,0.0,0,366.0,6:6,4,6,10,40.0,1,0,0,1,-1,0,0,0,0.0,0:0,0,0,0,0.0,0:0,628333
8476539,Jonathan,Marchessault,1990-12-27,C,R,2014-15,2,1,0,1,0.5,1,3,33.33,0,1433.0,11:56,1,2,3,33.33,4,0,1,0,1,0,0,0,93.0,0:46,0,0,0,0.0,0:0,925000
8476549,Daniil,Tarasov,1991-06-20,RW,L,2014-15,5,0,1,1,0.2,2,5,0.0,0,2271.0,7:34,1,0,1,100.0,2,1,1,0,1,0,0,0,114.0,0:22,0,0,0,0.0,0:0,680000
8476624,Barclay,Goodrow,1993-02-26,RW,L,2014-15,60,4,8,12,0.2,-1,68,5.88,35,39858.0,11:4,12,11,23,52.17,76,24,27,24,3,0,0,0,976.0,0:16,0,1,1,1627.0,0:27,626667
8476769,Bobby,Farnham,1989-01-21,RW,L,2014-15,11,0,0,0,0.0,0,6,0.0,24,4736.0,7:10,0,0,0,0.0,26,2,0,1,-1,0,0,0,92.0,0:8,0,0,0,0.0,0:0,550000
8476779,Brad,Hunt,1988-08-24,D,L,2014-15,11,1,2,3,0.27,-6,20,5.0,0,12860.0,19:29,0,0,0,0.0,8,10,6,6,0,1,0,1,1664.0,2:31,0,0,0,482.0,0:43,550000
8476792,Torey,Krug,1991-04-12,D,L,2014-15,78,12,27,39,0.5,13,205,5.85,20,91700.0,19:35,0,0,0,0.0,75,68,15,31,-16,2,12,14,12254.0,2:37,0,0,0,919.0,0:11,1400000
8476798,Karl,Stollery,1987-11-21,D,L,2014-15,10,0,0,0,0.0,-1,9,0.0,6,8837.0,14:43,0,0,0,0.0,23,21,1,7,-6,0,0,0,40.0,0:4,0,0,0,651.0,1:5,605000
8476799,Cameron,Schilling,1988-10-07,D,L,2014-15,4,0,0,0,0.0,1,2,0.0,4,2730.0,11:22,0,0,0,0.0,4,2,0,0,0,0,0,0,0.0,0:0,0,0,0,5.0,0:1,625000
8476806,J.T.,Brown,1990-07-02,RW,R,2014-15,52,3,6,9,0.17,-2,74,4.05,30,33093.0,10:36,6,7,13,46.15,43,20,7,18,-11,0,0,0,153.0,0:2,0,0,0,3345.0,1:4,950000
8476807,Matt,Tennyson,1990-04-23,D,R,2014-15,27,2,6,8,0.3,0,37,5.41,16,28459.0,17:34,0,0,0,0.0,48,34,11,18,-7,1,1,2,2926.0,1:48,0,1,1,743.0,0:27,625000
8476808,Brian,Flynn,1988-07-26,C,R,2014-15,63,5,12,17,0.27,-5,82,6.1,8,56368.0,14:54,172,187,359,47.91,44,46,12,17,-5,0,1,1,2967.0,0:47,0,2,2,7053.0,1:51,637500
8476822,Luke,Glendening,1989-04-28,RW,R,2014-15,82,12,6,18,0.22,5,104,11.54,34,72424.0,14:43,499,463,962,51.87,147,73,26,14,12,1,0,1,713.0,0:8,0,0,0,16607.0,3:22,628333
8476850,Ryan,Murray,1993-09-27,D,L,2014-15,12,1,2,3,0.25,1,8,12.5,8,13614.0,18:54,0,0,0,0.0,5,11,5,2,3,1,0,1,553.0,0:46,0,0,0,1245.0,1:43,894167
8476851,Alex,Galchenyuk,1994-02-12,LW,L,2014-15,80,20,26,46,0.57,8,163,12.27,39,78858.0,16:25,82,92,174,47.13,91,44,24,28,-4,3,9,12,10677.0,2:13,0,0,0,298.0,0:3,925000
8476852,Griffin,Reinhart,1994-01-24,D,L,2014-15,8,0,1,1,0.12,1,4,0.0,6,6803.0,14:10,0,0,0,0.0,14,8,0,2,-2,0,0,0,14.0,0:1,0,0,0,259.0,0:32,863333
8476853,Morgan,Rielly,1994-03-09,D,L,2014-15,81,8,21,29,0.36,-16,148,5.41,14,98841.0,20:20,0,0,0,0.0,98,103,41,63,-22,1,8,9,11888.0,2:26,0,0,0,3637.0,0:44,894167
8476854,Hampus,Lindholm,1994-01-20,D,L,2014-15,78,7,27,34,0.44,25,107,6.54,32,101838.0,21:45,0,5,5,0.0,59,77,29,68,-39,0,6,6,7587.0,1:37,0,0,0,9160.0,1:57,894167
8476855,Nail,Yakupov,1993-10-06,RW,L,2014-15,81,14,19,33,0.41,-35,191,7.33,18,75053.0,15:26,0,1,1,0.0,97,28,34,55,-21,5,5,10,9211.0,1:53,0,0,0,6.0,0:0,925000
8476856,Matt,Dumba,1994-07-25,D,R,2014-15,58,8,8,16,0.28,13,86,9.3,23,52236.0,15:0,0,0,0,0.0,42,51,9,28,-19,2,4,6,5475.0,1:34,0,0,0,1189.0,0:20,894167
8476868,Henrik,Samuelsson,1994-02-07,C,R,2014-15,3,0,0,0,0.0,-2,4,0.0,2,2388.0,13:16,2,0,2,100.0,5,0,1,0,1,0,0,0,373.0,2:4,0,0,0,0.0,0:0,894167
8476870,Stefan,Matteau,1994-02-23,C,L,2014-15,7,1,0,1,0.14,0,8,12.5,4,4986.0,11:52,0,0,0,0.0,17,1,2,3,-1,0,0,0,0.0,0:0,0,0,0,8.0,0:1,842500
8476871,Tanner,Pearson,1992-08-10,LW,L,2014-15,42,12,4,16,0.38,14,68,17.65,14,33496.0,13:17,5,3,8,62.5,46,9,18,14,4,1,0,1,3817.0,1:30,0,0,0,1145.0,0:27,735833
8476872,Scott,Laughton,1994-05-30,C,L,2014-15,31,2,4,6,0.19,-1,51,3.92,17,23658.0,12:43,134,149,283,47.35,58,11,11,12,-1,0,1,1,649.0,0:20,0,0,0,1786.0,0:57,863333
8476874,Olli,Maatta,1994-08-22,D,L,2014-15,20,1,8,9,0.45,1,27,3.7,10,24850.0,20:42,0,0,0,0.0,18,33,3,11,-8,0,2,2,1577.0,1:18,0,0,0,2852.0,2:22,894167
8476878,Zemgus,Girgensons,1994-01-05,C,L,2014-15,61,15,15,30,0.49,-16,115,13.04,25,69831.0,19:4,440,560,1000,44.0,127,62,19,12,7,1,3,4,7550.0,2:3,3,0,3,7570.0,2:4,894167
8476879,Cody,Ceci,1993-12-21,D,R,2014-15,81,5,16,21,0.26,-4,130,3.85,6,93749.0,19:17,0,0,0,0.0,89,113,14,41,-27,1,3,4,4913.0,1:0,0,0,0,11421.0,2:21,894167
8476880,Tom,Wilson,1994-03-29,RW,R,2014-15,67,4,13,17,0.25,-1,79,5.06,172,43966.0,10:56,2,9,11,18.18,205,24,20,10,10,0,0,0,202.0,0:3,0,0,0,46.0,0:0,894167
8476881,Tomas,Hertl,1993-11-12,C,L,2014-15,82,13,18,31,0.38,-5,145,8.97,16,71598.0,14:33,38,45,83,45.78,106,33,29,64,-35,3,3,6,7279.0,1:28,0,0,0,61.0,0:0,925000
8476882,Teuvo,Teravainen,1994-09-11,LW,L,2014-15,34,4,5,9,0.26,4,66,6.06,2,26080.0,12:47,29,33,62,46.77,11,14,11,15,-4,0,1,1,1542.0,0:45,0,0,0,50.0,0:1,894167
8476884,Derrick,Pouliot,1994-01-16,D,L,2014-15,34,2,5,7,0.21,-11,56,3.57,4,35795.0,17:32,0,0,0,0.0,15,20,11,18,-7,1,3,4,5080.0,2:29,0,0,0,158.0,0:4,863333
8476885,Jacob,Trouba,1994-02-26,D,R,2014-15,65,7,15,22,0.34,2,133,5.26,46,90934.0,23:18,0,1,1,0.0,97,120,28,76,-48,1,5,6,7575.0,1:56,0,0,0,13081.0,3:21,894167
8476886,Slater,Koekkoek,1994-02-18,D,L,2014-15,3,0,0,0,0.0,0,6,0.0,2,2985.0,16:35,0,0,0,0.0,2,3,1,0,1,0,0,0,2.0,0:0,0,0,0,137.0,0:45,894167
8476887,Filip,Forsberg,1994-08-13,LW,R,2014-15,82,26,37,63,0.77,15,237,10.97,24,85268.0,17:19,3,4,7,42.86,108,28,50,57,-7,6,13,19,13935.0,2:49,0,0,0,115.0,0:1,894167
8476888,Mikhail,Grigorenko,1994-05-16,C,L,2014-15,25,3,3,6,0.24,-10,35,8.57,2,22754.0,15:10,153,178,331,46.22,28,15,2,7,-5,1,1,2,1616.0,1:4,0,0,0,80.0,0:3,925000
8476906,Shayne,Gostisbehere,1993-04-20,D,L,2014-15,2,0,0,0,0.0,-2,2,0.0,0,1507.0,12:33,0,0,0,0.0,0,1,1,3,-2,0,0,0,260.0,2:10,0,0,0,0.0,0:0,925000
8476919,Chris,Tierney,1994-07-01,C,L,2014-15,43,6,15,21,0.49,3,48,12.5,6,31599.0,12:14,150,192,342,43.86,11,17,19,20,-1,1,3,4,1991.0,0:46,0,0,0,367.0,0:8,711667
8476921,Jordan,Martinook,1992-07-25,LW,L,2014-15,8,0,1,1,0.12,-3,8,0.0,0,5615.0,11:41,1,0,1,100.0,14,2,2,0,2,0,0,0,22.0,0:2,0,0,0,352.0,0:44,658250
8476923,Damon,Severson,1994-08-07,D,R,2014-15,51,5,12,17,0.33,-13,93,5.38,22,67207.0,21:57,0,1,1,0.0,19,34,14,38,-24,0,7,7,6383.0,2:5,0,0,0,3201.0,1:2,605833
8476931,Jake,McCabe,1993-10-12,D,L,2014-15,2,0,0,0,0.0,0,2,0.0,0,1335.0,11:7,0,0,0,0.0,4,1,0,0,0,0,0,0,62.0,0:31,0,0,0,38.0,0:19,925000
8476944,Brendan,Woods,1992-06-11,LW,L,2014-15,2,0,0,0,0.0,-1,3,0.0,0,724.0,6:2,0,0,0,0.0,2,0,0,0,0,0,0,0,0.0,0:0,0,0,0,0.0,0:0,725000
8476975,Cedric,Paquette,1993-08-13,C,L,2014-15,64,12,7,19,0.3,4,91,13.19,51,52265.0,13:36,112,123,235,47.66,127,58,24,23,1,0,0,0,176.0,0:2,2,0,2,7934.0,2:3,633333
8476981,Josh,Anderson,1994-05-07,RW,R,2014-15,6,0,1,1,0.17,-1,10,0.0,2,4842.0,13:27,0,0,0,0.0,24,2,3,3,0,0,0,0,8.0,0:1,0,0,0,0.0,0:0,678333
8476989,Petteri,Lindbohm,1993-09-23,D,L,2014-15,23,2,1,3,0.13,-1,32,6.25,26,21488.0,15:34,0,0,0,0.0,26,22,6,3,3,0,0,0,17.0,0:0,0,0,0,542.0,0:23,636667
8477059,Damien,Brunner,1986-03-09,RW,R,2014-15,17,2,5,7,0.41,-1,29,6.9,8,15450.0,15:8,2,2,4,50.0,7,3,6,6,0,0,4,4,2809.0,2:45,0,0,0,4.0,0:0,-111
8477070,Liam,O'Brien,1994-07-29,C,L,2014-15,13,1,1,2,0.15,4,16,6.25,23,5884.0,7:32,1,1,2,50.0,35,0,3,1,2,0,0,0,1.0,0:0,0,0,0,0.0,0:0,621667
8477126,Jayson,Megna,1990-02-01,C,R,2014-15,12,0,1,1,0.08,-2,13,0.0,14,7945.0,11:2,0,0,0,0.0,40,8,3,4,-1,0,0,0,49.0,0:4,0,0,0,332.0,0:27,874125
8477205,Andrej,Sustr,1990-11-29,D,R,2014-15,72,0,13,13,0.18,10,55,0.0,34,76474.0,17:42,0,0,0,0.0,39,84,17,28,-11,0,1,1,374.0,0:5,0,0,0,6381.0,1:28,874125
8477213,Tim,Schaller,1990-11-16,C,L,2014-15,18,1,1,2,0.11,-5,19,5.26,2,12255.0,11:20,74,112,186,39.78,44,14,3,3,0,0,0,0,62.0,0:3,0,0,0,1108.0,1:1,925000
8477214,Conor,Allen,1990-01-31,D,L,2014-15,4,0,0,0,0.0,-1,2,0.0,4,2928.0,12:12,0,0,0,0.0,6,0,0,3,-3,0,0,0,28.0,0:7,0,0,0,0.0,0:0,925000
8477215,Danny,DeKeyser,1990-03-07,D,L,2014-15,80,2,29,31,0.39,11,89,2.25,42,100451.0,20:55,0,0,0,0.0,74,88,14,38,-24,0,6,6,6350.0,1:19,0,0,0,11122.0,2:19,2187500
8477220,Nate,Schmidt,1991-07-16,D,L,2014-15,39,1,3,4,0.1,-2,40,2.5,10,32494.0,13:53,0,0,0,0.0,34,33,11,13,-2,0,0,0,20.0,0:0,0,0,0,377.0,0:9,625000
8477227,Eriah,Hayes,1988-07-07,RW,R,2014-15,4,0,0,0,0.0,-2,10,0.0,2,2393.0,9:58,1,0,1,100.0,7,4,1,1,0,0,0,0,21.0,0:5,0,0,0,0.0,0:0,655000
8477228,Matt,Lindblad,1990-03-23,C,L,2014-15,2,0,0,0,0.0,0,3,0.0,0,931.0,7:45,0,5,5,0.0,2,0,0,0,0,0,0,0,0.0,0:0,0,0,0,118.0,0:59,833750
8477244,Chad,Ruhwedel,1990-05-07,D,R,2014-15,4,0,1,1,0.25,3,4,0.0,0,2991.0,12:27,0,0,0,0.0,6,2,0,0,0,0,0,0,43.0,0:10,0,0,0,0.0,0:0,650000
8477249,Andrew,Miller,1988-09-18,C,R,2014-15,9,1,5,6,0.67,-2,14,7.14,0,7425.0,13:45,1,1,2,50.0,7,6,3,6,-3,0,0,0,0.0,0:0,0,0,0,8.0,0:0,675000
8477290,Michael,Raffl,1988-12-01,LW,L,2014-15,67,21,7,28,0.42,6,134,15.67,34,57067.0,14:11,44,53,97,45.36,172,46,21,18,3,2,0,2,1715.0,0:25,1,0,1,3764.0,0:56,1100000
8477407,Anthony,Duclair,1995-08-26,LW,L,2014-15,18,1,6,7,0.39,4,18,5.56,4,13129.0,12:9,0,0,0,0.0,6,5,5,6,-1,0,1,1,1524.0,1:24,0,0,0,0.0,0:0,772500
8477410,Bogdan,Yakimov,1994-10-04,C,L,2014-15,1,0,0,0,0.0,-1,1,0.0,0,679.0,11:19,3,4,7,42.86,2,0,0,0,0,0,0,0,0.0,0:0,0,0,0,0.0,0:0,842500
8477413,Sven,Andrighetto,1993-03-21,RW,L,2014-15,12,2,1,3,0.25,0,12,16.67,0,6778.0,9:24,3,12,15,20.0,5,4,1,2,-1,0,0,0,1113.0,1:32,0,0,0,0.0,0:0,633333
8477429,Andrew,Copp,1994-07-08,C,L,2014-15,1,0,1,1,1.0,2,4,0.0,0,796.0,13:16,6,3,9,66.67,0,0,0,0,0,0,0,0,34.0,0:34,0,0,0,21.0,0:21,925000
8477444,Andre,Burakovsky,1995-02-09,LW,L,2014-15,53,9,13,22,0.42,12,65,13.85,10,41088.0,12:55,74,93,167,44.31,22,18,18,17,1,2,1,3,3697.0,1:9,0,0,0,5.0,0:0,894167
8477448,Marko,Dano,1994-11-30,C,L,2014-15,35,8,13,21,0.6,12,84,9.52,14,27840.0,13:15,16,21,37,43.24,94,12,18,7,11,0,0,0,450.0,0:12,0,0,0,113.0,0:3,925000
8477451,Ryan,Hartman,1994-09-20,RW,R,2014-15,5,0,0,0,0.0,-1,8,0.0,2,2486.0,8:17,0,0,0,0.0,11,2,0,0,0,0,0,0,11.0,0:2,0,0,0,0.0,0:0,894167
8477455,Jacob,de la Rose,1995-05-20,LW,L,2014-15,33,4,2,6,0.18,-5,38,10.53,12,27321.0,13:47,64,96,160,40.0,71,24,6,13,-7,0,0,0,364.0,0:11,1,0,1,2297.0,1:9,925000
8477486,Emile,Poirier,1994-12-14,LW,L,2014-15,6,0,1,1,0.17,1,2,0.0,0,2874.0,7:59,0,1,1,0.0,7,1,3,0,3,0,0,0,72.0,0:12,0,0,0,0.0,0:0,894167
8477492,Nathan,MacKinnon,1995-09-01,C,R,2014-15,64,14,24,38,0.59,-7,192,7.29,34,65464.0,17:2,201,227,428,46.96,43,41,45,38,7,3,4,7,9345.0,2:26,0,0,0,190.0,0:2,925000
8477493,Aleksander,Barkov,1995-09-02,C,L,2014-15,71,16,20,36,0.51,-4,123,13.01,16,74545.0,17:29,462,540,1002,46.11,35,35,42,27,15,3,4,7,9655.0,2:15,0,0,0,1948.0,0:27,925000
8477494,Jonathan,Drouin,1995-03-28,LW,L,2014-15,70,4,28,32,0.46,3,76,5.26,34,55593.0,13:14,11,10,21,52.38,55,16,36,25,11,3,3,6,8024.0,1:54,0,0,0,255.0,0:3,894167
8477495,Seth,Jones,1994-10-03,D,R,2014-15,82,8,19,27,0.33,3,123,6.5,20,97824.0,19:52,0,0,0,0.0,72,90,41,46,-5,2,9,11,10748.0,2:11,1,0,1,8229.0,1:40,925000
8477496,Elias,Lindholm,1994-12-02,C,R,2014-15,81,17,22,39,0.48,-23,170,10.0,14,79818.0,16:25,115,105,220,52.27,106,30,36,42,-6,4,11,15,12196.0,2:30,0,0,0,195.0,0:2,925000
8477497,Sean,Monahan,1994-10-12,C,L,2014-15,81,31,31,62,0.77,8,191,16.23,12,95360.0,19:37,902,928,1830,49.29,39,42,81,52,29,10,9,19,13772.0,2:50,1,1,2,4072.0,0:50,925000
8477498,Darnell,Nurse,1995-02-04,D,L,2014-15,2,0,0,0,0.0,-2,2,0.0,0,2039.0,16:59,0,0,0,0.0,5,0,0,0,0,0,0,0,25.0,0:12,0,0,0,46.0,0:23,894167
8477499,Rasmus,Ristolainen,1994-10-27,D,R,2014-15,78,8,12,20,0.26,-32,121,6.61,26,96474.0,20:36,1,0,1,100.0,118,136,9,35,-26,4,5,9,9368.0,2:0,0,0,0,6129.0,1:18,925000
8477500,Bo,Horvat,1995-04-05,C,L,2014-15,68,13,12,25,0.37,-8,93,13.98,16,50036.0,12:15,436,412,848,51.42,70,47,13,10,3,0,0,0,1059.0,0:15,1,0,1,2899.0,0:42,894167
8477501,Valeri,Nichushkin,1995-03-04,RW,L,2014-15,8,0,1,1,0.12,-5,6,0.0,2,6611.0,13:46,0,0,0,0.0,7,1,5,6,-1,0,0,0,300.0,0:37,0,0,0,3.0,0:0,925000
8477505,Alexander,Wennberg,1994-09-22,C,L,2014-15,68,4,16,20,0.29,-19,85,4.71,22,63748.0,15:37,288,386,674,42.73,58,45,25,11,14,1,3,4,5892.0,1:26,0,0,0,7335.0,1:47,925000
8477507,Nikita,Zadorov,1995-04-16,D,L,2014-15,60,3,12,15,0.25,-10,52,5.77,51,63747.0,17:42,1,0,1,100.0,134,73,11,39,-28,2,3,5,5042.0,1:24,0,0,0,1435.0,0:23,894167
8477508,Curtis,Lazar,1995-02-02,C,R,2014-15,67,6,9,15,0.22,1,92,6.52,14,51845.0,12:53,129,144,273,47.25,167,40,24,13,11,0,0,0,539.0,0:8,0,0,0,2008.0,0:29,894167
8477509,Mirco,Mueller,1995-03-21,D,L,2014-15,39,1,3,4,0.1,-8,31,3.23,10,39689.0,16:57,0,0,0,0.0,49,58,19,21,-2,0,0,0,734.0,0:18,0,0,0,1859.0,0:47,894167
8477510,Kerby,Rychel,1994-10-07,LW,L,2014-15,5,0,3,3,0.6,3,4,0.0,2,3208.0,10:41,0,0,0,0.0,11,3,2,1,1,0,0,0,29.0,0:5,0,0,0,0.0,0:0,894167
8477589,Ronalds,Kenins,1991-02-28,LW,L,2014-15,30,4,8,12,0.4,-2,38,10.53,8,22083.0,12:16,0,0,0,0.0,71,7,13,9,4,0,0,0,171.0,0:5,0,0,0,12.0,0:0,680000
8477591,Josh,Jooris,1990-07-14,RW,R,2014-15,60,12,12,24,0.4,1,89,13.48,16,52170.0,14:29,276,291,567,48.68,59,29,39,29,10,4,1,5,2430.0,0:40,0,0,0,4038.0,1:7,925000
8477715,Tyler,Gaudet,1993-04-04,C,L,2014-15,2,0,0,0,0.0,-1,1,0.0,0,1149.0,9:34,9,8,17,52.94,2,1,1,0,1,0,0,0,0.0,0:0,0,0,0,22.0,0:11,925000
8477845,Trevor,van Riemsdyk,1991-07-24,D,R,2014-15,18,0,1,1,0.06,0,21,0.0,2,14619.0,13:32,0,0,0,0.0,4,15,9,4,5,0,0,0,176.0,0:9,0,0,0,182.0,0:10,925000
8477850,Christian,Folin,1991-02-09,D,R,2014-15,40,2,8,10,0.25,3,39,5.13,13,36480.0,15:12,0,0,0,0.0,46,42,9,16,-7,0,1,1,319.0,0:7,0,0,0,1349.0,0:33,925000
8477851,Jordan,Oesterle,1992-06-25,D,L,2014-15,6,0,1,1,0.17,-4,7,0.0,0,5290.0,14:41,0,0,0,0.0,2,3,2,1,1,0,0,0,321.0,0:53,0,0,0,54.0,0:9,767500
8477887,Patrick,Brown,1992-05-29,C,R,2014-15,7,0,0,0,0.0,-4,4,0.0,4,3730.0,8:52,0,2,2,0.0,11,2,1,0,1,0,0,0,24.0,0:3,0,0,0,111.0,0:15,652500
8477902,Dennis,Everberg,1991-12-31,RW,L,2014-15,55,3,9,12,0.22,-7,62,4.84,10,38943.0,11:48,0,3,3,0.0,73,41,20,11,9,0,0,0,779.0,0:14,0,0,0,1878.0,0:34,612500
8477913,David,Wolf,1989-09-15,LW,L,2014-15,3,0,0,0,0.0,0,1,0.0,2,1689.0,9:23,1,1,2,50.0,6,0,1,0,1,0,0,0,0.0,0:0,0,0,0,0.0,0:0,867500
8477916,Borna,Rendulic,1992-03-25,RW,R,2014-15,11,1,1,2,0.18,1,6,16.67,6,6205.0,9:24,0,0,0,0.0,22,3,5,1,4,0,0,0,163.0,0:14,0,0,0,0.0,0:0,622500
8477922,Melker,Karlsson,1990-07-18,C,R,2014-15,53,13,11,24,0.45,-3,100,13.0,20,49083.0,15:26,13,20,33,39.39,51,26,21,22,-1,1,0,1,3297.0,1:2,0,0,0,595.0,0:11,825000
8477930,Pierre-Edouard,Bellemare,1985-03-06,LW,L,2014-15,81,6,6,12,0.15,-3,113,5.31,18,62363.0,12:49,360,401,761,47.31,121,61,32,19,13,0,0,0,437.0,0:5,0,0,0,10034.0,2:3,600000
8477932,Aaron,Ekblad,1996-02-07,D,R,2014-15,81,12,27,39,0.48,12,170,7.06,32,105997.0,21:48,0,0,0,0.0,109,80,26,41,-15,6,7,13,13644.0,2:48,0,0,0,2072.0,0:25,925000
8477933,Sam,Reinhart,1995-11-06,C,R,2014-15,9,0,1,1,0.11,-1,3,0.0,2,5596.0,10:21,21,65,86,24.42,3,5,2,1,1,0,0,0,66.0,0:7,0,0,0,0.0,0:0,925000
8477934,Leon,Draisaitl,1995-10-27,C,L,2014-15,37,2,7,9,0.24,-17,49,4.08,4,28184.0,12:41,128,187,315,40.63,21,8,14,16,-2,1,1,2,4081.0,1:50,0,0,0,32.0,0:0,925000
8477935,Sam,Bennett,1996-06-20,C,L,2014-15,1,0,1,1,1.0,-1,1,0.0,0,960.0,16:0,1,5,6,16.67,0,0,1,0,1,0,0,0,54.0,0:54,0,0,0,0.0,0:0,925000
8477942,Kevin,Fiala,1996-07-22,LW,L,2014-15,1,0,0,0,0.0,-1,3,0.0,0,685.0,11:25,0,0,0,0.0,0,1,2,0,2,0,0,0,0.0,0:0,0,0,0,0.0,0:0,925000
8477956,David,Pastrnak,1996-05-25,RW,R,2014-15,46,10,17,27,0.59,12,93,10.75,8,38566.0,13:58,5,12,17,29.41,20,11,25,30,-5,2,1,3,4660.0,1:41,0,0,0,118.0,0:2,925000
8478042,Viktor,Arvidsson,1993-04-08,LW,R,2014-15,6,0,0,0,0.0,0,9,0.0,0,3692.0,10:15,0,0,0,0.0,3,5,3,3,0,0,0,0,0.0,0:0,0,0,0,0.0,0:0,631667
8478137,Jiri,Sekac,1992-06-10,LW,L,2014-15,69,9,14,23,0.33,0,85,10.59,22,56187.0,13:34,0,2,2,0.0,75,29,26,27,-1,2,1,3,2714.0,0:39,0,0,0,1043.0,0:15,925000
8478376,Casey,Bailey,1991-10-27,RW,R,2014-15,6,1,0,1,0.17,1,9,11.11,2,3253.0,9:2,0,0,0,0.0,3,4,1,1,0,0,0,0,46.0,0:7,0,0,0,0.0,0:0,912500
8478393,Kyle,Baun,1992-05-04,RW,R,2014-15,3,0,0,0,0.0,-1,4,0.0,0,2257.0,12:32,0,0,0,0.0,12,0,1,0,1,0,0,0,0.0,0:0,0,0,0,0.0,0:0,858750
