player_id,firstName,lastName,birthDate,primaryPosition,shootsCatches,season,gamesPlayed,goals,assists,points,pointsPerGame,plusMinus,shots,shootingPercentage,penaltyMinutes,timeOnIce,avgTimeOnIce,faceOffWins,faceOffLosses,faceOffTaken,faceOffPercentage,hits,blocks,takeaways,giveaways,turnoverDifferential,powerPlayGoals,powerPlayAssists,powerPlayPoints,powerPlayTimeOnIce,avgPowerPlayTimeOnIce,shortHandedGoals,shortHandedAssists,shortHandedPoints,shortHandedTimeOnIce,avgShortHandedTimeOnIce,salary
8448208,Jaromir,Jagr,1972-02-15,RW,L,2015-16,79,27,39,66,0.84,23,143,18.88,48,80936.0,17:4,0,1,1,0.0,31,16,33,44,-11,5,6,11,12867.0,2:42,0,0,0,78.0,0:0,3500000
8460542,Patrik,Elias,1976-04-13,C,L,2015-16,16,2,6,8,0.5,5,21,9.52,10,14819.0,15:26,9,19,28,32.14,10,1,5,9,-4,0,2,2,3333.0,3:28,0,0,0,750.0,0:46,5500000
8460720,Eric,Boulton,1976-08-17,LW,L,2015-16,6,0,0,0,0.0,-3,3,0.0,2,3415.0,9:29,0,0,0,0.0,15,0,1,2,-1,0,0,0,172.0,0:28,0,0,0,120.0,0:20,575000
8462038,Shane,Doan,1976-10-10,RW,R,2015-16,72,28,19,47,0.65,4,170,16.47,98,76011.0,17:35,74,69,143,51.75,116,15,33,27,6,12,5,17,13191.0,3:3,0,0,0,3073.0,0:42,5300000
8462042,Jarome,Iginla,1977-07-01,RW,R,2015-16,82,22,25,47,0.57,-22,182,12.09,41,78039.0,15:51,61,54,115,53.04,70,45,22,22,0,13,6,19,14414.0,2:55,0,0,0,201.0,0:2,5333333
8464977,Dainius,Zubrus,1978-06-16,C,L,2015-16,50,3,4,7,0.14,4,33,9.09,20,34769.0,11:35,15,12,27,55.56,68,15,15,15,0,0,0,0,163.0,0:3,0,0,0,2970.0,0:59,3100000
8464989,Matt,Cullen,1976-11-02,C,L,2015-16,82,16,16,32,0.39,5,118,13.56,20,68291.0,13:52,582,462,1044,55.75,40,41,19,20,-1,0,0,0,1241.0,0:15,3,3,6,12477.0,2:32,800000
8465009,Zdeno,Chara,1977-03-18,D,L,2015-16,80,9,28,37,0.46,12,158,5.7,71,115665.0,24:5,0,1,1,0.0,134,123,23,87,-64,1,9,10,7493.0,1:33,0,2,2,15971.0,3:19,6916667
8465058,Michal,Rozsival,1978-09-03,D,R,2015-16,51,1,12,13,0.25,3,41,2.44,33,49451.0,16:9,0,0,0,0.0,81,63,6,24,-18,0,2,2,1430.0,0:28,0,1,1,1854.0,0:36,600000
8465185,Willie,Mitchell,1977-04-23,D,L,2015-16,46,1,6,7,0.15,-2,33,3.03,18,54994.0,19:55,0,0,0,0.0,68,70,6,18,-12,0,0,0,354.0,0:7,0,0,0,8932.0,3:14,4250000
8465978,Shawn,Thornton,1977-07-23,LW,R,2015-16,50,1,4,5,0.1,-2,58,1.72,80,26067.0,8:41,6,7,13,46.15,73,2,9,4,5,0,0,0,328.0,0:6,0,0,0,0.0,0:0,1200000
8466138,Joe,Thornton,1979-07-02,C,L,2015-16,82,19,63,82,1.0,25,121,15.7,54,90343.0,18:21,399,354,753,52.99,48,30,69,98,-29,8,21,29,17917.0,3:38,0,0,0,227.0,0:2,6750000
8466139,Patrick,Marleau,1979-09-15,C,L,2015-16,82,25,23,48,0.59,-22,216,11.57,10,93620.0,19:1,267,258,525,50.86,64,36,46,71,-25,11,14,25,17314.0,3:31,1,0,1,6274.0,1:16,6666667
8466148,Marian,Hossa,1979-01-12,RW,L,2015-16,64,13,20,33,0.52,10,191,6.81,24,66284.0,17:15,0,2,2,0.0,37,33,44,25,19,2,7,9,7518.0,1:57,3,1,4,5990.0,1:33,5275000
8466251,Jason,Chimera,1979-05-02,LW,L,2015-16,82,20,20,40,0.49,0,165,12.12,22,69129.0,14:3,8,20,28,28.57,103,13,15,32,-17,4,5,9,7116.0,1:26,2,0,2,4840.0,0:59,2000000
8466285,Brian,Campbell,1979-05-23,D,L,2015-16,82,6,25,31,0.38,31,99,6.06,26,109607.0,22:16,0,0,0,0.0,27,80,23,54,-31,0,8,8,13211.0,2:41,1,0,1,7953.0,1:36,7142875
8466333,Andrew,Ference,1979-03-17,D,L,2015-16,6,0,0,0,0.0,-4,4,0.0,6,4701.0,13:3,0,0,0,0.0,10,5,0,2,-2,0,0,0,13.0,0:2,0,0,0,421.0,1:10,3250000
8466393,Pascal,Dupuis,1979-04-07,RW,L,2015-16,18,2,2,4,0.22,-1,28,7.14,12,16305.0,15:5,2,1,3,66.67,35,12,2,4,-2,0,0,0,166.0,0:9,0,0,0,2618.0,2:25,3750000
8467096,Dan,Boyle,1976-07-12,D,R,2015-16,74,10,14,24,0.32,0,95,10.53,30,83536.0,18:48,0,0,0,0.0,66,105,19,47,-28,3,7,10,9666.0,2:10,0,0,0,2989.0,0:40,4500000
8467329,Vincent,Lecavalier,1980-04-21,C,L,2015-16,49,10,8,18,0.37,0,67,14.93,22,38926.0,13:14,297,288,585,50.77,62,22,13,14,-1,6,1,7,4542.0,1:32,0,0,0,1420.0,0:28,7727272
8467330,David,Legwand,1980-08-17,C,L,2015-16,79,5,9,14,0.18,-4,61,8.2,14,46003.0,9:42,196,231,427,45.9,28,18,19,12,7,0,1,1,163.0,0:2,1,1,2,11498.0,2:25,3000000
8467331,Brad,Stuart,1979-11-06,D,L,2015-16,6,0,0,0,0.0,-2,0,,0,5040.0,14:0,0,0,0,0.0,11,7,0,3,-3,0,0,0,0.0,0:0,0,0,0,307.0,0:51,3600000
8467338,Alex,Tanguay,1979-11-21,LW,L,2015-16,70,8,27,35,0.5,8,71,11.27,32,66320.0,15:47,3,2,5,60.0,22,36,27,17,10,1,8,9,9472.0,2:15,0,1,1,2288.0,0:32,3500000
8467351,Scott,Gomez,1979-12-23,C,L,2015-16,34,1,8,9,0.26,-7,20,5.0,6,23128.0,11:20,125,152,277,45.13,3,10,6,13,-7,0,4,4,3201.0,1:34,0,0,0,66.0,0:1,575000
8467370,Mike,Fisher,1980-06-05,C,R,2015-16,70,13,10,23,0.33,-14,98,13.27,29,72085.0,17:9,668,582,1250,53.44,142,74,21,14,7,3,2,5,9513.0,2:15,0,1,1,7441.0,1:46,4400000
8467371,Mike,Ribeiro,1980-02-10,C,L,2015-16,81,7,43,50,0.62,11,76,9.21,62,84805.0,17:26,288,472,760,37.89,61,20,22,50,-28,2,13,15,13455.0,2:46,0,0,0,151.0,0:1,5500000
8467389,Brad,Richards,1980-05-02,C,L,2015-16,68,10,18,28,0.41,4,164,6.1,8,60361.0,14:47,124,126,250,49.6,16,12,15,22,-7,4,10,14,10804.0,2:38,0,0,0,78.0,0:1,6666666
8467400,Francois,Beauchemin,1980-06-04,D,L,2015-16,82,8,26,34,0.41,-7,127,6.3,38,123393.0,25:4,0,0,0,0.0,78,256,31,41,-10,2,9,11,10377.0,2:6,0,2,2,17338.0,3:31,4500000
8467407,Brian,Gionta,1979-01-18,RW,R,2015-16,79,12,21,33,0.42,-5,169,7.1,12,84052.0,17:43,54,66,120,45.0,46,36,31,21,10,1,5,6,9471.0,1:59,0,0,0,6756.0,1:25,4250000
8467423,Shawn,Horcoff,1978-09-17,C,L,2015-16,59,6,9,15,0.25,1,73,8.22,34,47036.0,13:17,320,306,626,51.12,58,24,12,28,-16,0,0,0,883.0,0:14,1,1,2,5736.0,1:37,1750000
8467452,Rob,Scuderi,1978-12-30,D,L,2015-16,63,0,10,10,0.16,7,35,0.0,10,59762.0,15:48,0,1,1,0.0,31,75,5,29,-24,0,0,0,107.0,0:1,0,1,1,6793.0,1:47,3375000
8467493,Chris,Neil,1979-06-18,RW,R,2015-16,80,5,8,13,0.16,-3,70,7.14,165,44631.0,9:17,1,1,2,50.0,215,12,11,12,-1,0,0,0,305.0,0:3,0,0,0,47.0,0:0,1900000
8467496,Andrei,Markov,1978-12-20,D,L,2015-16,82,5,39,44,0.54,-6,117,4.27,38,117272.0,23:50,0,0,0,0.0,57,142,38,93,-55,4,13,17,16646.0,3:23,0,0,0,11493.0,2:20,5750000
8467514,Pavel,Datsyuk,1978-07-20,C,L,2015-16,66,16,33,49,0.74,7,181,8.84,14,77834.0,19:39,599,517,1116,53.67,70,33,48,26,22,8,12,20,11707.0,2:57,0,0,0,336.0,0:5,7500000
8467875,Daniel,Sedin,1980-09-26,LW,L,2015-16,82,28,33,61,0.74,7,258,10.85,36,90202.0,18:20,5,14,19,26.32,20,19,24,31,-7,8,11,19,16080.0,3:16,0,1,1,2245.0,0:27,7000000
8467876,Henrik,Sedin,1980-09-26,C,L,2015-16,74,11,44,55,0.74,0,99,11.11,24,81602.0,18:22,620,727,1347,46.03,9,19,23,50,-27,5,15,20,14320.0,3:13,1,0,1,2486.0,0:33,7000000
8467890,Barret,Jackman,1981-03-05,D,L,2015-16,73,1,4,5,0.07,1,64,1.56,76,60695.0,13:51,0,0,0,0.0,100,86,8,35,-27,0,0,0,119.0,0:1,0,0,0,3720.0,0:50,2000000
8467899,Martin,Havlat,1981-04-19,RW,L,2015-16,2,1,0,1,0.5,0,3,33.33,0,1307.0,10:53,0,0,0,0.0,1,0,3,0,3,0,0,0,52.0,0:26,0,0,0,0.0,0:0,600000
8467967,Chris,Kelly,1980-11-11,C,L,2015-16,11,2,0,2,0.18,3,8,25.0,0,8637.0,13:5,22,30,52,42.31,13,13,2,2,0,0,0,0,94.0,0:8,1,0,1,1576.0,2:23,3000000
8468001,Derek,MacKenzie,1981-06-11,C,L,2015-16,64,6,7,13,0.2,7,79,7.59,36,50502.0,13:9,439,362,801,54.81,154,38,27,13,14,0,0,0,567.0,0:8,0,1,1,10116.0,2:38,1300000
8468083,Henrik,Zetterberg,1980-10-09,C,L,2015-16,82,13,37,50,0.61,-15,214,6.07,24,95499.0,19:24,539,536,1075,50.14,54,26,29,46,-17,2,20,22,15324.0,3:6,0,0,0,433.0,0:5,6083333
8468085,Radim,Vrbata,1981-06-13,RW,R,2015-16,63,13,14,27,0.43,-30,199,6.53,12,60657.0,16:2,4,10,14,28.57,15,12,20,27,-7,5,4,9,10793.0,2:51,0,0,0,230.0,0:3,5000000
8468208,Joel,Ward,1980-12-02,RW,R,2015-16,79,21,22,43,0.54,-15,138,15.22,28,80452.0,16:58,237,256,493,48.07,68,53,41,51,-10,5,7,12,9942.0,2:5,1,1,2,6352.0,1:20,3275000
8468309,Mark,Streit,1977-12-11,D,L,2015-16,62,6,17,23,0.37,-1,110,5.45,18,81373.0,21:52,0,0,0,0.0,28,90,14,41,-27,2,6,8,11551.0,3:6,0,0,0,5393.0,1:26,5250000
8468483,Marian,Gaborik,1982-02-14,RW,L,2015-16,54,12,10,22,0.41,-6,142,8.45,20,48420.0,14:56,1,2,3,33.33,29,17,13,18,-5,1,3,4,5984.0,1:50,0,0,0,346.0,0:6,4875000
8468486,Scott,Hartnell,1982-04-18,LW,L,2015-16,79,23,26,49,0.62,-11,150,15.33,112,73865.0,15:35,0,3,3,0.0,131,41,20,32,-12,10,2,12,12026.0,2:32,0,0,0,277.0,0:3,4750000
8468493,Ron,Hainsey,1981-03-24,D,L,2015-16,81,5,14,19,0.23,-13,131,3.82,37,108498.0,22:19,0,0,0,0.0,85,126,34,48,-14,0,0,0,1001.0,0:12,0,0,0,13456.0,2:46,2833333
8468498,Brooks,Orpik,1980-09-26,D,L,2015-16,41,3,7,10,0.24,11,31,9.68,24,48734.0,19:48,0,0,0,0.0,125,102,7,24,-17,0,0,0,65.0,0:1,0,0,0,5513.0,2:14,5500000
8468504,Brad,Boyes,1982-04-17,RW,R,2015-16,60,8,16,24,0.4,-6,85,9.41,12,43093.0,11:58,9,5,14,64.29,20,17,25,19,6,2,3,5,8566.0,2:22,0,0,0,95.0,0:1,2625000
8468505,Steve,Ott,1982-08-19,C,L,2015-16,21,0,2,2,0.1,-3,21,0.0,34,13757.0,10:55,39,31,70,55.71,34,5,3,1,2,0,0,0,44.0,0:2,0,0,0,2224.0,1:45,2600000
8468508,Justin,Williams,1981-10-04,RW,R,2015-16,82,22,30,52,0.63,15,201,10.95,36,81932.0,16:39,57,52,109,52.29,32,43,37,48,-11,3,6,9,9980.0,2:1,0,1,1,4726.0,0:57,3250000
8468509,Niklas,Kronwall,1981-01-12,D,L,2015-16,64,3,23,26,0.41,-21,61,4.92,30,84516.0,22:0,0,0,0,0.0,93,81,9,23,-14,0,14,14,10955.0,2:51,0,0,0,8612.0,2:14,4750000
8468513,Nick,Schultz,1982-08-25,D,L,2015-16,81,1,9,10,0.12,-1,70,1.43,42,87221.0,17:56,1,0,1,100.0,85,174,4,38,-34,0,0,0,277.0,0:3,0,0,0,14314.0,2:56,2250000
8468526,Jarret,Stoll,1982-06-24,C,R,2015-16,80,4,5,9,0.11,-1,49,8.16,36,58450.0,12:10,481,362,843,57.06,117,69,8,11,-3,0,0,0,116.0,0:1,0,0,0,8553.0,1:46,800000
8468535,Antoine,Vermette,1982-07-20,C,L,2015-16,76,17,21,38,0.5,-14,123,13.82,93,75883.0,16:38,754,597,1351,55.81,55,57,27,33,-6,6,10,16,12970.0,2:50,1,0,1,4783.0,1:2,3750000
8468542,Paul,Martin,1981-03-05,D,L,2015-16,78,3,17,20,0.26,13,49,6.12,22,97006.0,20:43,0,0,0,0.0,54,123,26,50,-24,1,1,2,1874.0,0:24,0,0,0,10367.0,2:12,4850000
8468575,Dominic,Moore,1980-08-03,C,L,2015-16,80,6,9,15,0.19,-2,94,6.38,32,63816.0,13:17,476,385,861,55.28,51,35,24,36,-12,0,0,0,276.0,0:3,0,0,0,10351.0,2:9,1500000
8468611,Matt,Hendricks,1981-06-17,C,L,2015-16,68,5,7,12,0.18,2,62,8.06,82,54010.0,13:14,251,202,453,55.41,175,68,14,20,-6,0,0,0,590.0,0:8,1,1,2,9104.0,2:13,1850000
8468635,Travis,Moen,1982-04-06,LW,L,2015-16,23,0,2,2,0.09,-3,12,0.0,21,11305.0,8:11,4,1,5,80.0,30,13,4,4,0,0,0,0,38.0,0:1,0,1,1,555.0,0:24,1850000
8468639,John-Michael,Liles,1980-11-25,D,L,2015-16,81,6,15,21,0.26,-10,111,5.41,18,98676.0,20:18,0,0,0,0.0,81,127,26,44,-18,1,2,3,8192.0,1:41,1,0,1,7477.0,1:32,3875000
8468674,Deryk,Engelland,1982-04-03,D,R,2015-16,69,3,9,12,0.17,7,71,4.23,54,63058.0,15:13,0,0,0,0.0,105,107,8,22,-14,0,0,0,504.0,0:7,0,1,1,5117.0,1:14,2916667
8468700,Paul,Gaustad,1982-02-03,C,L,2015-16,63,2,4,6,0.1,-4,46,4.35,46,42495.0,11:14,427,345,772,55.31,114,33,14,14,0,0,0,0,135.0,0:2,1,1,2,6961.0,1:50,3250000
8469455,Jason,Spezza,1983-06-13,C,R,2015-16,75,33,30,63,0.84,4,202,16.34,22,74340.0,16:31,538,443,981,54.84,9,20,45,62,-17,9,15,24,14048.0,3:7,0,0,0,492.0,0:6,7500000
8469459,Mikko,Koivu,1983-03-12,C,L,2015-16,82,17,39,56,0.68,6,141,12.06,40,98051.0,19:55,987,771,1758,56.14,38,57,37,45,-8,10,10,20,16810.0,3:25,1,1,2,4505.0,0:54,6750000
8469462,Tuomo,Ruutu,1983-02-16,LW,L,2015-16,33,0,1,1,0.03,-7,34,0.0,8,22779.0,11:30,2,3,5,40.0,63,8,10,8,2,0,0,0,358.0,0:10,0,0,0,449.0,0:13,4750000
8469465,Dan,Hamhuis,1982-12-13,D,L,2015-16,58,3,10,13,0.22,-2,72,4.17,28,74525.0,21:24,0,0,0,0.0,64,72,24,47,-23,1,2,3,4832.0,1:23,0,0,0,9074.0,2:36,4500000
8469466,Ales,Hemsky,1983-08-13,RW,R,2015-16,75,13,26,39,0.52,3,155,8.39,20,58969.0,13:6,2,4,6,33.33,25,26,22,36,-14,1,4,5,7250.0,1:36,0,0,0,35.0,0:0,4000000
8469469,R.J.,Umberger,1982-05-03,C,L,2015-16,39,2,9,11,0.28,1,48,4.17,15,23771.0,10:9,2,3,5,40.0,59,15,4,7,-3,1,1,2,1151.0,0:29,0,0,0,318.0,0:8,4600000
8469470,Carlo,Colaiacovo,1983-01-27,D,L,2015-16,36,1,4,5,0.14,-11,29,3.45,10,31261.0,14:28,0,0,0,0.0,36,41,3,11,-8,0,1,1,382.0,0:10,0,0,0,139.0,0:3,900000
8469490,Tim,Jackman,1981-11-14,RW,R,2015-16,2,0,0,0,0.0,-2,1,0.0,4,688.0,5:44,0,0,0,0.0,2,0,0,1,-1,0,0,0,0.0,0:0,0,0,0,0.0,0:0,700000
8469492,Fedor,Tyutin,1983-07-19,D,L,2015-16,61,1,2,3,0.05,-6,25,4.0,28,64380.0,17:35,0,0,0,0.0,128,71,7,13,-6,0,0,0,338.0,0:5,0,0,0,7727.0,2:6,4500000
8469500,Michael,Cammalleri,1982-06-08,LW,L,2015-16,42,14,24,38,0.9,15,101,13.86,18,48583.0,19:16,7,7,14,50.0,15,13,19,24,-5,3,7,10,7610.0,3:1,0,0,0,507.0,0:12,5000000
8469501,Chris,Thorburn,1983-06-03,RW,R,2015-16,82,6,6,12,0.15,-1,70,8.57,81,49797.0,10:7,68,54,122,55.74,146,32,11,18,-7,0,0,0,379.0,0:4,1,0,1,3403.0,0:41,1200000
8469506,Jason,Pominville,1982-11-30,RW,R,2015-16,75,11,25,36,0.48,10,187,5.88,12,73637.0,16:21,37,45,82,45.12,31,31,21,22,-1,3,7,10,11103.0,2:28,0,0,0,31.0,0:0,5600000
8469508,Jay,McClement,1983-03-02,C,L,2015-16,77,3,8,11,0.14,-17,64,4.69,24,53609.0,11:36,375,303,678,55.31,79,31,32,21,11,0,0,0,441.0,0:5,1,0,1,8872.0,1:55,1200000
8469521,Tomas,Plekanec,1982-10-31,C,L,2015-16,82,14,40,54,0.66,4,189,7.41,36,91178.0,18:31,804,811,1615,49.78,60,46,15,45,-30,1,12,13,13214.0,2:41,0,0,0,7952.0,1:36,5000000
8469544,Patrick,Sharp,1981-12-27,LW,R,2015-16,76,20,35,55,0.72,-3,226,8.85,27,80337.0,17:37,16,17,33,48.48,76,24,51,46,5,7,17,24,13057.0,2:51,0,0,0,530.0,0:6,5900000
8469547,Jordin,Tootoo,1983-02-02,RW,R,2015-16,66,4,5,9,0.14,-26,90,4.44,102,45650.0,11:31,0,2,2,0.0,99,18,17,23,-6,2,3,5,4803.0,1:12,0,0,0,82.0,0:1,825000
8469555,Christian,Ehrhoff,1982-07-06,D,L,2015-16,48,2,10,12,0.25,-11,80,2.5,34,44593.0,15:29,0,0,0,0.0,39,35,5,22,-17,0,8,8,4729.0,1:38,0,0,0,1177.0,0:24,4000000
8469598,Kevin,Bieksa,1981-06-16,D,R,2015-16,71,4,11,15,0.21,-7,109,3.67,99,89506.0,21:0,0,0,0,0.0,152,108,13,51,-38,2,4,6,6351.0,1:29,0,0,0,8817.0,2:4,4600000
8469619,Dennis,Seidenberg,1981-07-18,D,L,2015-16,61,1,11,12,0.2,-1,66,1.52,24,70995.0,19:23,0,0,0,0.0,127,120,16,24,-8,0,1,1,186.0,0:3,0,0,0,8606.0,2:21,4000000
8469623,Marek,Zidlicky,1977-02-03,D,R,2015-16,53,4,12,16,0.3,5,48,8.33,20,49555.0,15:35,0,0,0,0.0,39,68,5,21,-16,0,4,4,5963.0,1:52,0,0,0,146.0,0:2,1500000
8469638,Jussi,Jokinen,1983-04-01,LW,L,2015-16,81,18,42,60,0.74,25,153,11.76,42,88896.0,18:17,135,127,262,51.53,43,50,31,47,-16,5,7,12,12662.0,2:36,1,1,2,11067.0,2:16,4000000
8469639,Brooks,Laich,1983-06-23,C,L,2015-16,81,2,12,14,0.17,-13,101,1.98,18,55574.0,11:26,98,145,243,40.33,126,34,29,16,13,0,0,0,1281.0,0:15,0,1,1,9602.0,1:58,4500000
8469665,Johnny,Oduya,1981-10-01,D,L,2015-16,82,4,17,21,0.26,8,63,6.35,26,100257.0,20:22,0,0,0,0.0,73,172,23,37,-14,0,0,0,683.0,0:8,1,1,2,13795.0,2:48,3750000
8469707,PA,Parenteau,1983-03-24,RW,R,2015-16,77,20,21,41,0.53,0,168,11.9,68,75116.0,16:15,4,14,18,22.22,48,26,29,27,2,7,4,11,12914.0,2:47,0,0,0,89.0,0:1,4000000
8469759,Vernon,Fiddler,1980-05-09,C,L,2015-16,82,12,10,22,0.27,5,98,12.24,31,57270.0,11:38,455,442,897,50.72,42,39,24,15,9,1,1,2,1459.0,0:17,2,2,4,10689.0,2:10,1250000
8469760,Zbynek,Michalek,1982-12-23,D,R,2015-16,70,2,5,7,0.1,3,69,2.9,20,71469.0,17:0,0,0,0,0.0,84,125,21,27,-6,0,0,0,147.0,0:2,0,0,0,13093.0,3:7,3200000
8469770,Dennis,Wideman,1983-03-20,D,R,2015-16,51,2,17,19,0.37,-9,75,2.67,30,63082.0,20:36,0,0,0,0.0,37,77,14,37,-23,2,6,8,9042.0,2:57,0,0,0,4732.0,1:32,5250000
8470039,Tomas,Fleischmann,1984-05-16,LW,L,2015-16,76,14,11,25,0.33,-8,123,11.38,32,69374.0,15:12,24,19,43,55.81,40,19,38,16,22,0,1,1,2721.0,0:35,1,0,1,6804.0,1:29,750000
8470041,Rick,Nash,1984-06-16,LW,L,2015-16,60,15,21,36,0.6,8,183,8.2,30,60982.0,16:56,0,1,1,0.0,69,24,45,40,5,4,2,6,7660.0,2:7,0,1,1,4905.0,1:21,7800000
8470047,Valtteri,Filppula,1984-03-20,C,L,2015-16,76,8,23,31,0.41,-6,101,7.92,46,83251.0,18:15,632,584,1216,51.97,30,25,30,37,-7,1,7,8,12518.0,2:44,1,0,1,7492.0,1:38,5000000
8470104,Tom,Gilbert,1983-01-10,D,R,2015-16,45,1,1,2,0.04,3,36,2.78,12,45532.0,16:51,0,0,0,0.0,29,88,6,39,-33,0,0,0,411.0,0:9,0,1,1,4954.0,1:50,2800000
8470105,Scottie,Upshall,1983-10-07,RW,L,2015-16,70,6,8,14,0.2,5,113,5.31,44,45980.0,10:56,12,22,34,35.29,92,16,19,10,9,0,0,0,156.0,0:2,0,3,3,5269.0,1:15,700000
8470110,Trevor,Daley,1983-10-09,D,L,2015-16,82,6,22,28,0.34,9,130,4.62,34,90731.0,18:26,0,1,1,0.0,42,79,17,28,-11,1,8,9,9125.0,1:51,0,0,0,3262.0,0:39,3300000
8470120,Alexander,Semin,1984-03-03,RW,R,2015-16,15,1,3,4,0.27,1,18,5.56,12,11102.0,12:20,1,0,1,100.0,6,4,6,8,-2,0,0,0,1875.0,2:5,0,0,0,0.0,0:0,7000000
8470121,Matt,Greene,1983-05-13,D,R,2015-16,3,0,0,0,0.0,0,3,0.0,8,2115.0,11:45,0,0,0,0.0,5,1,0,3,-3,0,0,0,1.0,0:0,0,0,0,340.0,1:53,2500000
8470144,Frans,Nielsen,1984-04-24,C,L,2015-16,81,20,32,52,0.64,1,181,11.05,12,86119.0,17:43,586,583,1169,50.13,35,92,30,30,0,7,13,20,13241.0,2:43,2,0,2,9670.0,1:59,2750000
8470151,Jay,Bouwmeester,1983-09-27,D,L,2015-16,72,3,16,19,0.26,-4,105,2.86,18,99853.0,23:6,0,0,0,0.0,71,110,11,30,-19,1,1,2,2931.0,0:40,0,0,0,13937.0,3:13,5400000
8470159,Boyd,Gordon,1983-10-19,C,R,2015-16,65,2,2,4,0.06,-7,53,3.77,10,47587.0,12:12,526,383,909,57.87,21,51,10,12,-2,0,0,0,159.0,0:2,1,0,1,10966.0,2:48,3000000
8470162,Matt,Stajan,1983-12-19,C,L,2015-16,80,6,11,17,0.21,-4,58,10.34,52,60948.0,12:41,373,415,788,47.34,77,45,34,34,0,0,0,0,448.0,0:5,2,1,3,7489.0,1:33,3125000
8470169,Gregory,Campbell,1983-12-17,C,L,2015-16,82,3,8,11,0.13,-6,58,5.17,78,51986.0,10:33,229,253,482,47.51,100,56,14,11,3,0,0,0,237.0,0:2,0,0,0,8971.0,1:49,1500000
8470171,Max,Talbot,1984-02-11,C,L,2015-16,38,2,5,7,0.18,-11,29,6.9,15,25567.0,11:12,164,181,345,47.54,66,28,9,0,9,0,1,1,189.0,0:4,0,0,0,4062.0,1:46,1800000
8470180,Eric,Nystrom,1983-02-14,LW,L,2015-16,46,7,0,7,0.15,-6,27,25.93,20,31694.0,11:29,1,1,2,50.0,92,26,6,6,0,0,0,0,63.0,0:1,1,0,1,3803.0,1:22,2500000
8470187,Johnny,Boychuk,1984-01-19,D,R,2015-16,70,9,16,25,0.36,17,165,5.45,31,89741.0,21:22,0,0,0,0.0,149,140,21,47,-26,1,4,5,4069.0,0:58,0,0,0,9855.0,2:20,6000000
8470201,Jiri,Hudler,1984-01-04,RW,L,2015-16,72,16,30,46,0.64,-1,109,14.68,27,68080.0,15:45,11,15,26,42.31,28,7,23,25,-2,3,7,10,11101.0,2:34,0,0,0,59.0,0:0,4000000
8470207,Joffrey,Lupul,1983-09-23,LW,R,2015-16,46,11,3,14,0.3,-10,102,10.78,12,40354.0,14:37,0,4,4,0.0,58,14,12,7,5,2,2,4,6516.0,2:21,0,0,0,20.0,0:0,5250000
8470222,James,Wisniewski,1984-02-21,D,R,2015-16,1,0,0,0,0.0,0,0,,0,47.0,0:47,0,0,0,0.0,1,0,0,0,0,0,0,0,0.0,0:0,0,0,0,0.0,0:0,5500000
8470230,Daniel,Paille,1984-04-15,LW,L,2015-16,12,0,0,0,0.0,-2,11,0.0,0,8214.0,11:24,0,1,1,0.0,16,9,5,2,3,0,0,0,2.0,0:0,0,0,0,1212.0,1:41,575000
8470257,Alexander,Steen,1984-03-01,LW,L,2015-16,67,17,35,52,0.78,3,172,9.88,48,81892.0,20:22,159,198,357,44.54,50,35,36,20,16,2,19,21,11883.0,2:57,1,0,1,7195.0,1:47,5800000
8470274,Chris,Higgins,1983-06-02,LW,L,2015-16,33,3,1,4,0.12,-14,51,5.88,4,27281.0,13:46,1,2,3,33.33,15,18,7,8,-1,0,0,0,1250.0,0:37,1,0,1,2968.0,1:29,2500000
8470281,Duncan,Keith,1983-07-16,D,L,2015-16,67,9,34,43,0.64,13,130,6.92,26,101446.0,25:14,0,1,1,0.0,16,116,22,46,-24,4,14,18,11304.0,2:48,0,1,1,10772.0,2:40,5538462
8470317,Nate,Guenin,1982-12-10,D,R,2015-16,29,0,0,0,0.0,2,10,0.0,2,22725.0,13:3,0,0,0,0.0,15,33,2,6,-4,0,0,0,4.0,0:0,0,0,0,2971.0,1:42,800000
8470318,Jonathan,Ericsson,1984-03-02,D,L,2015-16,71,3,12,15,0.21,2,68,4.41,56,78957.0,18:32,0,0,0,0.0,121,48,14,61,-47,0,0,0,448.0,0:6,0,0,0,11164.0,2:37,4250000
8470324,Josh,Gorges,1984-08-14,D,L,2015-16,77,2,10,12,0.16,-7,57,3.51,72,94549.0,20:27,0,0,0,0.0,143,167,13,17,-4,0,0,0,308.0,0:4,0,0,0,10512.0,2:16,3900000
8470358,Alexandre,Burrows,1981-04-11,RW,L,2015-16,79,9,13,22,0.28,-13,135,6.67,49,71905.0,15:10,10,12,22,45.45,81,33,27,14,13,2,4,6,9148.0,1:55,0,0,0,8195.0,1:43,4500000
8470378,Andre,Benoit,1984-01-06,D,L,2015-16,2,0,0,0,0.0,1,0,,0,1630.0,13:35,0,0,0,0.0,1,5,0,0,0,0,0,0,58.0,0:29,0,0,0,5.0,0:2,600000
8470543,Chris,Kunitz,1979-09-26,LW,L,2015-16,80,17,23,40,0.5,29,150,11.33,41,80758.0,16:49,5,6,11,45.45,264,33,33,43,-10,2,4,6,10261.0,2:8,0,0,0,1647.0,0:20,3850000
8470595,Eric,Staal,1984-10-29,C,L,2015-16,83,13,26,39,0.47,-2,199,6.53,34,92406.0,18:33,446,396,842,52.97,74,33,62,39,23,1,6,7,12850.0,2:34,0,0,0,1654.0,0:19,8250000
8470598,Thomas,Vanek,1984-01-19,LW,R,2015-16,74,18,23,41,0.55,-10,146,12.33,22,69312.0,15:36,12,26,38,31.58,18,17,22,51,-29,6,8,14,11526.0,2:35,0,0,0,90.0,0:1,6500000
8470599,Milan,Michalek,1984-12-07,LW,L,2015-16,45,7,9,16,0.36,0,64,10.94,18,43520.0,16:7,3,5,8,37.5,42,27,25,14,11,3,3,6,7906.0,2:55,0,0,0,2516.0,0:55,4000000
8470600,Ryan,Suter,1985-01-21,D,L,2015-16,82,8,43,51,0.62,10,188,4.26,30,140677.0,28:35,0,0,0,0.0,69,142,36,41,-5,3,18,21,18105.0,3:40,1,1,2,9621.0,1:57,7538462
8470601,Braydon,Coburn,1985-02-27,D,L,2015-16,80,1,9,10,0.12,12,92,1.09,53,80411.0,16:45,0,0,0,0.0,111,88,17,31,-14,0,0,0,368.0,0:4,0,1,1,11034.0,2:17,4500000
8470602,Dion,Phaneuf,1985-04-10,D,L,2015-16,71,4,28,32,0.45,-7,144,2.78,90,95197.0,22:20,0,0,0,0.0,168,89,19,35,-16,0,9,9,12163.0,2:51,0,2,2,7811.0,1:50,7000000
8470604,Jeff,Carter,1985-01-01,C,R,2015-16,77,24,38,62,0.81,18,242,9.92,20,84954.0,18:23,598,630,1228,48.7,89,39,26,41,-15,4,8,12,10583.0,2:17,1,1,2,7664.0,1:39,5272727
8470606,Dustin,Brown,1984-11-04,RW,R,2015-16,82,11,17,28,0.34,-5,218,5.05,30,79573.0,16:10,8,9,17,47.06,234,20,40,31,9,2,1,3,4985.0,1:0,0,1,1,7567.0,1:32,5875000
8470607,Brent,Seabrook,1985-04-20,D,R,2015-16,81,14,35,49,0.6,6,167,8.38,32,110918.0,22:49,0,0,0,0.0,121,150,19,89,-70,6,19,25,13929.0,2:51,0,0,0,8688.0,1:47,5800000
8470609,Steve,Bernier,1985-03-31,RW,R,2015-16,24,1,5,6,0.25,3,27,3.7,9,16168.0,11:13,0,0,0,0.0,42,13,6,7,-1,0,0,0,434.0,0:18,0,0,0,13.0,0:0,750000
8470610,Zach,Parise,1984-07-28,LW,L,2015-16,70,25,28,53,0.76,-3,234,10.68,36,81026.0,19:17,0,4,4,0.0,71,42,39,18,21,7,11,18,14274.0,3:23,0,0,0,1178.0,0:16,7538462
8470611,Eric,Fehr,1985-09-07,C,R,2015-16,55,8,6,14,0.25,0,74,10.81,19,43084.0,13:3,107,135,242,44.21,60,45,30,11,19,0,1,1,1216.0,0:22,4,0,4,8171.0,2:28,2000000
8470612,Ryan,Getzlaf,1985-05-10,C,R,2015-16,77,13,50,63,0.82,14,178,7.3,55,90117.0,19:30,602,617,1219,49.38,108,61,48,75,-27,6,16,22,13129.0,2:50,0,1,1,6755.0,1:27,8250000
8470613,Brent,Burns,1985-03-09,D,R,2015-16,82,27,48,75,0.91,-5,353,7.65,53,127251.0,25:51,1,0,1,100.0,101,145,53,102,-49,7,23,30,20145.0,4:5,1,1,2,10499.0,2:8,5760000
8470614,Mark,Stuart,1984-04-27,D,L,2015-16,64,1,2,3,0.05,-7,39,2.56,66,62784.0,16:21,0,0,0,0.0,162,120,3,43,-40,0,0,0,81.0,0:1,0,1,1,11128.0,2:53,2625000
8470616,Ryan,Kesler,1984-08-31,C,R,2015-16,79,21,32,53,0.67,5,164,12.8,78,92580.0,19:31,980,695,1675,58.51,168,92,39,34,5,5,10,15,9646.0,2:2,1,0,1,13049.0,2:45,5000000
8470617,Mike,Richards,1985-02-11,C,L,2015-16,39,2,3,5,0.13,-2,46,4.35,8,28490.0,12:10,235,240,475,49.47,39,19,12,10,2,0,0,0,137.0,0:3,0,0,0,5306.0,2:16,5750000
8470619,Brian,Boyle,1984-12-18,C,L,2015-16,76,13,7,20,0.26,-7,117,11.11,57,58871.0,12:54,346,336,682,50.73,115,48,15,16,-1,2,1,3,2923.0,0:38,2,0,2,7962.0,1:44,2000000
8470621,Corey,Perry,1985-05-16,RW,R,2015-16,82,34,28,62,0.76,2,215,15.81,68,87122.0,17:42,2,8,10,20.0,104,36,25,53,-28,12,12,24,14141.0,2:52,0,0,0,242.0,0:2,8625000
8470622,Patrick,Eaves,1984-05-01,RW,R,2015-16,54,11,6,17,0.31,-5,86,12.79,27,42038.0,12:58,3,8,11,27.27,70,20,16,11,5,5,2,7,6585.0,2:1,0,0,0,1023.0,0:18,1150000
8470626,Loui,Eriksson,1985-07-17,LW,L,2015-16,82,30,33,63,0.77,13,184,16.3,12,95850.0,19:28,12,9,21,57.14,22,34,48,27,21,10,7,17,14324.0,2:54,2,1,3,9106.0,1:51,4250000
8470630,Kevin,Klein,1984-12-13,D,R,2015-16,69,9,17,26,0.38,16,69,13.04,19,84392.0,20:23,0,0,0,0.0,117,155,20,45,-25,0,1,1,1930.0,0:27,0,0,0,8672.0,2:5,2900000
8470638,Patrice,Bergeron,1985-07-24,C,R,2015-16,80,32,36,68,0.85,12,282,11.35,49,95207.0,19:50,1130,848,1978,57.13,77,56,67,34,33,12,13,25,14381.0,2:59,1,2,3,10546.0,2:11,6875000
8470640,Matt,Carle,1984-09-25,D,L,2015-16,64,2,7,9,0.14,4,54,3.7,26,64434.0,16:46,0,0,0,0.0,30,91,9,28,-19,0,0,0,1383.0,0:21,0,0,0,5523.0,1:26,5500000
8470642,Shea,Weber,1985-08-14,D,R,2015-16,78,20,31,51,0.65,-7,189,10.58,27,118764.0,25:22,0,0,0,0.0,169,160,19,39,-20,14,12,26,14340.0,3:3,0,1,1,13319.0,2:50,7857143
8470644,Colin,McDonald,1984-09-30,RW,R,2015-16,5,1,0,1,0.2,0,4,25.0,7,2443.0,8:8,0,0,0,0.0,16,1,0,0,0,0,0,0,3.0,0:0,0,0,0,0.0,0:0,625000
8470655,David,Backes,1984-05-01,RW,R,2015-16,79,21,24,45,0.57,4,168,12.5,83,91151.0,19:13,620,572,1192,52.01,239,63,39,24,15,8,5,13,11824.0,2:29,0,0,0,8542.0,1:48,4500000
8470667,Clarke,MacArthur,1985-04-06,LW,L,2015-16,4,0,0,0,0.0,-1,4,0.0,0,2606.0,10:51,0,1,1,0.0,3,1,0,0,0,0,0,0,193.0,0:48,0,0,0,31.0,0:7,4650000
8470714,Corey,Potter,1984-01-05,D,R,2015-16,1,0,0,0,0.0,0,0,,0,884.0,14:44,0,0,0,0.0,0,1,0,0,0,0,0,0,0.0,0:0,0,0,0,0.0,0:0,650000
8470724,Kyle,Quincey,1985-08-12,D,L,2015-16,47,4,7,11,0.23,1,62,6.45,36,55733.0,19:45,0,0,0,0.0,49,62,8,26,-18,0,0,0,190.0,0:4,0,0,0,6438.0,2:16,4250000
8470729,Tyson,Strachan,1984-10-30,D,R,2015-16,2,0,0,0,0.0,1,0,,0,906.0,7:33,0,0,0,0.0,4,0,0,0,0,0,0,0,0.0,0:0,0,0,0,0.0,0:0,650000
8470740,Lee,Stempniak,1983-02-04,RW,R,2015-16,82,19,32,51,0.62,4,146,13.01,38,88283.0,17:56,2,11,13,15.38,113,34,31,30,1,3,9,12,9539.0,1:56,1,0,1,7907.0,1:36,850000
8470750,John,Mitchell,1985-01-22,C,L,2015-16,71,10,11,21,0.3,-7,101,9.9,52,64947.0,15:14,415,434,849,48.88,85,65,33,17,16,0,1,1,2602.0,0:36,0,0,0,8580.0,2:0,1800000
8470755,Brad,Richardson,1985-02-04,C,L,2015-16,82,11,20,31,0.38,8,117,9.4,46,76858.0,15:37,523,438,961,54.42,57,53,26,15,11,0,0,0,1440.0,0:17,0,0,0,8234.0,1:40,2083333
8470760,Marc,Methot,1985-06-21,D,L,2015-16,69,5,7,12,0.17,12,74,6.76,34,85525.0,20:39,0,0,0,0.0,124,90,10,49,-39,0,0,0,221.0,0:3,0,0,0,9068.0,2:11,4900000
8470775,Nate,Thompson,1984-10-05,C,L,2015-16,49,3,3,6,0.12,-1,42,7.14,47,34084.0,11:35,235,216,451,52.11,103,40,7,14,-7,0,0,0,396.0,0:8,1,0,1,4638.0,1:34,1600000
8470778,Drew,Miller,1984-02-17,LW,L,2015-16,28,1,1,2,0.07,-5,27,3.7,2,21794.0,12:58,1,1,2,50.0,39,33,8,6,2,0,0,0,82.0,0:2,0,0,0,4992.0,2:58,1350000
8470794,Joe,Pavelski,1984-07-11,C,R,2015-16,82,38,40,78,0.95,25,224,16.96,30,97494.0,19:48,516,422,938,55.01,147,67,46,82,-36,12,16,28,17979.0,3:39,0,0,0,2735.0,0:33,6000000
8470803,Kyle,Brodziak,1984-05-25,C,R,2015-16,76,7,4,11,0.14,-1,49,14.29,37,49271.0,10:48,275,281,556,49.46,50,37,18,11,7,0,0,0,225.0,0:2,3,0,3,8030.0,1:45,900000
8470828,Toby,Enstrom,1984-11-05,D,L,2015-16,72,2,14,16,0.22,8,50,4.0,44,90091.0,20:51,0,0,0,0.0,25,96,9,40,-31,0,1,1,5861.0,1:21,0,0,0,6671.0,1:32,5750000
8470834,Dustin,Byfuglien,1985-03-27,D,R,2015-16,81,19,34,53,0.65,4,247,7.69,119,122487.0,25:12,0,0,0,0.0,222,105,73,92,-19,3,14,17,16311.0,3:21,1,1,2,9765.0,2:0,5200000
8470852,Matt,Moulson,1983-11-01,LW,L,2015-16,81,8,13,21,0.26,-5,111,7.21,16,57849.0,11:54,0,5,5,0.0,45,23,18,15,3,2,5,7,9598.0,1:58,0,0,0,23.0,0:0,5000000
8470854,Tanner,Glass,1983-11-29,LW,L,2015-16,57,4,3,7,0.12,-3,49,8.16,66,35178.0,10:17,6,14,20,30.0,224,18,4,13,-9,0,0,0,227.0,0:3,0,0,0,1516.0,0:26,1450000
8470871,Chris,Porter,1984-05-29,LW,L,2015-16,61,4,3,7,0.11,-6,45,8.89,6,35269.0,9:38,0,1,1,0.0,157,12,15,8,7,0,0,0,71.0,0:1,0,0,0,4372.0,1:11,575000
8470877,David,Jones,1984-08-10,RW,R,2015-16,75,11,7,18,0.24,-7,84,13.1,10,55976.0,12:26,17,17,34,50.0,147,33,14,9,5,1,0,1,1700.0,0:22,0,0,0,245.0,0:3,4000000
8470886,Clayton,Stoner,1985-02-19,D,L,2015-16,50,1,5,6,0.12,4,32,3.12,67,46081.0,15:21,0,0,0,0.0,123,55,2,31,-29,0,0,0,164.0,0:3,0,1,1,5399.0,1:47,3250000
8470920,David,Clarkson,1984-03-31,RW,R,2015-16,23,2,2,4,0.17,-8,24,8.33,23,12720.0,9:13,2,10,12,16.67,45,6,5,2,3,0,0,0,390.0,0:16,0,0,0,22.0,0:0,5250000
8470966,Mark,Giordano,1983-10-03,D,L,2015-16,82,21,35,56,0.68,-5,212,9.91,54,121981.0,24:47,0,0,0,0.0,65,193,45,68,-23,9,10,19,15704.0,3:11,1,2,3,11840.0,2:24,4020000
8471214,Alex,Ovechkin,1985-09-17,LW,R,2015-16,79,50,21,71,0.9,21,398,12.56,53,96262.0,20:18,0,0,0,0.0,225,34,24,50,-26,19,5,24,20365.0,4:17,0,0,0,18.0,0:0,9538462
8471215,Evgeni,Malkin,1986-07-31,C,L,2015-16,57,27,31,58,1.02,1,162,16.67,65,66241.0,19:22,317,438,755,41.99,27,19,54,52,2,11,16,27,13041.0,3:48,0,0,0,919.0,0:16,9500000
8471217,Andrew,Ladd,1985-12-12,LW,L,2015-16,78,25,21,46,0.59,-13,181,13.81,45,88519.0,18:54,8,5,13,61.54,155,42,29,34,-5,10,4,14,12687.0,2:42,2,0,2,8617.0,1:50,4400000
8471218,Blake,Wheeler,1986-08-31,RW,R,2015-16,82,26,52,78,0.95,8,256,10.16,49,97354.0,19:47,10,18,28,35.71,92,56,38,46,-8,3,14,17,15526.0,3:9,2,2,4,6344.0,1:17,5600000
8471222,Ladislav,Smid,1986-02-01,D,L,2015-16,22,0,0,0,0.0,-7,11,0.0,6,15293.0,11:35,0,0,0,0.0,39,33,1,4,-3,0,0,0,113.0,0:5,0,0,0,609.0,0:27,3500000
8471226,Drew,Stafford,1985-10-30,RW,R,2015-16,78,21,17,38,0.49,-23,187,11.23,28,83646.0,17:52,51,50,101,50.5,59,15,30,34,-4,6,3,9,10080.0,2:9,1,2,3,4856.0,1:2,4350000
8471231,Kyle,Chipchura,1986-02-19,C,L,2015-16,70,4,8,12,0.17,-10,47,8.51,38,42985.0,10:14,88,80,168,52.38,73,13,25,16,9,0,1,1,661.0,0:9,0,0,0,3114.0,0:44,875000
8471232,Lauri,Korpikoski,1986-07-28,LW,L,2015-16,71,10,12,22,0.31,-17,88,11.36,10,59343.0,13:55,18,16,34,52.94,100,56,19,14,5,2,4,6,3436.0,0:48,1,0,1,8498.0,1:59,2500000
8471233,Travis,Zajac,1985-05-13,C,R,2015-16,74,14,28,42,0.57,3,111,12.61,25,88144.0,19:51,715,672,1387,51.55,65,41,49,5,44,6,11,17,11072.0,2:29,2,1,3,12031.0,2:42,5750000
8471240,Jeff,Schultz,1986-02-25,D,L,2015-16,1,0,0,0,0.0,-1,1,0.0,0,1095.0,18:15,0,0,0,0.0,0,2,0,0,0,0,0,0,0.0,0:0,0,0,0,221.0,3:41,850000
8471242,Mike,Green,1985-10-12,D,R,2015-16,74,7,28,35,0.47,-6,124,5.65,38,87772.0,19:46,0,2,2,0.0,106,71,18,40,-22,5,15,20,12316.0,2:46,0,0,0,625.0,0:8,6000000
8471245,Dave,Bolland,1986-06-05,C,R,2015-16,25,1,4,5,0.2,-2,26,3.85,16,21138.0,14:5,156,185,341,45.75,36,9,5,12,-7,0,3,3,1183.0,0:47,0,0,0,2991.0,1:59,5500000
8471254,Bryan,Bickell,1986-03-09,LW,L,2015-16,25,0,2,2,0.08,-5,21,0.0,2,14682.0,9:47,2,0,2,100.0,58,10,4,7,-3,0,0,0,316.0,0:12,0,0,0,0.0,0:0,4000000
8471260,Blake,Comeau,1986-02-18,LW,R,2015-16,81,12,24,36,0.44,-9,142,8.45,58,85668.0,17:37,276,290,566,48.76,173,35,31,25,6,2,6,8,8454.0,1:44,2,0,2,9738.0,2:0,2400000
8471262,Carl,Soderberg,1985-10-12,C,L,2015-16,82,12,39,51,0.62,-7,163,7.36,32,88634.0,18:0,339,380,719,47.15,27,71,32,26,6,3,11,14,11178.0,2:16,1,1,2,9780.0,1:59,4750000
8471269,Nicklas,Grossmann,1985-01-22,D,L,2015-16,58,3,4,7,0.12,-3,42,7.14,24,61895.0,17:47,0,0,0,0.0,106,73,3,21,-18,0,0,0,136.0,0:2,0,0,0,10367.0,2:58,3500000
8471273,Brandon,Dubinsky,1986-04-29,C,L,2015-16,75,17,31,48,0.64,-16,158,10.76,71,84434.0,18:45,780,704,1484,52.56,235,40,45,31,14,5,5,10,10012.0,2:13,0,0,0,8935.0,1:59,5850000
8471274,Alex,Goligoski,1985-07-30,D,L,2015-16,82,5,32,37,0.45,21,127,3.94,34,117262.0,23:50,0,0,0,0.0,100,159,18,73,-55,1,4,5,9633.0,1:57,0,1,1,11494.0,2:20,4600000
8471276,David,Krejci,1986-04-28,C,R,2015-16,72,17,46,63,0.88,4,143,11.89,32,87700.0,20:18,560,557,1117,50.13,43,57,36,49,-13,4,14,18,13956.0,3:13,0,3,3,6451.0,1:29,7250000
8471283,Brandon,Prust,1984-03-16,LW,L,2015-16,35,1,6,7,0.2,-3,19,5.26,59,26847.0,12:47,6,5,11,54.55,40,15,5,15,-10,0,0,0,270.0,0:7,0,0,0,1346.0,0:38,2500000
8471284,Andrej,Sekera,1986-06-08,D,L,2015-16,81,6,24,30,0.37,-15,155,3.87,12,106136.0,21:50,0,0,0,0.0,60,156,37,82,-45,2,12,14,11324.0,2:19,0,1,1,7844.0,1:36,5500000
8471296,Alexei,Emelin,1986-04-25,D,L,2015-16,72,0,12,12,0.17,-7,71,0.0,71,88551.0,20:29,0,0,0,0.0,256,113,15,75,-60,0,0,0,1147.0,0:15,0,0,0,9092.0,2:6,4100000
8471303,Alexander,Edler,1986-04-21,D,L,2015-16,52,6,14,20,0.38,-8,111,5.41,46,76292.0,24:27,0,0,0,0.0,84,106,15,40,-25,3,6,9,10145.0,3:15,0,0,0,8057.0,2:34,5000000
8471309,Johan,Franzen,1979-12-23,RW,L,2015-16,2,0,1,1,0.5,0,3,0.0,2,1554.0,12:57,0,1,1,0.0,3,0,0,0,0,0,1,1,76.0,0:38,0,0,0,0.0,0:0,3954545
8471311,Tyler,Kennedy,1986-07-15,C,R,2015-16,50,3,13,16,0.32,-14,72,4.17,14,40275.0,13:25,23,35,58,39.66,35,9,16,12,4,1,5,6,4127.0,1:22,0,0,0,157.0,0:3,600000
8471331,Kevin,Porter,1986-03-12,C,L,2015-16,41,0,3,3,0.07,-2,34,0.0,0,27845.0,11:19,44,43,87,50.57,96,25,7,8,-1,0,0,0,125.0,0:3,0,0,0,4567.0,1:51,575000
8471338,Torrey,Mitchell,1985-01-30,C,R,2015-16,71,11,8,19,0.27,2,69,15.94,51,54041.0,12:41,370,347,717,51.6,67,38,22,27,-5,0,0,0,412.0,0:5,1,2,3,6812.0,1:35,1200000
8471339,Ryan,Callahan,1985-03-21,RW,R,2015-16,73,10,18,28,0.38,-5,156,6.41,45,75502.0,17:14,21,15,36,58.33,164,71,34,23,11,2,2,4,10160.0,2:19,0,0,0,7528.0,1:43,5800000
8471346,Kris,Versteeg,1986-05-13,RW,R,2015-16,77,15,23,38,0.49,0,156,9.62,45,71092.0,15:23,8,8,16,50.0,20,32,38,38,0,2,7,9,8139.0,1:45,0,0,0,98.0,0:1,4400000
8471348,Nikita,Nikitin,1986-06-16,D,L,2015-16,11,0,1,1,0.09,-5,12,0.0,8,9770.0,14:48,0,0,0,0.0,14,9,0,4,-4,0,0,0,191.0,0:17,0,0,0,19.0,0:1,4500000
8471362,Mikhail,Grabovski,1984-01-31,C,L,2015-16,58,9,16,25,0.43,3,83,10.84,33,49079.0,14:6,221,242,463,47.73,28,26,28,34,-6,1,2,3,3566.0,1:1,0,0,0,101.0,0:1,5500000
8471371,Mike,Brown,1985-06-24,RW,R,2015-16,58,2,3,5,0.09,-5,51,3.92,90,27169.0,7:48,3,1,4,75.0,176,25,9,12,-3,0,0,0,139.0,0:2,0,0,0,354.0,0:6,1200000
8471385,Adam,Pardy,1984-03-29,D,L,2015-16,23,0,4,4,0.17,-7,22,0.0,14,21920.0,15:53,0,0,0,0.0,32,32,6,14,-8,0,0,0,28.0,0:1,0,1,1,3323.0,2:24,1000000
8471390,Mike,Santorelli,1985-12-14,C,R,2015-16,70,9,9,18,0.26,-4,81,11.11,8,42389.0,10:5,75,83,158,47.47,28,20,5,15,-10,1,2,3,2324.0,0:33,0,0,0,63.0,0:0,875000
8471392,Roman,Polak,1986-04-28,D,R,2015-16,79,1,15,16,0.2,6,91,1.1,72,90803.0,19:9,1,0,1,100.0,303,146,17,43,-26,0,0,0,254.0,0:3,0,0,0,13657.0,2:52,2750000
8471426,Troy,Brouwer,1985-08-17,RW,R,2015-16,82,18,21,39,0.48,2,142,12.68,62,83614.0,16:59,65,49,114,57.02,200,52,40,26,14,7,3,10,8868.0,1:48,0,0,0,7341.0,1:29,3666667
8471436,Matt,Hunwick,1985-05-21,D,L,2015-16,60,2,8,10,0.17,-17,74,2.7,32,81229.0,22:33,0,0,0,0.0,126,98,24,44,-20,0,2,2,678.0,0:11,0,0,0,13361.0,3:42,1200000
8471476,Daniel,Winnik,1985-03-06,LW,L,2015-16,76,6,13,19,0.25,4,101,5.94,38,62544.0,13:42,8,12,20,40.0,53,46,35,9,26,0,0,0,1507.0,0:19,0,0,0,7908.0,1:44,2250000
8471490,Adam,Cracknell,1985-07-15,RW,R,2015-16,52,5,5,10,0.19,-1,68,7.35,20,38161.0,12:13,156,239,395,39.49,124,25,23,14,9,0,0,0,364.0,0:7,0,0,0,1972.0,0:37,575000
8471498,Jannik,Hansen,1986-03-15,RW,R,2015-16,67,22,16,38,0.57,16,117,18.8,32,66065.0,16:26,6,15,21,28.57,39,19,25,24,1,1,0,1,1627.0,0:24,1,0,1,7024.0,1:44,2500000
8471504,Rene,Bourque,1981-12-10,RW,L,2015-16,49,3,5,8,0.16,-9,77,3.9,38,30703.0,10:26,3,6,9,33.33,82,19,16,8,8,0,0,0,678.0,0:13,0,0,0,162.0,0:3,3333333
8471657,Cody,McLeod,1984-06-26,LW,L,2015-16,82,8,5,13,0.16,1,73,10.96,138,51854.0,10:32,1,0,1,100.0,240,28,6,2,4,1,0,1,813.0,0:9,0,0,0,3873.0,0:47,1333333
8471663,Mike,Blunden,1986-12-15,RW,R,2015-16,20,3,2,5,0.25,3,14,21.43,34,10384.0,8:39,0,0,0,0.0,41,3,1,2,-1,0,0,0,268.0,0:13,0,0,0,0.0,0:0,600000
8471664,Mason,Raymond,1985-09-17,LW,L,2015-16,29,4,1,5,0.17,-3,53,7.55,8,21474.0,12:20,3,4,7,42.86,12,7,8,11,-3,0,0,0,2341.0,1:20,0,0,0,15.0,0:0,3150000
8471669,Paul,Stastny,1985-12-27,C,L,2015-16,64,10,39,49,0.77,3,103,9.71,26,73542.0,19:9,684,536,1220,56.07,32,40,20,7,13,2,12,14,9018.0,2:20,0,0,0,5358.0,1:23,7000000
8471675,Sidney,Crosby,1987-08-07,C,L,2015-16,80,36,49,85,1.06,19,248,14.52,42,98253.0,20:28,986,921,1907,51.7,90,35,40,47,-7,10,14,24,17776.0,3:42,0,0,0,1938.0,0:24,8700000
8471676,Bobby,Ryan,1987-03-17,RW,R,2015-16,81,22,34,56,0.69,-9,183,12.02,28,83470.0,17:10,3,8,11,27.27,106,24,52,52,0,6,10,16,13963.0,2:52,0,0,0,142.0,0:1,7250000
8471677,Jack,Johnson,1987-01-13,D,L,2015-16,60,6,8,14,0.23,-16,86,6.98,25,87031.0,24:10,0,1,1,0.0,98,102,8,30,-22,3,3,6,8546.0,2:22,0,0,0,10402.0,2:53,4357143
8471678,Benoit,Pouliot,1986-09-29,LW,L,2015-16,55,14,22,36,0.65,-6,109,12.84,30,52963.0,16:2,20,29,49,40.82,35,25,32,29,3,5,4,9,7762.0,2:21,1,0,1,1418.0,0:25,4000000
8471681,Jack,Skille,1987-05-19,RW,R,2015-16,74,8,6,14,0.19,-4,106,7.55,11,39216.0,8:49,4,15,19,21.05,97,25,17,8,9,0,0,0,220.0,0:2,0,0,0,959.0,0:12,675000
8471685,Anze,Kopitar,1987-08-24,C,L,2015-16,81,25,49,74,0.91,34,177,14.12,16,101412.0,20:52,950,826,1776,53.49,78,65,43,45,-2,5,13,18,12490.0,2:34,1,2,3,10484.0,2:9,6800000
8471686,Marc,Staal,1987-01-13,D,L,2015-16,77,2,13,15,0.19,2,65,3.08,36,90918.0,19:40,1,3,4,25.0,65,120,20,49,-29,0,0,0,489.0,0:6,0,0,0,10523.0,2:16,5700000
8471691,Martin,Hanzal,1987-02-20,C,L,2015-16,64,13,28,41,0.64,-5,141,9.22,77,68342.0,17:47,586,461,1047,55.97,126,28,27,21,6,3,10,13,12100.0,3:9,1,0,1,5035.0,1:18,3100000
8471693,Jakub,Kindl,1987-02-10,D,L,2015-16,44,2,6,8,0.18,13,63,3.17,18,40629.0,15:23,0,1,1,0.0,39,24,7,29,-22,0,1,1,2256.0,0:51,0,0,0,253.0,0:5,2400000
8471698,T.J.,Oshie,1986-12-23,RW,R,2015-16,80,26,25,51,0.64,16,185,14.05,34,91024.0,18:57,138,124,262,52.67,134,62,62,42,20,11,6,17,14545.0,3:1,0,0,0,6839.0,1:25,4175000
8471699,Andrew,Cogliano,1987-06-14,LW,L,2015-16,82,9,23,32,0.39,2,131,6.87,28,71004.0,14:25,6,11,17,35.29,124,27,26,34,-8,0,0,0,411.0,0:5,2,1,3,9345.0,1:53,3000000
8471702,Matt,Niskanen,1986-12-06,D,R,2015-16,82,5,27,32,0.39,10,150,3.33,38,121335.0,24:39,0,0,0,0.0,157,145,34,62,-28,2,14,16,11887.0,2:24,0,0,0,14118.0,2:52,5750000
8471703,Steve,Downie,1987-04-03,RW,R,2015-16,26,3,3,6,0.23,1,22,13.64,53,14043.0,9:0,2,2,4,50.0,29,7,4,4,0,0,0,0,296.0,0:11,0,0,0,0.0,0:0,1750000
8471707,James,Neal,1987-09-03,LW,L,2015-16,82,31,27,58,0.71,27,268,11.57,65,93831.0,19:4,8,19,27,29.63,113,31,49,25,24,4,10,14,13675.0,2:46,0,0,0,93.0,0:1,5000000
8471709,Marc-Edouard,Vlasic,1987-03-30,D,L,2015-16,67,8,31,39,0.58,15,116,6.9,48,92982.0,23:7,0,0,0,0.0,47,129,15,29,-14,2,8,10,8040.0,2:0,0,2,2,9077.0,2:15,4250000
8471710,Taylor,Chorney,1987-04-27,D,L,2015-16,55,1,5,6,0.11,8,28,3.57,21,43530.0,13:11,0,0,0,0.0,56,58,8,27,-19,0,0,0,109.0,0:1,0,0,0,3907.0,1:11,700000
8471716,Justin,Abdelkader,1987-02-25,LW,L,2015-16,82,19,23,42,0.51,-16,155,12.26,120,90703.0,18:26,5,9,14,35.71,207,44,23,29,-6,6,7,13,14152.0,2:52,0,0,0,7904.0,1:36,1800000
8471717,Adam,McQuaid,1986-10-12,D,R,2015-16,64,1,8,9,0.14,6,42,2.38,89,69274.0,18:2,0,0,0,0.0,142,121,7,27,-20,0,0,0,141.0,0:2,0,0,0,9412.0,2:27,2750000
8471724,Kris,Letang,1987-04-24,D,R,2015-16,71,16,51,67,0.94,9,218,7.34,66,114786.0,26:56,0,0,0,0.0,135,122,47,69,-22,5,22,27,16946.0,3:58,0,3,3,9887.0,2:19,7250000
8471729,Kris,Russell,1987-05-02,D,L,2015-16,62,4,15,19,0.31,-5,70,5.71,10,85842.0,23:4,0,1,1,0.0,40,210,23,47,-24,2,2,4,5643.0,1:31,0,0,0,7174.0,1:55,2600000
8471733,Rich,Clune,1987-04-25,LW,L,2015-16,19,0,4,4,0.21,1,10,0.0,22,9227.0,8:5,0,0,0,0.0,58,5,2,1,1,0,0,0,112.0,0:5,0,0,0,101.0,0:5,850000
8471735,Keith,Yandle,1986-09-09,D,L,2015-16,82,5,42,47,0.57,-4,160,3.12,40,98213.0,19:57,0,0,0,0.0,43,68,27,76,-49,2,20,22,12818.0,2:36,0,0,0,249.0,0:3,5250000
8471742,Cody,Franson,1987-08-08,D,R,2015-16,59,4,13,17,0.29,-5,92,4.35,26,59604.0,16:50,0,0,0,0.0,61,56,14,31,-17,1,6,7,7561.0,2:8,0,0,0,2653.0,0:44,3325000
8471752,Marc-Andre,Gragnani,1987-03-11,D,L,2015-16,4,0,0,0,0.0,-2,0,,2,3447.0,14:21,0,0,0,0.0,1,1,1,1,0,0,0,0,582.0,2:25,0,0,0,19.0,0:4,575000
8471760,Cody,Bass,1987-01-07,C,R,2015-16,17,0,0,0,0.0,-1,11,0.0,17,7816.0,7:39,12,9,21,57.14,26,8,2,0,2,0,0,0,13.0,0:0,0,0,0,203.0,0:11,575000
8471761,Chris,Butler,1986-10-27,D,L,2015-16,5,0,0,0,0.0,-1,4,0.0,4,3450.0,11:30,0,0,0,0.0,3,8,0,2,-2,0,0,0,102.0,0:20,0,0,0,93.0,0:18,675000
8471762,Chris,VandeVelde,1987-03-15,C,L,2015-16,79,2,12,14,0.18,-7,77,2.6,27,64236.0,13:33,6,15,21,28.57,139,60,21,18,3,0,0,0,489.0,0:6,1,0,1,10849.0,2:17,712500
8471766,Jared,Boll,1986-05-13,RW,R,2015-16,30,1,2,3,0.1,-3,11,9.09,61,11970.0,6:39,2,0,2,100.0,53,15,3,0,3,0,0,0,73.0,0:2,0,0,0,134.0,0:4,1700000
8471769,Niklas,Hjalmarsson,1987-06-06,D,L,2015-16,81,2,22,24,0.3,13,77,2.6,32,108758.0,22:22,0,0,0,0.0,32,151,31,65,-34,0,2,2,695.0,0:8,0,3,3,13942.0,2:52,4100000
8471794,Darren,Helm,1987-01-21,LW,L,2015-16,77,13,13,26,0.34,-2,165,7.88,32,69615.0,15:4,39,38,77,50.65,115,26,22,16,6,0,0,0,3372.0,0:43,0,0,0,8366.0,1:48,2125000
8471804,Nathan,Gerbe,1987-07-24,C,L,2015-16,47,3,4,7,0.15,-15,73,4.11,14,37957.0,13:27,2,3,5,40.0,54,10,13,23,-10,0,1,1,2907.0,1:1,0,0,0,2939.0,1:2,1750000
8471811,Cal,O'Reilly,1986-09-30,C,L,2015-16,20,3,4,7,0.35,-1,10,30.0,2,13416.0,11:10,59,50,109,54.13,3,5,2,6,-4,1,1,2,2349.0,1:57,0,0,0,65.0,0:3,700000
8471816,Mark,Fayne,1987-05-15,D,R,2015-16,69,2,5,7,0.1,-6,61,3.28,18,69208.0,16:43,0,0,0,0.0,53,100,13,36,-23,0,0,0,134.0,0:1,0,1,1,6827.0,1:38,3625000
8471817,Ryan,Reaves,1987-01-20,RW,R,2015-16,64,3,1,4,0.06,-6,31,9.68,68,30831.0,8:1,1,1,2,50.0,206,10,8,7,1,0,0,0,93.0,0:1,0,0,0,4.0,0:0,1125000
8471856,Joe,Vitale,1985-08-20,C,R,2015-16,1,0,0,0,0.0,1,1,0.0,5,373.0,6:13,0,1,1,0.0,1,0,0,0,0,0,0,0,16.0,0:16,0,0,0,46.0,0:46,1116667
8471862,Colin,Greening,1986-03-09,C,L,2015-16,31,7,8,15,0.48,-2,58,12.07,13,26219.0,14:5,13,8,21,61.9,90,10,10,10,0,1,1,2,4494.0,2:24,0,0,0,2.0,0:0,2650000
8471873,Anton,Stralman,1986-08-01,D,R,2015-16,73,9,25,34,0.47,16,127,7.09,20,96700.0,22:4,0,0,0,0.0,99,73,26,35,-9,1,11,12,12781.0,2:55,0,0,0,9153.0,2:5,4500000
8471887,Patric,Hornqvist,1987-01-01,RW,R,2015-16,82,22,29,51,0.62,15,257,8.56,36,82896.0,16:50,5,3,8,62.5,160,54,28,8,20,9,6,15,14926.0,3:2,0,0,0,141.0,0:1,4250000
8471916,Mike,Angelidis,1985-06-27,LW,L,2015-16,4,1,0,1,0.25,2,1,100.0,5,2160.0,9:0,10,21,31,32.26,6,1,1,1,0,0,0,0,57.0,0:14,0,0,0,60.0,0:15,650000
8471956,Andrew,Desjardins,1986-07-27,LW,L,2015-16,77,8,5,13,0.17,-8,96,8.33,30,61825.0,13:22,43,44,87,49.43,102,49,26,15,11,0,0,0,384.0,0:4,0,0,0,8373.0,1:48,800000
8471958,Dan,Girardi,1984-04-29,D,R,2015-16,74,2,15,17,0.23,18,77,2.6,20,90224.0,20:19,0,0,0,0.0,168,195,23,56,-33,0,0,0,538.0,0:7,0,1,1,12111.0,2:43,5500000
8471976,David,Desharnais,1986-09-14,C,L,2015-16,65,11,18,29,0.45,-6,90,12.22,20,62411.0,16:0,391,412,803,48.69,31,25,27,22,5,3,2,5,9010.0,2:18,0,0,0,76.0,0:1,3500000
8471996,Bracken,Kearns,1981-05-12,C,L,2015-16,2,0,1,1,0.5,1,0,,4,1907.0,15:53,8,4,12,66.67,5,2,0,1,-1,0,0,0,96.0,0:48,0,1,1,165.0,1:22,775000
8472382,Andy,Greene,1982-10-30,D,L,2015-16,82,4,9,13,0.16,7,63,6.35,26,112925.0,22:57,0,0,0,0.0,73,154,26,38,-12,1,1,2,1758.0,0:21,0,0,0,17123.0,3:28,5000000
8472410,Stephen,Gionta,1983-10-09,RW,R,2015-16,82,1,10,11,0.13,-13,62,1.61,43,60076.0,12:12,291,400,691,42.11,113,36,17,8,9,0,0,0,498.0,0:6,0,0,0,8739.0,1:46,850000
8473412,Bryan,Little,1987-11-12,C,R,2015-16,57,17,25,42,0.74,-13,127,13.39,12,67020.0,19:35,674,640,1314,51.29,48,22,20,26,-6,2,10,12,10066.0,2:56,2,0,2,6957.0,2:2,4700000
8473415,Alex,Biega,1988-04-04,D,R,2015-16,51,0,7,7,0.14,-11,61,0.0,22,51296.0,16:45,0,0,0,0.0,124,41,8,18,-10,0,0,0,666.0,0:13,0,0,0,3283.0,1:4,600000
8473419,Brad,Marchand,1988-05-11,LW,L,2015-16,77,37,24,61,0.79,21,250,14.8,90,85933.0,18:36,21,35,56,37.5,65,35,43,69,-26,6,2,8,6829.0,1:28,4,2,6,9258.0,2:0,4500000
8473422,Nick,Foligno,1987-10-31,LW,L,2015-16,72,12,25,37,0.51,-14,149,8.05,53,72972.0,16:53,83,93,176,47.16,152,46,27,25,2,0,13,13,8937.0,2:4,0,0,0,2401.0,0:33,5500000
8473426,Mike,Weber,1987-12-16,D,L,2015-16,45,1,4,5,0.11,2,40,2.5,60,41797.0,15:28,0,0,0,0.0,108,61,2,22,-20,0,0,0,28.0,0:0,0,0,0,4058.0,1:30,1666667
8473431,Bud,Holloway,1988-03-01,C,R,2015-16,1,0,0,0,0.0,0,1,0.0,0,439.0,7:19,0,1,1,0.0,0,0,2,1,1,0,0,0,0.0,0:0,0,0,0,0.0,0:0,-111
8473432,Derek,Dorsett,1986-12-20,RW,R,2015-16,71,5,11,16,0.23,-13,91,5.49,177,53635.0,12:35,3,7,10,30.0,127,44,11,14,-3,0,0,0,547.0,0:7,0,1,1,3353.0,0:47,2650000
8473446,Erik,Johnson,1988-03-21,D,R,2015-16,73,11,16,27,0.37,-19,175,6.29,50,102678.0,23:26,0,1,1,0.0,126,197,30,45,-15,3,3,6,8961.0,2:2,2,1,3,13545.0,3:5,3750000
8473449,Kyle,Okposo,1988-04-16,RW,R,2015-16,79,22,42,64,0.81,-4,202,10.89,51,86295.0,18:12,23,40,63,36.51,90,39,42,54,-12,7,16,23,14119.0,2:58,0,0,0,312.0,0:3,2800000
8473453,Trevor,Lewis,1987-01-08,C,R,2015-16,75,8,8,16,0.21,-10,167,4.79,20,65519.0,14:33,103,154,257,40.08,168,28,17,22,-5,0,1,1,1632.0,0:21,1,0,1,6889.0,1:31,1525000
8473463,Leo,Komarov,1987-01-23,C,L,2015-16,67,19,17,36,0.54,-12,130,14.62,40,71697.0,17:50,62,65,127,48.82,283,27,42,16,26,4,3,7,8934.0,2:13,1,0,1,6703.0,1:40,2950000
8473465,Jamie,McGinn,1988-08-05,LW,L,2015-16,84,22,17,39,0.46,-7,156,14.1,33,72035.0,14:17,4,3,7,57.14,164,27,18,19,-1,9,3,12,12148.0,2:24,0,0,0,26.0,0:0,2950000
8473466,Ryan,White,1988-03-17,C,R,2015-16,73,11,5,16,0.22,-9,88,12.5,101,55030.0,12:33,184,167,351,52.42,208,51,14,21,-7,3,0,3,4272.0,0:58,0,0,0,4198.0,0:57,800000
8473468,Eric,Gryba,1988-04-14,D,R,2015-16,53,1,5,6,0.11,0,58,1.72,75,56866.0,17:52,0,0,0,0.0,132,78,16,39,-23,0,0,0,142.0,0:2,0,0,0,7313.0,2:17,1250000
8473473,Milan,Lucic,1988-06-07,LW,L,2015-16,81,20,35,55,0.68,26,124,16.13,79,83772.0,17:14,7,13,20,35.0,244,22,22,48,-26,2,6,8,10358.0,2:7,0,0,0,242.0,0:2,6000000
8473482,Jiri,Tlusty,1988-03-16,LW,L,2015-16,30,2,2,4,0.13,-1,38,5.26,6,24681.0,13:42,0,0,0,0.0,39,13,8,4,4,1,1,2,1535.0,0:51,0,0,0,708.0,0:23,800000
8473485,Chris,Stewart,1987-10-30,RW,R,2015-16,56,8,12,20,0.36,2,78,10.26,73,36271.0,10:47,3,6,9,33.33,72,10,12,20,-8,1,4,5,3654.0,1:5,0,0,0,28.0,0:0,1700000
8473492,Matt,Beleskey,1988-06-07,LW,L,2015-16,80,15,22,37,0.46,6,168,8.93,65,76113.0,15:51,6,19,25,24.0,260,44,27,26,1,3,4,7,5936.0,1:14,0,0,0,337.0,0:4,3800000
8473504,Cal,Clutterbuck,1987-11-18,RW,R,2015-16,77,15,8,23,0.3,7,80,18.75,22,55052.0,11:54,1,2,3,33.33,288,34,21,20,1,0,0,0,502.0,0:6,2,1,3,9118.0,1:58,2750000
8473507,Jeff,Petry,1987-12-09,D,R,2015-16,51,5,11,16,0.31,-6,98,5.1,16,65350.0,21:21,1,0,1,100.0,86,73,16,50,-34,1,4,5,5493.0,1:47,0,3,3,7208.0,2:21,5500000
8473512,Claude,Giroux,1988-01-12,C,R,2015-16,78,22,45,67,0.86,-8,241,9.13,53,96157.0,20:32,1081,800,1881,57.47,83,36,41,45,-4,6,21,27,18039.0,3:51,1,1,2,6908.0,1:28,8275000
8473533,Jordan,Staal,1988-09-10,C,L,2015-16,82,20,28,48,0.59,6,151,13.25,34,90039.0,18:18,806,589,1395,57.78,165,31,55,50,5,6,4,10,8811.0,1:47,0,2,2,8732.0,1:46,6000000
8473534,Patrik,Berglund,1988-06-02,C,L,2015-16,42,10,5,15,0.36,1,80,12.5,16,39032.0,15:29,139,138,277,50.18,48,17,22,9,13,4,0,4,2025.0,0:48,0,0,0,3074.0,1:13,3700000
8473537,Viktor,Stalberg,1986-01-17,LW,L,2015-16,75,9,11,20,0.27,6,125,7.2,22,54914.0,12:12,2,4,6,33.33,144,33,29,22,7,0,0,0,167.0,0:2,0,0,0,5739.0,1:16,3000000
8473542,Tom,Sestito,1987-09-28,LW,L,2015-16,4,0,1,1,0.25,1,1,0.0,19,1391.0,5:47,0,0,0,0.0,13,1,0,1,-1,0,0,0,0.0,0:0,0,0,0,0.0,0:0,575000
8473544,Derick,Brassard,1987-09-22,C,L,2015-16,80,27,31,58,0.72,12,182,14.84,30,85849.0,17:53,676,670,1346,50.22,103,23,47,56,-9,8,14,22,12926.0,2:41,0,0,0,766.0,0:9,5000000
8473546,Michael,Grabner,1987-10-05,RW,L,2015-16,80,9,9,18,0.22,-4,116,7.76,12,69452.0,14:28,3,10,13,23.08,41,55,66,21,45,0,0,0,537.0,0:6,1,0,1,14909.0,3:6,3000000
8473548,Phil,Kessel,1987-10-02,RW,R,2015-16,82,26,33,59,0.72,9,274,9.49,18,90436.0,18:22,2,3,5,40.0,9,13,26,55,-29,4,13,17,17288.0,3:30,0,0,0,133.0,0:1,8000000
8473550,Andrew,Bodnarchuk,1988-07-11,D,L,2015-16,37,0,4,4,0.11,-7,9,0.0,14,27394.0,12:20,0,0,0,0.0,44,27,2,6,-4,0,0,0,131.0,0:3,0,0,0,562.0,0:15,650000
8473560,Korbinian,Holzer,1988-02-16,D,R,2015-16,29,0,3,3,0.1,-3,17,0.0,10,25672.0,14:45,0,0,0,0.0,57,32,2,8,-6,0,0,0,32.0,0:1,0,0,0,2259.0,1:17,750000
8473562,John,McCarthy,1986-08-09,C,L,2015-16,1,0,0,0,0.0,0,0,,0,425.0,7:5,0,1,1,0.0,0,1,0,1,-1,0,0,0,0.0,0:0,0,0,0,0.0,0:0,600000
8473563,Nicklas,Backstrom,1987-11-23,C,L,2015-16,75,20,50,70,0.93,17,129,15.5,36,86318.0,19:10,659,698,1357,48.56,51,50,42,27,15,3,27,30,13820.0,3:4,0,0,0,4037.0,0:53,6700000
8473564,Michael,Frolik,1988-02-17,RW,L,2015-16,64,15,17,32,0.5,1,155,9.68,24,60706.0,15:48,5,5,10,50.0,49,44,27,21,6,0,1,1,1700.0,0:26,2,2,4,6588.0,1:42,4300000
8473565,Brian,Strait,1988-01-04,D,L,2015-16,52,1,5,6,0.12,1,43,2.33,31,48164.0,15:26,0,0,0,0.0,106,65,9,26,-17,0,0,0,140.0,0:2,0,1,1,4883.0,1:33,775000
8473571,Jamie,McBain,1988-02-25,D,R,2015-16,44,2,7,9,0.2,2,32,6.25,6,32304.0,12:14,0,0,0,0.0,20,38,2,13,-11,1,5,6,2501.0,0:56,0,0,0,195.0,0:4,600000
8473573,Artem,Anisimov,1988-05-24,C,L,2015-16,77,20,22,42,0.55,8,121,16.53,12,83571.0,18:5,507,641,1148,44.16,53,40,28,14,14,5,5,10,10497.0,2:16,3,1,4,6264.0,1:21,3283333
8473574,Shawn,Matthias,1988-02-19,LW,L,2015-16,71,12,16,28,0.39,-17,101,11.88,20,57565.0,13:30,9,15,24,37.5,68,39,34,12,22,0,0,0,2315.0,0:32,0,1,1,4557.0,1:4,2300000
8473579,Nikolay,Kulemin,1986-07-14,LW,L,2015-16,81,9,13,22,0.27,13,92,9.78,22,68336.0,14:3,23,36,59,38.98,107,50,32,31,1,0,0,0,251.0,0:3,0,0,0,9931.0,2:2,4187500
8473584,Andrew,MacDonald,1986-09-07,D,L,2015-16,28,1,7,8,0.29,10,20,5.0,6,33800.0,20:7,0,0,0,0.0,14,72,4,20,-16,0,2,2,1273.0,0:45,0,0,0,3040.0,1:48,5000000
8473588,Erik,Condra,1986-08-06,RW,R,2015-16,54,6,5,11,0.2,-4,58,10.34,34,34690.0,10:42,1,2,3,33.33,20,16,15,12,3,0,0,0,251.0,0:4,0,0,0,3798.0,1:10,1250000
8473589,Chris,Summers,1988-02-05,D,L,2015-16,3,0,0,0,0.0,-2,5,0.0,4,2770.0,15:23,0,0,0,0.0,4,1,0,0,0,0,0,0,0.0,0:0,0,0,0,200.0,1:6,600000
8473604,Jonathan,Toews,1988-04-29,C,L,2015-16,80,28,30,58,0.72,16,179,15.64,62,92390.0,19:14,921,652,1573,58.55,81,38,57,28,29,6,3,9,11705.0,2:26,4,3,7,6792.0,1:24,10500000
8473618,Mathieu,Perreault,1988-01-05,C,L,2015-16,71,9,32,41,0.58,-11,133,6.77,36,70499.0,16:32,94,109,203,46.31,83,33,31,26,5,6,9,15,12263.0,2:52,0,0,0,182.0,0:2,3000000
8473646,Ryan,Carter,1983-08-03,LW,L,2015-16,60,7,5,12,0.2,-3,62,11.29,48,40107.0,11:8,21,18,39,53.85,87,37,17,7,10,0,0,0,136.0,0:2,1,0,1,5983.0,1:39,625000
8473658,Victor,Bartley,1988-02-17,D,L,2015-16,10,0,0,0,0.0,2,8,0.0,6,7991.0,13:19,0,0,0,0.0,21,17,0,7,-7,0,0,0,28.0,0:2,0,0,0,67.0,0:6,666667
8473673,David,Schlemko,1987-05-07,D,L,2015-16,67,6,13,19,0.28,-22,104,5.77,16,74969.0,18:38,0,0,0,0.0,47,88,16,29,-13,1,11,12,8065.0,2:0,0,0,0,6364.0,1:34,625000
8473722,John,Scott,1982-09-26,LW,L,2015-16,12,0,1,1,0.08,-1,6,0.0,27,4700.0,6:31,0,0,0,0.0,23,3,1,3,-2,0,0,0,27.0,0:2,0,0,0,113.0,0:9,575000
8473914,Mark,Letestu,1985-02-04,C,R,2015-16,82,10,15,25,0.3,-21,107,9.35,10,77649.0,15:46,596,566,1162,51.29,68,33,28,29,-1,3,9,12,9847.0,2:0,2,1,3,12139.0,2:28,1800000
8473933,Ben,Lovejoy,1984-02-20,D,R,2015-16,66,4,6,10,0.15,9,90,4.44,30,74713.0,18:52,0,0,0,0.0,154,104,20,18,2,0,0,0,308.0,0:4,0,1,1,9838.0,2:29,1100000
8473962,Teddy,Purcell,1985-09-08,LW,R,2015-16,76,14,29,43,0.57,-11,149,9.4,12,76744.0,16:49,2,4,6,33.33,31,15,31,34,-3,2,8,10,11530.0,2:31,0,1,1,2468.0,0:32,4500000
8473970,Rob,Klinkhammer,1986-08-12,LW,L,2015-16,14,1,0,1,0.07,-6,10,10.0,6,7906.0,9:24,1,0,1,100.0,47,4,3,3,0,0,0,0,1.0,0:0,0,0,0,347.0,0:24,725000
8473986,Alex,Killorn,1989-09-14,LW,L,2015-16,81,14,26,40,0.49,14,154,9.09,44,81625.0,16:47,31,49,80,38.75,76,23,31,46,-15,3,3,6,11252.0,2:18,0,1,1,2248.0,0:27,2550000
8473989,Luke,Gazdic,1989-07-25,LW,L,2015-16,29,1,0,1,0.03,-6,18,5.56,24,10784.0,6:11,0,1,1,0.0,35,9,2,1,1,0,0,0,2.0,0:0,0,0,0,0.0,0:0,800000
8473991,Karl,Alzner,1988-09-24,D,L,2015-16,82,4,17,21,0.26,14,75,5.33,26,105165.0,21:22,0,0,0,0.0,135,207,24,41,-17,0,0,0,251.0,0:3,0,0,0,13990.0,2:50,2800000
8473992,Justin,Falk,1988-10-11,D,L,2015-16,24,0,4,4,0.17,2,16,0.0,17,20485.0,14:13,0,0,0,0.0,37,38,3,9,-6,0,0,0,26.0,0:1,0,0,0,1320.0,0:55,600000
8473994,Jamie,Benn,1989-07-18,LW,L,2015-16,82,41,48,89,1.09,7,247,16.6,64,98508.0,20:1,226,252,478,47.28,156,55,65,80,-15,17,13,30,15747.0,3:12,2,3,5,7725.0,1:34,5250000
8474000,Steven,Kampfer,1988-09-24,D,R,2015-16,47,0,4,4,0.09,5,54,0.0,26,42566.0,15:5,1,1,2,50.0,70,70,5,10,-5,0,1,1,592.0,0:12,0,0,0,2408.0,0:51,612500
8474005,Alex,Grant,1989-01-20,D,R,2015-16,5,0,0,0,0.0,-2,4,0.0,7,3970.0,13:14,0,0,0,0.0,7,2,1,0,1,0,0,0,221.0,0:44,0,0,0,171.0,0:34,600000
8474008,Paul,Carey,1988-09-24,C,L,2015-16,4,1,0,1,0.25,0,5,20.0,0,2393.0,9:58,0,0,0,0.0,6,1,0,0,0,0,0,0,0.0,0:0,0,0,0,28.0,0:7,575000
8474009,Nick,Bonino,1988-04-20,C,L,2015-16,63,9,20,29,0.46,13,97,9.28,31,59871.0,15:50,463,455,918,50.44,22,67,32,17,15,2,0,2,6025.0,1:35,1,0,1,8804.0,2:19,1900000
8474013,Ian,Cole,1989-02-21,D,L,2015-16,70,0,12,12,0.17,-3,72,0.0,59,72404.0,17:14,0,0,0,0.0,122,122,8,32,-24,0,1,1,1543.0,0:22,0,0,0,9718.0,2:18,2100000
8474019,Tommy,Cross,1989-09-12,D,L,2015-16,3,0,1,1,0.33,-1,0,,0,2356.0,13:5,0,0,0,0.0,3,1,0,0,0,0,0,0,0.0,0:0,0,1,1,347.0,1:55,600000
8474024,Jim,O'Brien,1989-01-29,C,R,2015-16,4,0,0,0,0.0,-4,3,0.0,2,3244.0,13:31,29,20,49,59.18,7,2,0,1,-1,0,0,0,9.0,0:2,0,0,0,121.0,0:30,575000
8474025,Eric,Tangradi,1989-02-10,LW,L,2015-16,1,0,0,0,0.0,0,0,,0,415.0,6:55,0,1,1,0.0,1,0,0,0,0,0,0,0,0.0,0:0,0,0,0,0.0,0:0,575000
8474027,Justin,Braun,1987-02-10,D,R,2015-16,80,4,19,23,0.29,11,114,3.51,36,98685.0,20:33,0,0,0,0.0,95,140,33,46,-13,0,1,1,3224.0,0:40,0,0,0,9543.0,1:59,3800000
8474031,Kevin,Shattenkirk,1989-01-29,D,R,2015-16,72,14,30,44,0.61,-14,180,7.78,51,96864.0,22:25,0,0,0,0.0,82,113,37,39,-2,6,20,26,11973.0,2:46,0,1,1,8299.0,1:55,4250000
8474034,Patrick,Maroon,1988-04-23,LW,L,2015-16,72,12,15,27,0.38,-7,104,11.54,88,53302.0,12:20,17,36,53,32.08,151,10,10,30,-20,5,3,8,6632.0,1:32,0,0,0,15.0,0:0,2000000
8474037,James,van Riemsdyk,1989-05-04,LW,L,2015-16,40,14,15,29,0.72,3,129,10.85,6,42631.0,17:45,1,1,2,50.0,52,7,29,13,16,5,4,9,6658.0,2:46,0,0,0,65.0,0:1,4250000
8474038,Paul,Byron,1989-04-27,LW,L,2015-16,62,11,7,18,0.29,-9,50,22.0,11,51182.0,13:45,3,2,5,60.0,112,25,23,15,8,0,0,0,506.0,0:8,3,2,5,6862.0,1:50,900000
8474040,Sam,Gagner,1989-08-10,C,R,2015-16,53,8,8,16,0.3,4,86,9.3,25,44077.0,13:51,34,63,97,35.05,17,15,20,13,7,2,1,3,6087.0,1:54,0,0,0,20.0,0:0,4800000
8474052,Chris,Terry,1989-04-07,LW,L,2015-16,68,8,3,11,0.16,-12,78,10.26,16,46001.0,11:16,1,8,9,11.11,82,21,21,20,1,0,0,0,2224.0,0:32,0,0,0,29.0,0:0,875000
8474053,Logan,Couture,1989-03-28,C,L,2015-16,52,15,21,36,0.69,2,137,10.95,20,54248.0,17:23,271,305,576,47.05,29,38,39,36,3,5,10,15,11399.0,3:39,0,0,0,2336.0,0:44,6000000
8474056,P.K.,Subban,1989-05-13,D,R,2015-16,68,6,45,51,0.75,4,176,3.41,75,107558.0,26:21,0,0,0,0.0,102,80,23,106,-83,2,22,24,18831.0,4:36,0,0,0,9566.0,2:20,9000000
8474061,Anthony,Peluso,1989-04-18,RW,R,2015-16,35,1,4,5,0.14,4,16,6.25,44,13407.0,6:23,0,0,0,0.0,81,4,3,6,-3,0,0,0,90.0,0:2,0,0,0,0.0,0:0,675000
8474062,Riley,Nash,1989-05-09,C,R,2015-16,64,9,13,22,0.34,-5,76,11.84,18,49752.0,12:57,193,197,390,49.49,58,21,47,13,34,2,4,6,3924.0,1:1,0,0,0,3314.0,0:51,1150000
8474066,Thomas,Hickey,1989-02-08,D,L,2015-16,62,6,12,18,0.29,9,55,10.91,30,64745.0,17:24,0,0,0,0.0,65,90,18,41,-23,0,0,0,1399.0,0:22,0,0,0,7776.0,2:5,2200000
8474068,Kyle,Turris,1989-08-14,C,R,2015-16,57,13,17,30,0.53,-15,122,10.66,32,67390.0,19:42,536,508,1044,51.34,44,31,16,24,-8,3,5,8,11064.0,3:14,0,1,1,1134.0,0:19,3500000
8474074,Paul,Postma,1989-02-22,D,R,2015-16,26,2,0,2,0.08,-3,24,8.33,4,17866.0,11:27,0,0,0,0.0,13,14,4,8,-4,0,0,0,842.0,0:32,0,0,0,44.0,0:1,887500
8474089,Brad,Malone,1989-05-20,C,L,2015-16,57,2,4,6,0.11,-11,31,6.45,75,32659.0,9:32,40,22,62,64.52,124,15,4,16,-12,0,0,0,144.0,0:2,0,0,0,3922.0,1:8,650000
8474090,Brendan,Smith,1989-02-08,D,L,2015-16,63,3,12,15,0.24,1,82,3.66,62,66540.0,17:36,0,0,0,0.0,94,42,10,35,-25,1,0,1,2317.0,0:36,0,0,0,4387.0,1:9,2750000
8474091,Brandon,Sutter,1989-02-14,C,R,2015-16,20,5,4,9,0.45,3,45,11.11,2,21572.0,17:58,146,132,278,52.52,12,10,4,5,-1,1,0,1,2814.0,2:20,1,0,1,2553.0,2:7,3300000
8474094,Matt,Halischuk,1988-06-01,RW,R,2015-16,30,0,3,3,0.1,1,39,0.0,4,17014.0,9:27,1,2,3,33.33,38,11,5,3,2,0,0,0,73.0,0:2,0,0,0,732.0,0:24,750000
8474096,Nick,Spaling,1988-09-19,C,L,2015-16,58,3,10,13,0.22,-2,53,5.66,24,49684.0,14:16,309,292,601,51.41,65,45,31,13,18,0,0,0,317.0,0:5,0,0,0,7611.0,2:11,2200000
8474098,Colton,Sceviour,1989-04-20,C,R,2015-16,71,11,12,23,0.32,6,125,8.8,21,54007.0,12:40,9,15,24,37.5,71,52,30,27,3,1,2,3,2368.0,0:33,0,1,1,7132.0,1:40,650000
8474100,Dwight,King,1989-07-05,LW,L,2015-16,47,7,6,13,0.28,-6,48,14.58,24,40713.0,14:26,2,5,7,28.57,73,6,5,6,-1,0,0,0,1197.0,0:25,0,0,0,3630.0,1:17,1950000
8474102,David,Perron,1988-05-28,LW,R,2015-16,71,12,24,36,0.51,-1,147,8.16,62,64806.0,15:12,2,8,10,20.0,142,23,22,20,2,4,8,12,8817.0,2:4,0,0,0,122.0,0:1,3812500
8474113,TJ,Brennan,1989-04-03,D,L,2015-16,7,1,0,1,0.14,-6,11,9.09,6,6341.0,15:5,0,0,0,0.0,7,5,2,2,0,0,0,0,110.0,0:15,0,0,0,160.0,0:22,675000
8474125,Carl,Gunnarsson,1986-11-09,D,L,2015-16,72,3,6,9,0.12,7,51,5.88,31,75080.0,17:22,0,0,0,0.0,67,119,14,23,-9,1,0,1,461.0,0:6,0,0,0,8739.0,2:1,3150000
8474134,Yannick,Weber,1988-09-23,D,R,2015-16,45,0,7,7,0.16,-17,65,0.0,24,50841.0,18:49,0,0,0,0.0,49,37,10,15,-5,0,5,5,6182.0,2:17,0,0,0,2152.0,0:47,1500000
8474138,Dustin,Jeffrey,1988-02-27,LW,L,2015-16,7,1,1,2,0.29,2,5,20.0,2,4791.0,11:24,35,23,58,60.34,2,1,0,0,0,0,0,0,485.0,1:9,0,0,0,0.0,0:0,575000
8474141,Patrick,Kane,1988-11-19,RW,L,2015-16,82,46,60,106,1.29,17,287,16.03,30,100419.0,20:24,11,40,51,21.57,37,21,34,37,-3,17,20,37,15390.0,3:7,0,0,0,219.0,0:2,10500000
8474145,Robert,Bortuzzo,1989-03-18,D,R,2015-16,40,2,1,3,0.08,2,47,4.26,52,31846.0,13:16,0,0,0,0.0,93,42,5,9,-4,0,0,0,40.0,0:1,0,0,0,2278.0,0:56,1050000
8474150,Mikael,Backlund,1989-03-17,C,L,2015-16,82,21,26,47,0.57,10,155,13.55,28,80831.0,16:25,539,604,1143,47.16,68,51,57,44,13,3,6,9,7862.0,1:35,3,1,4,8657.0,1:45,3575000
8474151,Ryan,McDonagh,1989-06-13,D,L,2015-16,73,9,25,34,0.47,26,113,7.96,22,97903.0,22:21,1,0,1,100.0,98,138,31,67,-36,2,7,9,8403.0,1:55,0,1,1,11558.0,2:38,4700000
8474157,Max,Pacioretty,1988-11-20,LW,L,2015-16,82,30,34,64,0.78,-10,303,9.9,34,91154.0,18:31,6,7,13,46.15,102,37,35,33,2,8,9,17,14408.0,2:55,1,0,1,5805.0,1:10,4500000
8474161,Jakub,Voracek,1989-08-15,RW,L,2015-16,73,11,44,55,0.75,-5,213,5.16,38,81407.0,18:35,3,3,6,50.0,51,34,26,50,-24,1,22,23,15433.0,3:31,0,0,0,219.0,0:3,4250000
8474162,Jake,Muzzin,1989-02-21,D,L,2015-16,82,8,32,40,0.49,7,203,3.94,64,113460.0,23:3,0,0,0,0.0,197,135,13,68,-55,1,12,13,11390.0,2:18,0,1,1,12416.0,2:31,4000000
8474166,Alec,Martinez,1987-07-26,D,L,2015-16,78,10,21,31,0.4,16,124,8.06,40,98985.0,21:9,0,0,0,0.0,164,182,8,60,-52,4,9,13,9282.0,1:59,0,1,1,10566.0,2:15,4000000
8474168,Joakim,Andersson,1989-02-05,C,L,2015-16,29,1,2,3,0.1,1,17,5.88,6,15695.0,9:1,32,38,70,45.71,14,5,1,0,1,0,0,0,123.0,0:4,0,0,0,3242.0,1:51,815000
8474176,Carl,Hagelin,1988-08-23,LW,L,2015-16,80,14,25,39,0.49,8,178,7.87,32,75393.0,15:42,6,8,14,42.86,84,33,30,35,-5,0,0,0,1130.0,0:14,0,2,2,7897.0,1:38,4000000
8474189,Lars,Eller,1989-05-08,C,L,2015-16,79,13,13,26,0.33,-13,149,8.72,28,72319.0,15:15,207,202,409,50.61,111,36,46,25,21,1,0,1,4602.0,0:58,1,0,1,6353.0,1:20,3500000
8474190,Wayne,Simmonds,1988-08-26,RW,R,2015-16,81,32,28,60,0.74,-7,229,13.97,147,83758.0,17:14,5,2,7,71.43,192,44,25,31,-6,13,8,21,17600.0,3:37,0,0,0,134.0,0:1,3975000
8474207,Nick,Holden,1987-05-15,D,L,2015-16,82,6,16,22,0.27,-1,98,6.12,24,107652.0,21:52,0,0,0,0.0,217,118,21,26,-5,0,1,1,3745.0,0:45,0,0,0,11508.0,2:20,1650000
8474218,Jason,Demers,1988-06-09,D,R,2015-16,62,7,16,23,0.37,16,94,7.45,72,77629.0,20:52,0,0,0,0.0,86,73,28,41,-13,3,2,5,6258.0,1:40,1,0,1,8891.0,2:23,3400000
8474230,Micheal,Haley,1986-03-30,C,L,2015-16,16,1,0,1,0.06,-2,10,10.0,48,6814.0,7:5,11,8,19,57.89,39,4,0,9,-9,0,0,0,18.0,0:1,0,0,0,0.0,0:0,600000
8474250,Zack,Smith,1988-04-05,LW,L,2015-16,81,25,11,36,0.44,16,121,20.66,80,74843.0,15:23,380,349,729,52.13,175,26,33,26,7,4,1,5,7735.0,1:35,5,1,6,6419.0,1:19,1887500
8474291,Jay,Beagle,1985-10-16,C,R,2015-16,57,8,9,17,0.3,0,74,10.81,24,47935.0,14:0,370,267,637,58.08,55,24,20,12,8,0,0,0,194.0,0:3,0,0,0,6809.0,1:59,1750000
8474497,Michael,Kostka,1985-11-28,D,R,2015-16,15,0,1,1,0.07,6,9,0.0,4,13363.0,14:50,0,0,0,0.0,7,20,0,6,-6,0,0,0,10.0,0:0,0,0,0,541.0,0:36,800000
8474516,Bryan,Lerg,1986-01-20,C,L,2015-16,6,0,0,0,0.0,1,4,0.0,0,3195.0,8:52,17,16,33,51.52,13,3,0,0,0,0,0,0,0.0,0:0,0,0,0,201.0,0:33,600000
8474520,Jason,Garrison,1984-11-13,D,L,2015-16,72,5,6,11,0.15,-4,99,5.05,18,79763.0,18:27,0,0,0,0.0,88,105,15,45,-30,0,0,0,2864.0,0:39,0,0,0,8087.0,1:52,4600000
8474554,Eric,Selleck,1987-10-20,LW,L,2015-16,1,0,0,0,0.0,0,1,0.0,5,573.0,9:33,0,0,0,0.0,3,0,0,0,0,0,0,0,22.0,0:22,0,0,0,0.0,0:0,575000
8474563,Drew,Doughty,1989-12-08,D,R,2015-16,82,14,37,51,0.62,24,197,7.11,52,137848.0,28:1,0,0,0,0.0,125,105,10,97,-87,9,15,24,15066.0,3:3,1,1,2,14468.0,2:56,7000000
8474564,Steven,Stamkos,1990-02-07,C,R,2015-16,77,36,28,64,0.83,3,216,16.67,38,91266.0,19:45,463,464,927,49.95,109,35,45,45,0,14,9,23,16094.0,3:29,1,2,3,3576.0,0:46,7500000
8474565,Alex,Pietrangelo,1990-01-18,D,R,2015-16,73,7,30,37,0.51,10,182,3.85,20,115215.0,26:18,0,0,0,0.0,48,136,41,39,2,1,4,5,10041.0,2:17,0,1,1,13969.0,3:11,6500000
8474567,Zach,Bogosian,1990-07-15,D,R,2015-16,64,7,17,24,0.38,-11,121,5.79,68,85815.0,22:20,0,0,0,0.0,86,98,17,21,-4,3,3,6,5668.0,1:28,0,1,1,5362.0,1:23,5142857
8474568,Luke,Schenn,1989-11-02,D,R,2015-16,72,4,12,16,0.22,-2,76,5.26,82,75908.0,17:34,1,1,2,50.0,234,106,11,53,-42,1,0,1,1117.0,0:15,0,0,0,9240.0,2:8,3600000
8474569,Colin,Wilson,1989-10-20,C,L,2015-16,64,6,18,24,0.38,-1,108,5.56,14,55513.0,14:27,14,21,35,40.0,61,25,24,26,-2,1,0,1,5576.0,1:27,0,0,0,105.0,0:1,3937500
8474570,Cody,Hodgson,1990-02-18,C,R,2015-16,39,3,5,8,0.21,2,65,4.62,6,25115.0,10:43,46,52,98,46.94,25,6,7,7,0,0,1,1,282.0,0:7,0,0,0,74.0,0:1,4250000
8474571,Mikkel,Boedker,1989-12-16,LW,L,2015-16,80,17,34,51,0.64,-33,166,10.24,12,88941.0,18:31,1,2,3,33.33,51,31,38,32,6,3,16,19,18964.0,3:57,0,0,0,354.0,0:4,3750000
8474573,Josh,Bailey,1989-10-02,RW,L,2015-16,81,12,20,32,0.4,-7,105,11.43,22,77028.0,15:50,14,20,34,41.18,45,25,41,49,-8,4,1,5,6953.0,1:25,0,0,0,2494.0,0:30,3300000
8474574,Tyler,Myers,1990-02-01,D,R,2015-16,73,9,18,27,0.37,6,140,6.43,72,99068.0,22:37,0,1,1,0.0,54,95,45,47,-2,0,2,2,9936.0,2:16,0,1,1,9338.0,2:7,5500000
8474577,Joe,Colborne,1990-01-30,C,L,2015-16,73,19,25,44,0.6,-9,100,19.0,27,66425.0,15:9,85,70,155,54.84,122,28,27,32,-5,3,2,5,8908.0,2:2,0,0,0,1204.0,0:16,1275000
8474578,Erik,Karlsson,1990-05-31,D,R,2015-16,82,16,66,82,1.0,-2,248,6.45,50,142555.0,28:58,0,1,1,0.0,84,175,61,96,-35,1,25,26,22891.0,4:39,0,0,0,6538.0,1:19,6500000
8474579,Luca,Sbisa,1990-01-30,D,L,2015-16,41,2,6,8,0.2,5,29,6.9,26,42743.0,17:22,0,0,0,0.0,71,58,5,12,-7,0,0,0,200.0,0:4,0,1,1,4379.0,1:46,3600000
8474581,Jake,Gardiner,1990-07-04,D,L,2015-16,79,7,24,31,0.39,-15,122,5.74,32,97743.0,20:37,2,0,2,100.0,87,67,33,74,-41,1,11,12,11025.0,2:19,0,1,1,1673.0,0:21,4050000
8474584,Michael,Del Zotto,1990-06-24,D,L,2015-16,52,4,9,13,0.25,-8,98,4.08,16,73048.0,23:24,0,0,0,0.0,140,104,14,31,-17,0,1,1,4426.0,1:25,0,0,0,7880.0,2:31,3875000
8474586,Jordan,Eberle,1990-05-15,C,R,2015-16,69,25,22,47,0.68,-12,173,14.45,14,73924.0,17:51,5,3,8,62.5,28,23,30,41,-11,7,4,11,10924.0,2:38,0,0,0,105.0,0:1,6000000
8474588,Viktor,Tikhonov,1988-05-12,RW,R,2015-16,50,3,3,6,0.12,-10,41,7.32,20,34303.0,11:26,45,71,116,38.79,54,25,12,10,2,2,0,2,2124.0,0:42,0,0,0,279.0,0:5,1040000
8474589,Tyler,Ennis,1989-10-06,LW,L,2015-16,23,3,8,11,0.48,-9,57,5.26,11,24934.0,18:4,2,0,2,100.0,30,8,11,16,-5,2,2,4,3936.0,2:51,0,0,0,18.0,0:0,4600000
8474590,John,Carlson,1990-01-10,D,R,2015-16,56,8,31,39,0.7,16,124,6.45,14,79637.0,23:42,0,0,0,0.0,46,114,24,47,-23,2,12,14,11093.0,3:18,0,1,1,7328.0,2:10,3966667
8474597,Cody,Goloubef,1989-11-30,D,R,2015-16,43,1,7,8,0.19,-3,40,2.5,20,39027.0,15:7,0,0,0,0.0,31,48,3,11,-8,0,0,0,318.0,0:7,0,0,0,2181.0,0:50,750000
8474600,Roman,Josi,1990-06-01,D,L,2015-16,81,14,47,61,0.75,-3,198,7.07,43,123853.0,25:29,0,0,0,0.0,59,185,21,43,-22,6,18,24,14901.0,3:3,1,1,2,13112.0,2:41,4000000
8474602,Justin,Schultz,1990-07-06,D,R,2015-16,63,4,14,18,0.29,-15,82,4.88,16,69721.0,18:26,0,2,2,0.0,36,72,21,40,-19,2,6,8,8213.0,2:10,0,0,0,3085.0,0:48,3900000
8474604,Aaron,Ness,1990-05-18,D,L,2015-16,8,0,2,2,0.25,4,8,0.0,2,5946.0,12:23,0,0,0,0.0,4,7,0,2,-2,0,0,0,9.0,0:1,0,0,0,72.0,0:9,575000
8474605,Patrick,Wiercioch,1990-09-12,D,L,2015-16,52,0,5,5,0.1,2,56,0.0,24,54103.0,17:20,0,0,0,0.0,53,56,7,33,-26,0,2,2,1145.0,0:22,0,0,0,1774.0,0:34,2000000
8474610,Zac,Dalpe,1989-11-01,C,R,2015-16,2,1,0,1,0.5,0,3,33.33,0,1230.0,10:15,11,6,17,64.71,3,0,0,0,0,0,0,0,35.0,0:17,0,0,0,34.0,0:17,600000
8474612,Travis,Hamonic,1990-08-16,D,R,2015-16,72,5,16,21,0.29,-5,147,3.4,35,102918.0,23:49,0,0,0,0.0,148,128,44,61,-17,0,0,0,3588.0,0:49,1,0,1,9824.0,2:16,3857143
8474613,Derek,Stepan,1990-06-18,C,R,2015-16,72,22,31,53,0.74,5,192,11.46,20,76703.0,17:45,515,588,1103,46.69,38,39,62,30,32,5,9,14,10227.0,2:22,3,0,3,7395.0,1:42,6500000
8474616,Patrice,Cormier,1990-06-14,C,L,2015-16,2,0,0,0,0.0,0,1,0.0,0,539.0,4:29,3,6,9,33.33,1,0,0,0,0,0,0,0,44.0,0:22,0,0,0,0.0,0:0,650000
8474618,Marco,Scandella,1990-02-23,D,L,2015-16,73,5,16,21,0.29,6,126,3.97,22,90666.0,20:42,0,0,0,0.0,66,105,23,39,-16,2,1,3,2576.0,0:35,0,1,1,7943.0,1:48,4000000
8474625,Jimmy,Hayes,1989-11-21,RW,R,2015-16,75,13,16,29,0.39,-12,127,10.24,60,62219.0,13:49,42,70,112,37.5,128,15,25,28,-3,3,2,5,5829.0,1:17,0,0,0,14.0,0:0,2300000
8474627,Jori,Lehtera,1987-12-23,C,L,2015-16,79,9,25,34,0.43,12,83,10.84,38,76232.0,16:4,485,484,969,50.05,43,26,29,19,10,1,8,9,8786.0,1:51,0,0,0,3900.0,0:49,2750000
8474628,Michael,Stone,1990-06-07,D,R,2015-16,75,6,30,36,0.48,-10,161,3.73,62,101099.0,22:27,0,2,2,0.0,137,143,15,20,-5,0,14,14,13022.0,2:53,0,0,0,9484.0,2:6,1150000
8474638,Andrew,Campbell,1988-02-04,D,L,2015-16,6,0,1,1,0.17,0,1,0.0,2,4170.0,11:35,0,0,0,0.0,5,10,1,1,0,0,0,0,3.0,0:0,0,0,0,138.0,0:23,575000
8474641,Adam,Henrique,1990-02-06,C,L,2015-16,80,30,20,50,0.62,10,149,20.13,23,95167.0,19:49,617,764,1381,44.68,66,56,38,27,11,7,5,12,12886.0,2:41,2,1,3,12636.0,2:37,4000000
8474642,Lance,Bouma,1990-03-25,LW,L,2015-16,44,2,5,7,0.16,-6,49,4.08,31,31774.0,12:2,5,8,13,38.46,110,42,6,10,-4,0,0,0,87.0,0:1,0,2,2,4784.0,1:48,2200000
8474660,David,Warsofsky,1990-05-30,D,L,2015-16,22,1,1,2,0.09,-9,40,2.5,2,22603.0,17:7,0,0,0,0.0,5,23,4,17,-13,1,1,2,2853.0,2:9,0,0,0,70.0,0:3,600000
8474661,Michal,Jordan,1990-07-17,D,L,2015-16,36,1,0,1,0.03,-5,36,2.78,12,32768.0,15:10,0,0,0,0.0,24,34,6,8,-2,0,0,0,155.0,0:4,0,0,0,1137.0,0:31,625000
8474668,Dale,Weise,1988-08-05,RW,R,2015-16,71,14,13,27,0.38,4,136,10.29,24,57147.0,13:24,16,19,35,45.71,127,26,18,16,2,3,3,6,6011.0,1:24,0,0,0,740.0,0:10,1025000
8474673,TJ,Brodie,1990-06-07,D,L,2015-16,70,6,39,45,0.64,4,79,7.59,18,106094.0,25:15,0,0,0,0.0,15,104,47,91,-44,2,7,9,9764.0,2:19,0,2,2,10908.0,2:35,4650400
8474679,Gustav,Nyquist,1989-09-01,RW,L,2015-16,82,17,26,43,0.52,-2,161,10.56,34,74638.0,15:10,0,2,2,0.0,58,19,28,26,2,7,5,12,13719.0,2:47,0,0,0,67.0,0:0,4750000
8474683,Derek,Grant,1990-04-20,C,L,2015-16,15,0,1,1,0.07,-7,22,0.0,2,9791.0,10:52,61,50,111,54.95,25,11,3,1,2,0,0,0,236.0,0:15,0,0,0,877.0,0:58,700000
8474685,Matt,Calvert,1989-12-24,LW,L,2015-16,73,11,13,24,0.33,1,114,9.65,51,66261.0,15:7,7,7,14,50.0,91,46,36,10,26,1,0,1,719.0,0:9,0,0,0,9342.0,2:7,2200000
8474688,Greg,Pateryn,1990-06-20,D,R,2015-16,38,1,6,7,0.18,-8,32,3.12,49,38187.0,16:44,0,0,0,0.0,100,52,12,31,-19,0,0,0,547.0,0:14,0,0,0,3026.0,1:19,562500
8474697,Mark,Borowiecki,1989-07-12,D,L,2015-16,63,1,1,2,0.03,-4,27,3.7,107,55290.0,14:37,0,1,1,0.0,271,99,3,22,-19,0,0,0,104.0,0:1,0,0,0,8905.0,2:21,1100000
8474698,Brent,Regner,1989-05-17,D,R,2015-16,7,0,0,0,0.0,-2,7,0.0,4,4865.0,11:35,0,0,0,0.0,4,7,0,1,-1,0,0,0,19.0,0:2,0,0,0,136.0,0:19,600000
8474709,Matt,Martin,1989-05-08,LW,L,2015-16,80,10,9,19,0.24,2,86,11.63,119,50671.0,10:33,1,3,4,25.0,365,24,8,15,-7,0,0,0,429.0,0:5,0,0,0,213.0,0:2,1000000
8474715,Cam,Atkinson,1989-06-05,RW,R,2015-16,81,27,26,53,0.65,-8,226,11.95,22,86499.0,17:47,2,2,4,50.0,47,40,43,18,25,4,6,10,10949.0,2:15,2,0,2,9123.0,1:52,3500000
8474716,Jared,Spurgeon,1989-11-29,D,R,2015-16,77,11,18,29,0.38,11,122,9.02,14,104775.0,22:40,0,0,0,0.0,51,157,19,22,-3,5,8,13,8173.0,1:46,0,3,3,8132.0,1:45,2666667
8474717,Mark,Barberio,1990-03-23,D,L,2015-16,30,2,8,10,0.33,0,32,6.25,6,26996.0,14:59,0,0,0,0.0,12,18,11,19,-8,0,0,0,1296.0,0:43,0,0,0,685.0,0:22,600000
8474722,Luke,Witkowski,1990-04-14,RW,R,2015-16,4,0,0,0,0.0,0,1,0.0,4,1711.0,7:7,0,0,0,0.0,8,1,0,1,-1,0,0,0,0.0,0:0,0,0,0,0.0,0:0,575000
8474727,Ben,Smith,1988-07-11,RW,R,2015-16,22,2,4,6,0.27,2,17,11.76,0,15962.0,12:5,100,85,185,54.05,18,16,8,3,5,0,0,0,120.0,0:5,0,0,0,2184.0,1:39,1500000
8474736,Zac,Rinaldo,1990-06-15,C,L,2015-16,52,1,2,3,0.06,-5,38,2.63,83,25883.0,8:17,0,1,1,0.0,154,15,8,9,-1,0,0,0,83.0,0:1,0,0,0,558.0,0:10,850000
8474739,Tommy,Wingels,1988-04-12,C,R,2015-16,68,7,11,18,0.26,-10,111,6.31,63,55630.0,13:38,38,55,93,40.86,203,54,21,30,-9,1,2,3,2799.0,0:41,0,2,2,4611.0,1:7,2475000
8474743,Zach,Redmond,1988-07-26,D,R,2015-16,37,2,4,6,0.16,5,22,9.09,10,26149.0,11:46,0,0,0,0.0,47,39,6,12,-6,1,0,1,133.0,0:3,0,0,0,516.0,0:13,750000
8474744,Sean,Collins,1988-12-29,C,L,2015-16,2,0,0,0,0.0,-1,0,,2,1023.0,8:31,0,0,0,0.0,0,2,0,0,0,0,0,0,7.0,0:3,0,0,0,37.0,0:18,575000
8474749,Matt,Bartkowski,1988-06-04,D,L,2015-16,80,6,12,18,0.22,-19,85,7.06,50,89372.0,18:37,0,0,0,0.0,141,42,18,49,-31,0,0,0,1161.0,0:14,0,0,0,6018.0,1:15,1750000
8474774,Dalton,Prout,1990-03-13,D,R,2015-16,64,3,6,9,0.14,-6,69,4.35,102,62103.0,16:10,0,1,1,0.0,139,70,7,25,-18,0,0,0,237.0,0:3,0,0,0,4847.0,1:15,1075000
8474818,Jordie,Benn,1987-07-26,D,L,2015-16,64,3,9,12,0.19,2,58,5.17,21,60107.0,15:39,0,0,0,0.0,90,94,12,39,-27,1,0,1,1019.0,0:15,0,1,1,7449.0,1:56,700000
8474849,Antoine,Roussel,1989-11-21,LW,L,2015-16,80,13,16,29,0.36,11,111,11.71,123,66514.0,13:51,15,20,35,42.86,123,58,30,24,6,0,1,1,2098.0,0:26,0,1,1,6362.0,1:19,2000000
8474850,Brandon,Mashinter,1988-09-20,LW,L,2015-16,41,4,1,5,0.12,-7,25,16.0,23,18431.0,7:29,0,0,0,0.0,62,3,6,7,-1,0,0,0,68.0,0:1,0,0,0,0.0,0:0,562500
8474870,Tyler,Johnson,1990-07-29,C,R,2015-16,69,14,24,38,0.55,4,167,8.38,20,70957.0,17:8,479,507,986,48.58,46,25,19,31,-12,3,10,13,11355.0,2:44,0,0,0,2560.0,0:37,3333333
8474884,Mike,Hoffman,1989-11-24,LW,L,2015-16,78,29,30,59,0.76,1,242,11.98,18,82102.0,17:32,8,10,18,44.44,22,29,44,45,-1,9,4,13,11437.0,2:26,0,0,0,187.0,0:2,2000000
8475060,Matt,Taormina,1986-10-20,D,L,2015-16,3,0,0,0,0.0,0,2,0.0,0,2507.0,13:55,0,0,0,0.0,1,3,0,2,-2,0,0,0,127.0,0:42,0,0,0,22.0,0:7,600000
8475098,Tyler,Bozak,1986-03-19,C,R,2015-16,57,12,23,35,0.61,-9,99,12.12,18,59308.0,17:20,597,462,1059,56.37,46,24,33,18,15,3,7,10,9248.0,2:42,0,0,0,694.0,0:12,4200000
8475119,Zach,Sill,1988-05-24,C,L,2015-16,10,1,0,1,0.1,0,13,7.69,2,5960.0,9:56,33,44,77,42.86,20,6,4,3,1,0,0,0,34.0,0:3,0,0,0,438.0,0:43,575000
8475147,Jordan,Schroeder,1990-09-29,LW,R,2015-16,26,2,2,4,0.15,2,30,6.67,2,14689.0,9:24,1,2,3,33.33,15,13,1,6,-5,0,0,0,389.0,0:14,0,0,0,26.0,0:1,600000
8475149,Marcus,Johansson,1990-10-06,LW,L,2015-16,74,17,29,46,0.62,12,132,12.88,16,73880.0,16:38,128,150,278,46.04,38,24,35,39,-4,6,8,14,12158.0,2:44,0,0,0,219.0,0:2,3750000
8475150,Jordan,Caron,1990-11-02,RW,L,2015-16,4,0,0,0,0.0,-3,1,0.0,0,1950.0,8:7,0,0,0,0.0,6,0,0,0,0,0,0,0,0.0,0:0,0,0,0,1.0,0:0,600000
8475151,Kyle,Palmieri,1991-02-01,RW,R,2015-16,82,30,27,57,0.7,3,222,13.51,39,87600.0,17:48,10,17,27,37.04,129,51,43,35,8,11,12,23,12935.0,2:37,0,0,0,3132.0,0:38,1466667
8475153,Dylan,Olsen,1991-01-03,D,L,2015-16,8,0,1,1,0.12,-1,9,0.0,2,6601.0,13:45,0,0,0,0.0,6,7,0,1,-1,0,0,0,32.0,0:4,0,0,0,4.0,0:0,775000
8475155,Simon,Despres,1991-07-27,D,L,2015-16,32,0,4,4,0.12,2,32,0.0,8,37685.0,19:37,0,0,0,0.0,67,71,11,27,-16,0,1,1,446.0,0:13,0,0,0,4322.0,2:15,900000
8475157,Landon,Ferraro,1991-08-08,C,R,2015-16,68,5,5,10,0.15,-11,77,6.49,27,43294.0,10:36,29,57,86,33.72,101,29,16,17,-1,0,0,0,217.0,0:3,0,0,0,5446.0,1:20,600000
8475158,Ryan,O'Reilly,1991-02-07,C,L,2015-16,71,21,39,60,0.85,-16,157,13.38,8,92591.0,21:44,1024,788,1812,56.51,17,43,47,28,19,8,14,22,13918.0,3:16,1,0,1,8909.0,2:5,6000000
8475160,Kyle,Clifford,1991-01-13,LW,L,2015-16,56,3,6,9,0.16,-1,68,4.41,55,31415.0,9:20,3,4,7,42.86,111,11,5,6,-1,0,0,0,223.0,0:3,0,0,0,333.0,0:5,1600000
8475161,Chris,Brown,1991-02-03,RW,R,2015-16,1,0,0,0,0.0,0,1,0.0,0,461.0,7:41,0,0,0,0.0,2,0,0,0,0,0,0,0,0.0,0:0,0,0,0,0.0,0:0,575000
8475163,Alex,Chiasson,1990-10-01,RW,R,2015-16,77,8,6,14,0.18,2,88,9.09,45,63005.0,13:38,3,2,5,60.0,103,28,26,16,10,2,0,2,5073.0,1:5,1,0,1,6977.0,1:30,1200000
8475164,Jakob,Silfverberg,1990-10-13,RW,R,2015-16,82,20,19,39,0.48,8,215,9.3,32,83514.0,16:58,4,16,20,20.0,87,58,44,39,5,2,2,4,4211.0,0:51,0,1,1,11847.0,2:24,3750000
8475165,Anton,Lander,1991-04-24,C,L,2015-16,61,1,2,3,0.05,-9,54,1.85,18,44221.0,12:4,378,315,693,54.55,58,19,23,18,5,0,0,0,2991.0,0:49,0,0,0,7103.0,1:56,987500
8475166,John,Tavares,1990-09-20,C,L,2015-16,78,33,37,70,0.9,6,250,13.2,38,93574.0,19:59,741,629,1370,54.09,51,29,69,82,-13,7,12,19,14762.0,3:9,0,0,0,209.0,0:2,5500000
8475167,Victor,Hedman,1990-12-18,D,L,2015-16,78,10,37,47,0.6,21,180,5.56,46,107950.0,23:3,0,0,0,0.0,62,132,48,62,-14,1,10,11,12224.0,2:36,0,1,1,9363.0,2:0,4000000
8475168,Matt,Duchene,1991-01-16,C,L,2015-16,76,30,29,59,0.78,-8,200,15.0,24,84773.0,18:35,428,311,739,57.92,41,37,43,31,12,8,7,15,12779.0,2:48,0,0,0,900.0,0:11,6000000
8475169,Evander,Kane,1991-08-02,LW,L,2015-16,65,20,15,35,0.54,-14,271,7.38,91,82045.0,21:2,62,62,124,50.0,171,23,37,37,0,2,4,6,9967.0,2:33,1,0,1,4325.0,1:6,5250000
8475170,Brayden,Schenn,1991-08-22,C,L,2015-16,80,26,33,59,0.74,3,178,14.61,33,81091.0,16:53,52,64,116,44.83,187,30,30,35,-5,11,11,22,16934.0,3:31,0,0,0,48.0,0:0,2500000
8475171,Oliver,Ekman-Larsson,1991-07-17,D,L,2015-16,75,21,34,55,0.73,-6,228,9.21,96,111463.0,24:46,0,0,0,0.0,154,67,40,39,1,12,15,27,23292.0,5:10,0,0,0,3232.0,0:43,5500000
8475172,Nazem,Kadri,1990-10-06,C,L,2015-16,76,17,28,45,0.59,-15,260,6.54,73,83327.0,18:16,641,663,1304,49.16,148,43,47,41,6,4,10,14,12162.0,2:40,0,0,0,336.0,0:4,4100000
8475174,Jared,Cowen,1991-01-25,D,L,2015-16,37,0,4,4,0.11,7,23,0.0,16,37694.0,16:58,0,0,0,0.0,116,58,7,34,-27,0,0,0,52.0,0:1,0,0,0,5531.0,2:29,3100000
8475175,Magnus,Paajarvi,1991-04-12,LW,L,2015-16,48,3,6,9,0.19,-9,88,3.41,8,37008.0,12:51,0,2,2,0.0,44,16,8,4,4,0,0,0,372.0,0:7,0,0,0,626.0,0:13,700000
8475176,Ryan,Ellis,1991-01-03,D,R,2015-16,79,10,22,32,0.41,13,152,6.58,35,99059.0,20:53,0,0,0,0.0,61,100,24,23,1,3,4,7,9836.0,2:4,1,0,1,6957.0,1:28,2500000
8475177,Calvin,de Haan,1991-05-09,D,L,2015-16,72,2,14,16,0.22,3,102,1.96,20,89134.0,20:37,0,1,1,0.0,128,198,19,57,-38,0,1,1,1020.0,0:14,0,0,0,9694.0,2:14,1966667
8475178,Zack,Kassian,1991-01-24,RW,R,2015-16,36,3,5,8,0.22,-7,42,7.14,114,26896.0,12:27,1,3,4,25.0,95,6,11,15,-4,0,0,0,504.0,0:14,0,0,0,392.0,0:10,1750000
8475179,Dmitry,Kulikov,1990-10-29,D,L,2015-16,74,1,16,17,0.23,8,99,1.01,51,93393.0,21:2,0,0,0,0.0,122,121,31,54,-23,0,6,6,6207.0,1:23,0,0,0,10523.0,2:22,4333333
8475180,Peter,Holland,1991-01-14,C,L,2015-16,65,9,18,27,0.42,-16,138,6.52,28,57197.0,14:39,216,249,465,46.45,78,19,34,21,13,5,6,11,9677.0,2:28,0,0,0,1158.0,0:17,775000
8475181,Nick,Leddy,1991-03-20,D,L,2015-16,81,5,35,40,0.49,-9,121,4.13,25,109929.0,22:37,0,0,0,0.0,83,87,40,52,-12,3,16,19,13357.0,2:44,0,0,0,2226.0,0:27,5500000
8475182,David,Rundblad,1990-10-08,D,R,2015-16,9,0,2,2,0.22,-2,13,0.0,6,7761.0,14:22,0,0,0,0.0,3,3,4,12,-8,0,2,2,1122.0,2:4,0,0,0,13.0,0:1,1050000
8475184,Chris,Kreider,1991-04-30,LW,L,2015-16,79,21,22,43,0.54,10,158,13.29,58,75636.0,15:57,5,1,6,83.33,177,33,23,37,-14,5,3,8,11350.0,2:23,0,0,0,30.0,0:0,2475000
8475185,Jacob,Josefson,1991-03-02,C,L,2015-16,58,4,10,14,0.24,-21,86,4.65,20,54017.0,15:31,323,344,667,48.43,67,40,19,18,1,3,8,11,8590.0,2:28,0,1,1,5427.0,1:33,800000
8475186,John,Moore,1990-11-19,D,L,2015-16,73,4,15,19,0.26,-12,106,3.77,28,86891.0,19:50,0,0,0,0.0,93,83,23,42,-19,1,5,6,6617.0,1:30,0,0,0,8809.0,2:0,1666667
8475188,Brayden,McNabb,1991-01-21,D,L,2015-16,81,2,12,14,0.17,11,91,2.2,92,91441.0,18:48,0,0,0,0.0,206,95,19,56,-37,0,1,1,1432.0,0:17,0,1,1,8400.0,1:43,650000
8475191,Reilly,Smith,1991-04-01,RW,L,2015-16,82,25,25,50,0.61,19,173,14.45,31,91566.0,18:36,0,2,2,0.0,85,39,51,31,20,5,6,11,12640.0,2:34,0,1,1,11237.0,2:17,3425000
8475192,Taylor,Beck,1991-05-13,LW,R,2015-16,2,0,0,0,0.0,0,0,,2,1018.0,8:29,0,0,0,0.0,6,0,0,0,0,0,0,0,0.0,0:0,0,0,0,0.0,0:0,875000
8475193,Tomas,Tatar,1990-12-01,LW,L,2015-16,81,21,24,45,0.56,4,165,12.73,24,69747.0,14:21,6,18,24,25.0,74,18,30,24,6,7,8,15,11508.0,2:22,0,0,0,24.0,0:0,2750000
8475194,Philip,Samuelsson,1991-07-26,D,L,2015-16,4,0,0,0,0.0,0,5,0.0,2,3813.0,15:53,0,0,0,0.0,3,11,1,1,0,0,0,0,22.0,0:5,0,0,0,621.0,2:35,600000
8475197,Tyson,Barrie,1991-07-26,D,R,2015-16,78,13,36,49,0.63,-16,172,7.56,31,108574.0,23:11,0,0,0,0.0,37,84,29,59,-30,3,18,21,14662.0,3:7,1,1,2,2369.0,0:30,2600000
8475199,Eric,Gelinas,1991-05-08,D,L,2015-16,40,1,5,6,0.15,-6,55,1.82,16,33203.0,13:50,0,0,0,0.0,61,23,7,20,-13,1,3,4,3219.0,1:20,0,0,0,193.0,0:4,1575000
8475200,Dmitry,Orlov,1991-07-23,D,L,2015-16,82,8,21,29,0.35,8,90,8.89,26,78850.0,16:1,0,0,0,0.0,121,61,37,41,-4,0,2,2,2555.0,0:31,0,0,0,681.0,0:8,2000000
8475204,Brandon,Pirri,1991-04-10,RW,L,2015-16,61,14,15,29,0.48,-4,128,10.94,30,53130.0,14:30,66,77,143,46.15,66,14,20,26,-6,3,7,10,7888.0,2:9,0,0,0,119.0,0:1,925000
8475206,Stefan,Elliott,1991-01-30,D,R,2015-16,21,2,4,6,0.29,-3,37,5.41,4,17850.0,14:10,0,0,0,0.0,12,18,4,5,-1,0,0,0,1396.0,1:6,0,0,0,149.0,0:7,650000
8475208,Brian,Dumoulin,1991-09-06,D,L,2015-16,79,0,16,16,0.2,11,101,0.0,14,89518.0,18:53,1,0,1,100.0,77,68,32,36,-4,0,0,0,2160.0,0:27,0,0,0,6158.0,1:17,800000
8475209,Richard,Panik,1991-02-07,RW,L,2015-16,30,6,2,8,0.27,4,39,15.38,6,19501.0,10:50,1,1,2,50.0,54,11,6,8,-2,0,0,0,519.0,0:17,0,0,0,0.0,0:0,975000
8475213,Drew,Shore,1991-01-29,C,R,2015-16,2,0,1,1,0.5,0,3,0.0,2,1679.0,13:59,4,6,10,40.0,0,1,1,0,1,0,0,0,22.0,0:11,0,0,0,346.0,2:53,850500
8475218,Mattias,Ekholm,1990-05-24,D,L,2015-16,82,8,27,35,0.43,14,114,7.02,44,99589.0,20:14,0,0,0,0.0,67,106,26,54,-28,1,4,5,5589.0,1:8,1,1,2,8455.0,1:43,1037500
8475220,Marcus,Foligno,1991-08-10,LW,L,2015-16,75,10,13,23,0.31,4,81,12.35,79,59330.0,13:11,1,3,4,25.0,193,44,30,17,13,0,2,2,963.0,0:12,2,0,2,1815.0,0:24,1875000
8475222,Sami,Vatanen,1991-06-03,D,R,2015-16,71,9,29,38,0.54,8,140,6.43,20,90797.0,21:18,0,0,0,0.0,85,105,34,54,-20,4,15,19,12243.0,2:52,0,0,0,9546.0,2:14,1262500
8475223,Linden,Vey,1991-07-17,RW,R,2015-16,41,4,11,15,0.37,-14,40,10.0,6,38749.0,15:45,193,256,449,42.98,4,9,16,16,0,3,2,5,5594.0,2:16,0,0,0,1431.0,0:34,1000000
8475225,Craig,Smith,1989-09-05,RW,R,2015-16,82,21,16,37,0.45,4,199,10.55,40,74709.0,15:11,76,154,230,33.04,84,18,42,44,-2,2,3,5,10449.0,2:7,0,0,0,162.0,0:1,4250000
8475227,Chris,Wideman,1990-01-07,D,R,2015-16,64,6,7,13,0.2,4,87,6.9,34,53569.0,13:57,0,0,0,0.0,57,71,5,29,-24,1,1,2,2360.0,0:36,0,0,0,419.0,0:6,600000
8475231,Casey,Cizikas,1991-02-27,C,L,2015-16,80,8,21,29,0.36,4,84,9.52,31,60873.0,12:40,469,490,959,48.91,158,62,58,23,35,0,0,0,386.0,0:4,1,2,3,10488.0,2:11,1000000
8475233,David,Savard,1990-10-22,D,R,2015-16,65,4,21,25,0.38,-7,122,3.28,45,90373.0,23:10,0,0,0,0.0,122,111,14,14,0,1,4,5,8301.0,2:7,0,1,1,11394.0,2:55,1300000
8475235,Nicolas,Deslauriers,1991-02-22,LW,L,2015-16,70,6,6,12,0.17,-14,72,8.33,59,43379.0,10:19,0,1,1,0.0,206,30,14,8,6,0,0,0,207.0,0:2,0,0,0,439.0,0:6,637500
8475236,Cody,Eakin,1991-05-24,C,L,2015-16,82,16,19,35,0.43,3,132,12.12,42,80531.0,16:22,567,621,1188,47.73,98,47,42,46,-4,2,2,4,6709.0,1:21,3,1,4,7714.0,1:34,1900000
8475246,Kevin,Connauton,1990-02-23,D,L,2015-16,65,5,12,17,0.26,7,109,4.59,60,65278.0,16:44,0,0,0,0.0,100,58,15,13,2,0,3,3,5067.0,1:17,0,0,0,1670.0,0:25,683333
8475247,Michael,Latta,1991-05-25,C,R,2015-16,43,3,4,7,0.16,0,29,10.34,50,20861.0,8:5,102,96,198,51.52,58,10,8,4,4,0,0,0,52.0,0:1,0,0,0,59.0,0:1,575000
8475250,Andrej,Nestrasil,1991-02-22,C,L,2015-16,55,9,14,23,0.42,4,105,8.57,8,47358.0,14:21,8,17,25,32.0,27,13,29,16,13,2,0,2,4238.0,1:17,0,0,0,12.0,0:0,912500
8475253,Garrett,Wilson,1991-03-16,LW,L,2015-16,29,0,0,0,0.0,-3,28,0.0,24,16308.0,9:22,0,1,1,0.0,75,4,2,2,0,0,0,0,220.0,0:7,0,0,0,0.0,0:0,675000
8475260,Corban,Knight,1990-09-10,C,R,2015-16,20,2,5,7,0.35,3,11,18.18,4,11558.0,9:37,54,52,106,50.94,18,2,6,1,5,0,0,0,126.0,0:6,0,0,0,65.0,0:3,750000
8475268,Gabriel,Bourque,1990-09-23,LW,L,2015-16,22,1,3,4,0.18,0,25,4.0,18,16321.0,12:21,0,1,1,0.0,55,22,3,5,-2,0,0,0,372.0,0:16,0,0,0,2746.0,2:4,866250
8475274,Seth,Helgeson,1990-10-08,D,L,2015-16,19,0,1,1,0.05,-5,9,0.0,17,15910.0,13:57,0,0,0,0.0,46,23,2,8,-6,0,0,0,2.0,0:0,0,0,0,566.0,0:29,587500
8475278,Byron,Froese,1991-03-12,C,R,2015-16,56,2,3,5,0.09,-11,64,3.12,16,42424.0,12:37,310,332,642,48.29,51,23,20,10,10,0,0,0,923.0,0:16,0,0,0,8719.0,2:35,575000
8475279,Ben,Chiarot,1991-05-09,D,L,2015-16,70,1,9,10,0.14,-9,74,1.35,43,60723.0,14:27,0,0,0,0.0,130,105,15,34,-19,0,0,0,217.0,0:3,0,0,0,3245.0,0:46,850000
8475287,Erik,Haula,1991-03-23,LW,L,2015-16,76,14,20,34,0.45,21,99,14.14,24,58036.0,12:43,416,365,781,53.27,57,55,34,13,21,0,1,1,394.0,0:5,2,2,4,7959.0,1:44,1000000
8475292,Tyler,Randell,1991-06-15,RW,R,2015-16,27,6,0,6,0.22,-2,18,33.33,47,11312.0,6:58,0,0,0,0.0,39,8,6,1,5,0,0,0,9.0,0:0,0,0,0,0.0,0:0,600000
8475310,Curtis,McKenzie,1991-02-22,LW,L,2015-16,3,0,0,0,0.0,-1,3,0.0,0,1584.0,8:48,0,0,0,0.0,4,1,1,0,1,0,0,0,0.0,0:0,0,0,0,22.0,0:7,675000
8475314,Anders,Lee,1990-07-03,LW,L,2015-16,80,15,21,36,0.45,-2,183,8.2,51,69967.0,14:34,1,5,6,16.67,164,31,32,21,11,8,6,14,11951.0,2:29,0,0,0,121.0,0:1,3750000
8475321,Phil,Varone,1990-12-04,C,L,2015-16,6,1,2,3,0.5,2,2,50.0,2,3063.0,8:30,10,8,18,55.56,4,6,1,0,1,0,0,0,0.0,0:0,0,0,0,0.0,0:0,600000
8475323,Marcus,Kruger,1990-05-27,C,L,2015-16,41,0,4,4,0.1,-5,50,0.0,24,33262.0,13:31,233,241,474,49.16,25,31,10,4,6,0,0,0,213.0,0:5,0,0,0,5857.0,2:22,1500000
8475325,Jordan,Nolan,1989-06-23,C,L,2015-16,52,0,5,5,0.1,0,49,0.0,38,27759.0,8:53,0,1,1,0.0,78,8,4,8,-4,0,0,0,183.0,0:3,0,0,0,77.0,0:1,950000
8475343,Nic,Dowd,1990-05-27,C,R,2015-16,5,0,0,0,0.0,1,3,0.0,2,3173.0,10:34,18,16,34,52.94,6,0,3,3,0,0,0,0,134.0,0:26,0,0,0,139.0,0:27,600000
8475414,Craig,Cunningham,1990-09-13,LW,R,2015-16,10,0,1,1,0.1,-1,13,0.0,2,6050.0,10:5,2,1,3,66.67,15,4,2,1,1,0,0,0,50.0,0:5,0,0,0,57.0,0:5,700000
8475430,Brandon,Manning,1990-06-04,D,L,2015-16,56,1,6,7,0.12,2,67,1.49,66,55533.0,16:31,0,1,1,0.0,94,57,7,19,-12,0,0,0,1089.0,0:19,0,0,0,3859.0,1:8,625000
8475455,Brenden,Dillon,1990-11-13,D,L,2015-16,76,2,9,11,0.14,8,93,2.15,61,76097.0,16:41,0,0,0,0.0,154,89,12,42,-30,0,0,0,493.0,0:6,0,0,0,4559.0,0:59,3270000
8475461,Andrew,Agozzino,1991-01-03,LW,L,2015-16,9,0,2,2,0.22,-1,3,0.0,0,4623.0,8:33,24,21,45,53.33,8,4,0,1,-1,0,1,1,136.0,0:15,0,0,0,0.0,0:0,600000
8475462,Radko,Gudas,1990-06-05,D,R,2015-16,76,5,9,14,0.18,-3,150,3.33,116,90487.0,19:50,0,0,0,0.0,304,157,11,57,-46,0,0,0,706.0,0:9,0,0,0,12406.0,2:43,991667
8475598,Ryan,Stanton,1989-07-20,D,L,2015-16,1,0,0,0,0.0,-1,0,,2,521.0,8:41,0,0,0,0.0,0,0,0,0,0,0,0,0,0.0,0:0,0,0,0,0.0,0:0,575000
8475613,Nate,Prosser,1986-05-07,D,R,2015-16,54,0,3,3,0.06,1,20,0.0,39,36882.0,11:23,0,0,0,0.0,34,73,5,16,-11,0,0,0,40.0,0:0,0,1,1,4087.0,1:15,625000
8475625,Matt,Irwin,1987-11-29,D,L,2015-16,2,0,0,0,0.0,-5,3,0.0,0,1792.0,14:56,0,0,0,0.0,1,0,0,0,0,0,0,0,124.0,1:2,0,0,0,135.0,1:7,800000
8475650,Brandon,Bollig,1987-01-31,LW,L,2015-16,54,2,2,4,0.07,-10,56,3.57,103,30099.0,9:17,2,1,3,66.67,117,25,11,8,3,0,0,0,173.0,0:3,0,0,0,56.0,0:1,1250000
8475661,Dave,Dziurzynski,1989-10-06,LW,L,2015-16,14,1,3,4,0.29,-4,14,7.14,9,8465.0,10:4,3,4,7,42.86,55,7,2,2,0,0,0,0,0.0,0:0,0,0,0,185.0,0:13,750000
8475690,Christopher,Tanev,1989-12-20,D,R,2015-16,69,4,14,18,0.26,-8,42,9.52,8,90060.0,21:45,0,0,0,0.0,18,166,14,39,-25,2,1,3,5546.0,1:20,0,1,1,11476.0,2:46,4450000
8475692,Mats,Zuccarello,1987-09-01,RW,L,2015-16,81,26,35,61,0.75,2,166,15.66,34,89796.0,18:28,5,6,11,45.45,88,69,59,43,16,7,11,18,13154.0,2:42,0,0,0,594.0,0:7,4500000
8475714,Calle,Jarnkrok,1991-09-25,C,R,2015-16,81,16,14,30,0.37,1,125,12.8,14,78418.0,16:8,366,433,799,45.81,35,24,32,19,13,3,1,4,3256.0,0:40,1,0,1,9511.0,1:57,735000
8475715,Oscar,Lindberg,1991-10-29,C,L,2015-16,68,13,15,28,0.41,12,114,11.4,43,49681.0,12:10,134,143,277,48.38,132,36,16,14,2,1,2,3,3323.0,0:48,0,0,0,1360.0,0:20,650000
8475716,Martin,Marincin,1992-02-18,D,L,2015-16,65,1,6,7,0.11,-3,55,1.82,34,65400.0,16:46,0,0,0,0.0,37,63,25,41,-16,0,0,0,489.0,0:7,0,0,0,9178.0,2:21,700000
8475722,Jason,Zucker,1992-01-16,LW,L,2015-16,71,13,10,23,0.32,-4,158,8.23,20,66367.0,15:34,1,0,1,100.0,83,33,40,27,13,0,2,2,3920.0,0:55,1,1,2,2119.0,0:29,900250
8475726,Tyler,Toffoli,1992-04-24,C,R,2015-16,82,31,27,58,0.71,35,213,14.55,20,85179.0,17:18,0,4,4,0.0,70,19,32,38,-6,9,2,11,10316.0,2:5,1,0,1,6339.0,1:17,3250000
8475727,Ryan,Spooner,1992-01-30,C,L,2015-16,80,13,36,49,0.61,-9,162,8.02,35,72677.0,15:8,304,407,711,42.76,53,19,25,35,-10,6,11,17,13371.0,2:47,0,0,0,728.0,0:9,950000
8475728,Johan,Larsson,1992-07-25,C,L,2015-16,74,10,7,17,0.23,-4,95,10.53,27,65799.0,14:49,388,371,759,51.12,113,33,21,16,5,1,3,4,4267.0,0:57,0,0,0,1473.0,0:19,800000
8475730,Stephen,Johns,1992-04-18,D,R,2015-16,14,1,2,3,0.21,-6,13,7.69,6,14977.0,17:49,0,0,0,0.0,55,21,6,11,-5,0,0,0,238.0,0:17,0,0,0,300.0,0:21,800000
8475735,Greg,McKegg,1992-06-17,C,L,2015-16,15,2,0,2,0.13,1,14,14.29,2,7432.0,8:15,50,61,111,45.05,20,6,4,1,3,0,0,0,70.0,0:4,0,0,0,234.0,0:15,700000
8475736,Connor,Brickley,1992-02-25,C,L,2015-16,23,1,4,5,0.22,1,13,7.69,14,12041.0,8:43,0,0,0,0.0,46,6,4,3,1,0,0,0,192.0,0:8,0,0,0,2.0,0:0,592500
8475738,Jordan,Weal,1992-04-15,C,R,2015-16,14,0,0,0,0.0,1,4,0.0,2,7863.0,9:21,33,35,68,48.53,5,2,5,4,1,0,0,0,577.0,0:41,0,0,0,44.0,0:3,632500
8475744,Evgeny,Kuznetsov,1992-05-19,C,L,2015-16,82,20,57,77,0.94,27,193,10.36,32,85683.0,17:24,543,594,1137,47.76,73,29,61,54,7,5,13,18,10813.0,2:11,0,0,0,160.0,0:1,3000000
8475745,Charlie,Coyle,1992-03-02,C,R,2015-16,82,21,21,42,0.51,1,140,15.0,16,85152.0,17:18,228,274,502,45.42,131,61,36,30,6,2,4,6,9381.0,1:54,0,1,1,2690.0,0:32,3200000
8475747,Patrik,Nemeth,1992-02-08,D,L,2015-16,38,0,8,8,0.21,-1,36,0.0,14,35660.0,15:38,0,0,0,0.0,58,47,5,19,-14,0,1,1,173.0,0:4,0,0,0,2464.0,1:4,900000
8475749,Christian,Thomas,1992-05-26,LW,R,2015-16,6,0,2,2,0.33,1,9,0.0,2,3218.0,8:56,0,0,0,0.0,5,1,1,1,0,0,0,0,27.0,0:4,0,0,0,0.0,0:0,600000
8475750,Jon,Merrill,1992-02-03,D,L,2015-16,47,1,4,5,0.11,-15,30,3.33,28,47648.0,16:53,0,0,0,0.0,48,54,7,17,-10,0,1,1,324.0,0:6,0,0,0,3566.0,1:15,840000
8475753,Justin,Faulk,1992-03-20,D,R,2015-16,64,16,21,37,0.58,-22,184,8.7,27,92331.0,24:2,0,1,1,0.0,109,65,45,42,3,12,5,17,12326.0,3:12,0,0,0,7278.0,1:53,4833333
8475754,Brock,Nelson,1991-10-15,C,L,2015-16,81,26,14,40,0.49,-3,165,15.76,30,76804.0,15:48,186,202,388,47.94,59,50,48,24,24,3,2,5,8618.0,1:46,0,0,0,2292.0,0:28,2500000
8475755,Alex,Petrovic,1992-03-03,D,R,2015-16,66,2,15,17,0.26,17,53,3.77,90,67144.0,16:57,0,0,0,0.0,157,76,9,24,-15,0,0,0,629.0,0:9,0,1,1,7040.0,1:46,1050000
8475756,John,McFarland,1992-04-02,LW,R,2015-16,3,0,0,0,0.0,-1,2,0.0,0,1784.0,9:54,0,0,0,0.0,5,3,0,1,-1,0,0,0,47.0,0:15,0,0,0,0.0,0:0,850500
8475757,Brett,Bulmer,1992-04-26,RW,R,2015-16,3,0,0,0,0.0,-1,2,0.0,7,1209.0,6:43,0,0,0,0.0,2,0,0,0,0,0,0,0,0.0,0:0,0,0,0,19.0,0:6,600000
8475758,Devante,Smith-Pelly,1992-06-14,RW,R,2015-16,64,14,11,25,0.39,-3,94,14.89,30,47203.0,12:17,2,3,5,40.0,105,23,7,18,-11,0,1,1,3060.0,0:47,0,0,0,1127.0,0:17,800000
8475759,Brandon,Gormley,1992-02-18,D,L,2015-16,26,0,1,1,0.04,-3,11,0.0,8,18994.0,12:10,0,0,0,0.0,18,19,5,12,-7,0,0,0,274.0,0:10,0,0,0,206.0,0:7,850500
8475760,Nick,Bjugstad,1992-07-17,C,R,2015-16,67,15,19,34,0.51,-8,171,8.77,41,62350.0,15:30,449,419,868,51.73,87,28,25,26,-1,6,9,15,10396.0,2:35,0,0,0,630.0,0:9,4100000
8475761,Beau,Bennett,1991-11-27,RW,R,2015-16,33,6,6,12,0.36,-1,52,11.54,10,23553.0,11:53,2,4,6,33.33,65,6,5,10,-5,1,2,3,2789.0,1:24,0,0,0,174.0,0:5,800000
8475762,Derek,Forbort,1992-03-04,D,L,2015-16,14,1,1,2,0.14,-1,14,7.14,17,9278.0,11:2,0,0,0,0.0,9,7,0,3,-3,0,0,0,12.0,0:0,0,0,0,571.0,0:40,863333
8475763,Kevin,Hayes,1992-05-08,C,L,2015-16,79,14,22,36,0.46,4,133,10.53,30,64762.0,13:39,137,244,381,35.96,59,23,24,42,-18,3,3,6,7141.0,1:30,0,0,0,115.0,0:1,900000
8475764,Cam,Fowler,1991-12-05,D,L,2015-16,69,5,23,28,0.41,-8,113,4.42,27,94312.0,22:46,0,0,0,0.0,43,112,17,32,-15,3,14,17,12395.0,2:59,0,0,0,8993.0,2:10,4000000
8475765,Vladimir,Tarasenko,1991-12-13,RW,L,2015-16,80,40,34,74,0.92,7,292,13.7,37,89461.0,18:38,0,1,1,0.0,32,28,38,34,4,12,12,24,13492.0,2:48,0,0,0,2043.0,0:25,7500000
8475766,Austin,Watson,1992-01-13,LW,R,2015-16,57,3,7,10,0.18,-4,55,5.45,32,34209.0,10:0,6,7,13,46.15,74,45,11,10,1,0,0,0,116.0,0:2,0,0,0,2648.0,0:46,575000
8475768,Jaden,Schwartz,1992-06-25,LW,L,2015-16,33,8,14,22,0.67,8,63,12.7,8,34063.0,17:12,15,17,32,46.88,26,21,16,18,-2,1,4,5,4349.0,2:11,0,0,0,1695.0,0:51,2350000
8475769,Quinton,Howden,1992-01-21,C,L,2015-16,58,6,5,11,0.19,-1,54,11.11,18,36095.0,10:22,3,3,6,50.0,116,10,9,7,2,0,0,0,385.0,0:6,0,0,0,394.0,0:6,850500
8475770,Emerson,Etem,1992-06-16,RW,L,2015-16,58,7,8,15,0.26,-12,100,7.0,11,45762.0,13:9,2,2,4,50.0,87,43,20,20,0,0,0,0,239.0,0:4,0,0,0,737.0,0:12,850500
8475772,Riley,Sheahan,1991-12-07,C,L,2015-16,81,14,11,25,0.31,-8,128,10.94,12,74022.0,15:13,358,424,782,45.78,72,40,20,21,-1,3,1,4,5644.0,1:9,1,0,1,9919.0,2:2,950000
8475774,Petter,Granberg,1992-08-27,D,R,2015-16,27,0,2,2,0.07,1,12,0.0,13,22226.0,13:43,0,0,0,0.0,48,26,0,7,-7,0,0,0,0.0,0:0,0,0,0,836.0,0:30,600000
8475775,Tye,McGinn,1990-07-29,LW,L,2015-16,2,0,0,0,0.0,0,1,0.0,0,1025.0,8:32,0,0,0,0.0,0,0,1,0,1,0,0,0,0.0,0:0,0,0,0,0.0,0:0,625000
8475780,Chris,Wagner,1991-05-27,RW,R,2015-16,43,4,2,6,0.14,-2,55,7.27,28,23620.0,9:9,148,126,274,54.01,95,27,3,11,-8,0,0,0,124.0,0:2,0,0,0,1384.0,0:32,600000
8475782,Morgan,Ellis,1992-04-30,D,R,2015-16,3,0,0,0,0.0,0,3,0.0,2,1612.0,8:57,0,0,0,0.0,1,2,0,2,-2,0,0,0,18.0,0:6,0,0,0,45.0,0:15,632500
8475784,Jeff,Skinner,1992-05-16,LW,L,2015-16,82,28,23,51,0.62,-2,258,10.85,38,80129.0,16:17,20,27,47,42.55,21,17,77,43,34,4,3,7,9587.0,1:56,0,0,0,119.0,0:1,5725000
8475786,Zach,Hyman,1992-06-09,C,R,2015-16,16,4,2,6,0.38,0,37,10.81,18,15059.0,15:41,1,2,3,33.33,31,8,9,2,7,0,0,0,263.0,0:16,0,0,0,1555.0,1:37,900000
8475788,Alexander,Burmistrov,1991-10-21,C,L,2015-16,81,7,14,21,0.26,-11,102,6.86,32,78599.0,16:10,205,307,512,40.04,125,35,36,48,-12,0,1,1,4576.0,0:56,0,1,1,9763.0,2:0,1550000
8475790,Erik,Gudbranson,1992-01-07,D,R,2015-16,64,2,7,9,0.14,3,73,2.74,49,77232.0,20:6,0,0,0,0.0,150,73,11,28,-17,0,0,0,1275.0,0:19,0,0,0,12427.0,3:14,2500000
8475791,Taylor,Hall,1991-11-14,LW,L,2015-16,82,26,39,65,0.79,-4,286,9.09,54,94485.0,19:12,14,25,39,35.9,82,50,64,73,-9,4,8,12,13866.0,2:49,0,0,0,245.0,0:2,6000000
8475792,Brett,Connolly,1992-05-02,RW,R,2015-16,71,9,16,25,0.35,-1,95,9.47,20,55214.0,12:57,14,17,31,45.16,137,36,11,20,-9,2,3,5,3567.0,0:50,0,0,0,24.0,0:0,1025000
8475793,Ryan,Johansen,1992-07-31,C,R,2015-16,80,14,46,60,0.75,6,185,7.57,61,84301.0,17:33,652,594,1246,52.33,115,30,38,42,-4,4,18,22,13547.0,2:49,0,0,0,837.0,0:10,4000000
8475794,Tyler,Seguin,1992-01-31,C,R,2015-16,72,33,40,73,1.01,2,278,11.87,16,83991.0,19:26,470,376,846,55.56,80,27,21,46,-25,7,17,24,14339.0,3:19,0,0,0,96.0,0:1,5750000
8475795,Dylan,McIlrath,1992-04-20,D,R,2015-16,34,2,2,4,0.12,7,28,7.14,64,28813.0,14:7,0,0,0,0.0,93,35,9,12,-3,0,0,0,70.0,0:2,0,0,0,1885.0,0:55,600000
8475796,Mark,Pysyk,1992-01-11,D,R,2015-16,55,1,10,11,0.2,-1,44,2.27,32,52480.0,15:54,0,0,0,0.0,37,49,9,21,-12,0,1,1,2117.0,0:38,0,1,1,1536.0,0:27,1125000
8475797,Jarred,Tinordi,1992-02-20,D,L,2015-16,10,0,0,0,0.0,-5,3,0.0,17,8579.0,14:17,0,0,0,0.0,22,11,1,1,0,0,0,0,36.0,0:3,0,0,0,1148.0,1:54,850500
8475798,Mikael,Granlund,1992-02-26,RW,L,2015-16,82,13,31,44,0.54,-12,160,8.12,20,89148.0,18:7,528,557,1085,48.66,86,57,51,40,11,2,9,11,12914.0,2:37,1,0,1,2812.0,0:34,3000000
8475799,Nino,Niederreiter,1992-09-08,RW,L,2015-16,82,20,23,43,0.52,9,159,12.58,36,76474.0,15:32,11,16,27,40.74,129,19,35,23,12,2,3,5,9292.0,1:53,0,0,0,159.0,0:1,2666667
8475800,Teemu,Pulkkinen,1992-01-02,LW,R,2015-16,36,6,6,12,0.33,2,65,9.23,14,24985.0,11:34,0,1,1,0.0,5,8,12,12,0,1,2,3,3757.0,1:44,0,0,0,24.0,0:0,735000
8475807,Joakim,Nordstrom,1992-02-25,LW,L,2015-16,71,10,14,24,0.34,1,81,12.35,12,66566.0,15:37,6,4,10,60.0,98,32,26,33,-7,0,0,0,427.0,0:6,1,0,1,7110.0,1:40,605000
8475808,Michael,Chaput,1992-04-09,C,L,2015-16,8,1,1,2,0.25,3,10,10.0,5,4319.0,8:59,49,26,75,65.33,13,3,0,3,-3,0,0,0,19.0,0:2,0,0,0,0.0,0:0,650000
8475810,Bryan,Rust,1992-05-11,RW,R,2015-16,41,4,7,11,0.27,1,68,5.88,12,30744.0,12:29,1,3,4,25.0,62,23,10,8,2,0,1,1,739.0,0:18,0,0,0,647.0,0:15,652500
8475815,Julian,Melchiori,1991-12-06,D,L,2015-16,11,0,0,0,0.0,1,12,0.0,0,8973.0,13:35,0,0,0,0.0,18,9,2,5,-3,0,0,0,0.0,0:0,0,0,0,259.0,0:23,600000
8475816,Stanislav,Galiev,1992-01-17,RW,R,2015-16,24,0,3,3,0.12,2,30,0.0,4,13133.0,9:7,0,0,0,0.0,14,4,6,8,-2,0,0,0,1000.0,0:41,0,0,0,40.0,0:1,575000
8475820,Joonas,Donskoi,1992-04-13,RW,R,2015-16,76,11,25,36,0.47,4,107,10.28,20,64539.0,14:9,2,1,3,66.67,31,46,33,37,-4,3,5,8,6654.0,1:27,0,0,0,311.0,0:4,925000
8475829,John,Ramage,1991-02-07,D,R,2015-16,1,0,0,0,0.0,-2,0,,0,849.0,14:9,0,0,0,0.0,0,4,0,0,0,0,0,0,0.0,0:0,0,0,0,21.0,0:21,600000
8475832,Tom,Kuhnhackl,1992-01-21,RW,L,2015-16,42,5,10,15,0.36,3,52,9.62,24,30744.0,12:12,0,3,3,0.0,57,32,5,6,-1,0,0,0,80.0,0:1,2,0,2,2476.0,0:58,575000
8475836,Alex,Friesen,1991-01-30,C,L,2015-16,1,0,0,0,0.0,-2,1,0.0,0,703.0,11:43,0,1,1,0.0,1,0,1,0,1,0,0,0,0.0,0:0,0,0,0,0.0,0:0,575000
8475842,Sam,Carrick,1992-02-04,C,R,2015-16,3,0,0,0,0.0,-2,4,0.0,4,2064.0,11:28,1,0,1,100.0,4,0,0,0,0,0,0,0,0.0,0:0,0,0,0,286.0,1:35,600000
8475844,Kenny,Agostino,1992-04-30,LW,L,2015-16,2,0,0,0,0.0,-2,3,0.0,0,1626.0,13:33,0,0,0,0.0,3,0,2,5,-3,0,0,0,163.0,1:21,0,0,0,0.0,0:0,735000
8475848,Brendan,Gallagher,1992-05-06,RW,R,2015-16,53,19,21,40,0.75,13,173,10.98,24,52712.0,16:34,12,17,29,41.38,43,25,30,14,16,7,3,10,9353.0,2:56,0,0,0,44.0,0:0,3750000
8475855,Jesper,Fast,1991-12-02,RW,R,2015-16,79,10,20,30,0.38,9,75,13.33,18,70807.0,14:56,1,5,6,16.67,109,55,35,18,17,0,0,0,1043.0,0:13,0,0,0,10328.0,2:10,950000
8475857,Kevin,Gravel,1992-03-06,D,L,2015-16,5,0,0,0,0.0,0,2,0.0,0,3503.0,11:40,0,0,0,0.0,4,4,0,2,-2,0,0,0,232.0,0:46,0,0,0,101.0,0:20,667500
8475868,Anthony,Bitetto,1990-07-15,D,L,2015-16,28,1,5,6,0.21,0,19,5.26,19,20385.0,12:8,0,0,0,0.0,62,41,2,8,-6,0,0,0,129.0,0:4,0,0,0,85.0,0:3,665500
8475869,Brandon,Davidson,1991-08-21,D,L,2015-16,51,4,7,11,0.22,7,63,6.35,20,58741.0,19:11,0,0,0,0.0,74,92,19,45,-26,2,0,2,1334.0,0:26,0,1,1,8075.0,2:38,585000
8475878,Freddie,Hamilton,1992-01-01,C,R,2015-16,4,1,1,2,0.5,1,7,14.29,0,3048.0,12:42,12,9,21,57.14,8,2,1,2,-1,0,0,0,0.0,0:0,1,0,1,202.0,0:50,687500
8475902,Zach,Trotman,1990-08-26,D,R,2015-16,38,2,5,7,0.18,3,60,3.33,22,42303.0,18:33,0,0,0,0.0,71,49,2,16,-14,0,0,0,689.0,0:18,0,0,0,4020.0,1:45,625000
8475906,John,Klingberg,1992-08-14,D,R,2015-16,76,10,48,58,0.76,22,171,5.85,30,103458.0,22:41,0,0,0,0.0,44,68,36,78,-42,2,20,22,14581.0,3:11,0,0,0,452.0,0:5,4250000
8475907,Micheal,Ferland,1992-04-20,LW,L,2015-16,71,4,14,18,0.25,-15,122,3.28,45,53730.0,12:36,7,5,12,58.33,207,22,37,25,12,1,1,2,4425.0,1:2,0,0,0,648.0,0:9,825000
8475913,Mark,Stone,1992-05-13,RW,R,2015-16,75,23,38,61,0.81,-4,151,15.23,38,90511.0,20:6,8,11,19,42.11,55,54,128,54,74,5,10,15,13470.0,2:59,1,2,3,5484.0,1:13,3500000
8475949,Marek,Hrivik,1991-08-28,LW,R,2015-16,5,0,1,1,0.2,3,3,0.0,0,3215.0,10:43,3,2,5,60.0,6,1,0,3,-3,0,0,0,33.0,0:6,0,0,0,252.0,0:50,575000
8475958,Michael,Sgarbossa,1992-07-25,C,L,2015-16,1,0,0,0,0.0,0,0,,0,501.0,8:21,2,2,4,50.0,0,2,0,0,0,0,0,0,0.0,0:0,0,0,0,0.0,0:0,605000
8475980,Brody,Sutter,1991-09-26,C,R,2015-16,8,0,0,0,0.0,-4,7,0.0,0,4304.0,8:58,9,4,13,69.23,21,0,1,1,0,0,0,0,0.0,0:0,0,0,0,0.0,0:0,600000
8476043,Ben,Street,1987-02-13,C,L,2015-16,7,0,0,0,0.0,-1,8,0.0,4,3085.0,7:20,26,21,47,55.32,6,4,0,2,-2,0,0,0,0.0,0:0,0,0,0,0.0,0:0,650000
8476062,Mark,Arcobello,1988-08-12,RW,R,2015-16,20,3,1,4,0.2,0,43,6.98,0,15213.0,12:40,132,110,242,54.55,22,3,9,4,5,0,0,0,2484.0,2:4,0,0,0,130.0,0:6,1100000
8476116,Ryan,Garbutt,1985-08-12,C,L,2015-16,80,7,7,14,0.18,-11,135,5.19,48,52009.0,10:50,1,7,8,12.5,165,28,12,18,-6,0,0,0,446.0,0:5,1,0,1,3138.0,0:39,1800000
8476147,Kael,Mouillierat,1987-12-09,LW,L,2015-16,1,0,0,0,0.0,0,1,0.0,2,641.0,10:41,5,6,11,45.45,4,0,1,0,1,0,0,0,0.0,0:0,0,0,0,0.0,0:0,575000
8476158,Harry,Zolnierczyk,1987-09-01,LW,L,2015-16,1,0,0,0,0.0,-1,1,0.0,0,528.0,8:48,0,0,0,0.0,3,0,0,0,0,0,0,0,0.0,0:0,0,0,0,0.0,0:0,600000
8476166,Taylor,Fedun,1988-06-04,D,R,2015-16,1,0,1,1,1.0,1,0,,0,1128.0,18:48,0,0,0,0.0,3,3,0,0,0,0,0,0,0.0,0:0,0,0,0,9.0,0:9,600000
8476177,Matt,Read,1986-06-14,RW,R,2015-16,79,11,15,26,0.33,-5,127,8.66,27,72300.0,15:15,24,26,50,48.0,81,60,34,20,14,2,5,7,6242.0,1:19,0,0,0,7937.0,1:40,3625000
8476191,Kevan,Miller,1987-11-15,D,R,2015-16,71,5,13,18,0.25,15,64,7.81,53,81190.0,19:3,0,0,0,0.0,164,123,12,33,-21,0,1,1,235.0,0:3,0,0,0,10791.0,2:31,800000
8476200,Paul,Thompson,1988-11-30,RW,R,2015-16,3,0,0,0,0.0,0,3,0.0,2,2255.0,12:31,0,0,0,0.0,3,0,1,0,1,0,0,0,8.0,0:2,0,0,0,7.0,0:2,575000
8476209,Mike,Sislo,1988-01-20,RW,R,2015-16,18,3,1,4,0.22,-2,29,10.34,4,13419.0,12:25,0,2,2,0.0,25,6,3,2,1,1,0,1,1265.0,1:10,0,0,0,9.0,0:0,562500
8476235,Justin,Fontaine,1987-11-06,RW,R,2015-16,60,5,11,16,0.27,3,54,9.26,20,42680.0,11:51,1,3,4,25.0,9,24,17,12,5,0,0,0,484.0,0:8,0,1,1,3943.0,1:5,1000000
8476279,Jyrki,Jokipakka,1991-08-20,D,L,2015-16,58,2,10,12,0.21,4,45,4.44,14,54145.0,15:33,0,0,0,0.0,69,66,14,35,-21,0,0,0,390.0,0:6,0,0,0,3882.0,1:6,900000
8476288,Ryan,Dzingel,1992-03-09,LW,L,2015-16,30,3,6,9,0.3,4,23,13.04,11,19436.0,10:47,2,2,4,50.0,54,4,6,2,4,0,0,0,66.0,0:2,0,0,0,192.0,0:6,715000
8476289,Alexey,Marchenko,1992-01-02,D,R,2015-16,66,2,9,11,0.17,-5,40,5.0,10,66651.0,16:49,0,0,0,0.0,47,100,7,33,-26,0,0,0,158.0,0:2,0,1,1,8396.0,2:7,666667
8476292,Ondrej,Palat,1991-03-28,LW,L,2015-16,62,16,24,40,0.65,10,117,13.68,20,66659.0,17:55,2,6,8,25.0,108,39,32,31,1,1,6,7,10230.0,2:45,2,1,3,5206.0,1:23,3333333
8476293,Scott,Wilson,1992-04-24,C,L,2015-16,24,5,1,6,0.25,0,39,12.82,12,15387.0,10:41,0,0,0,0.0,38,6,5,5,0,0,0,0,1158.0,0:48,0,0,0,58.0,0:2,655000
8476300,Nikita,Nesterov,1993-03-28,D,L,2015-16,57,3,6,9,0.16,-6,57,5.26,41,50922.0,14:53,0,0,0,0.0,95,31,8,30,-22,2,2,4,4269.0,1:14,0,0,0,164.0,0:2,742500
8476302,Frank,Corrado,1993-03-26,D,R,2015-16,39,1,5,6,0.15,-12,46,2.17,26,33822.0,14:27,0,0,0,0.0,46,37,2,16,-14,0,1,1,1215.0,0:31,0,0,0,1574.0,0:40,632500
8476312,Josh,Manson,1991-10-07,D,R,2015-16,71,5,10,15,0.21,11,88,5.68,74,80013.0,18:46,0,0,0,0.0,158,67,18,51,-33,0,0,0,487.0,0:6,0,0,0,9142.0,2:8,925000
8476323,Max,McCormick,1992-05-01,LW,L,2015-16,20,2,2,4,0.2,-4,37,5.41,37,12550.0,10:27,39,37,76,51.32,46,11,8,5,3,0,0,0,75.0,0:3,0,0,0,80.0,0:4,642500
8476326,Josh,Archibald,1992-10-06,RW,R,2015-16,1,0,0,0,0.0,0,0,,0,302.0,5:2,0,0,0,0.0,1,1,0,0,0,0,0,0,0.0,0:0,0,0,0,0.0,0:0,659167
8476331,Dylan,DeMelo,1993-05-01,D,R,2015-16,45,2,2,4,0.09,0,42,4.76,14,36769.0,13:37,0,0,0,0.0,39,35,8,22,-14,2,2,4,2974.0,1:6,0,0,0,349.0,0:7,633333
8476336,Iiro,Pakarinen,1991-08-25,RW,R,2015-16,63,5,8,13,0.21,-10,76,6.58,8,40629.0,10:44,5,8,13,38.46,152,21,10,9,1,0,2,2,1234.0,0:19,0,0,0,4399.0,1:9,817500
8476344,Tyler,Graovac,1993-04-27,C,L,2015-16,2,0,0,0,0.0,-1,2,0.0,0,1393.0,11:36,13,6,19,68.42,1,0,2,0,2,0,0,0,0.0,0:0,0,0,0,0.0,0:0,747500
8476346,Johnny,Gaudreau,1993-08-13,LW,L,2015-16,79,30,48,78,0.99,4,217,13.82,20,94471.0,19:55,2,3,5,40.0,26,10,41,90,-49,6,15,21,17066.0,3:36,0,0,0,310.0,0:3,925000
8476352,Michael,Mersch,1992-10-02,LW,L,2015-16,17,1,2,3,0.18,1,23,4.35,0,10588.0,10:22,1,3,4,25.0,26,10,3,3,0,0,0,0,408.0,0:24,0,0,0,445.0,0:26,786667
8476356,Tobias,Rieder,1993-01-10,C,L,2015-16,82,14,23,37,0.45,-21,189,7.41,10,85143.0,17:18,10,19,29,34.48,54,43,31,11,20,2,6,8,11061.0,2:14,0,1,1,9571.0,1:56,853333
8476368,Fredrik,Claesson,1992-11-24,D,L,2015-16,16,0,2,2,0.12,-6,15,0.0,2,18518.0,19:17,0,0,0,0.0,33,30,9,14,-5,0,0,0,79.0,0:4,0,0,0,1350.0,1:24,600000
8476370,Blake,Pietila,1993-02-20,LW,L,2015-16,7,1,1,2,0.29,0,10,10.0,2,5054.0,12:2,0,0,0,0.0,19,3,0,0,0,0,0,0,135.0,0:19,0,0,0,444.0,1:3,662500
8476379,Darren,Dietz,1993-07-17,D,R,2015-16,13,1,4,5,0.38,-1,13,7.69,13,11339.0,14:32,0,0,0,0.0,38,14,3,12,-9,0,0,0,134.0,0:10,0,0,0,241.0,0:18,665000
8476381,Andrew,Shaw,1991-07-20,RW,R,2015-16,78,14,20,34,0.44,11,153,9.15,69,68567.0,14:39,146,168,314,46.5,148,21,21,23,-2,4,4,8,8915.0,1:54,0,0,0,75.0,0:0,2000000
8476384,Max,Friberg,1992-11-20,RW,R,2015-16,5,0,0,0,0.0,-1,1,0.0,2,2652.0,8:50,0,0,0,0.0,7,2,0,0,0,0,0,0,2.0,0:0,0,0,0,149.0,0:29,587500
8476386,Shane,Prince,1992-11-16,LW,L,2015-16,62,6,11,17,0.27,5,88,6.82,10,41776.0,11:13,4,1,5,80.0,24,14,19,24,-5,0,0,0,708.0,0:11,0,0,0,222.0,0:3,700000
8476388,Andrey,Pedan,1993-07-03,D,L,2015-16,13,0,0,0,0.0,-3,11,0.0,18,8543.0,10:57,0,0,0,0.0,40,8,0,5,-5,0,0,0,9.0,0:0,0,0,0,327.0,0:25,792500
8476389,Vincent,Trocheck,1993-07-11,C,R,2015-16,76,25,28,53,0.7,15,174,14.37,44,81032.0,17:46,547,559,1106,49.46,125,41,43,33,10,4,9,13,12223.0,2:40,1,0,1,3615.0,0:47,661667
8476392,Adam,Lowry,1993-03-29,C,L,2015-16,74,7,10,17,0.23,-9,73,9.59,53,62242.0,14:1,391,454,845,46.27,187,48,33,18,15,0,0,0,837.0,0:11,0,0,0,9317.0,2:5,828333
8476393,Nick,Cousins,1993-07-20,C,L,2015-16,36,6,5,11,0.31,5,41,14.63,4,23179.0,10:43,109,128,237,45.99,38,17,18,13,5,0,2,2,903.0,0:25,0,0,0,13.0,0:0,842500
8476394,Michael,Paliotta,1993-04-06,D,R,2015-16,1,0,0,0,0.0,0,2,0.0,4,452.0,7:32,0,0,0,0.0,0,1,0,0,0,0,0,0,0.0,0:0,0,0,0,0.0,0:0,925000
8476400,Logan,Shaw,1992-10-05,RW,R,2015-16,53,5,2,7,0.13,-7,72,6.94,13,38926.0,12:14,16,21,37,43.24,88,20,21,5,16,1,0,1,3303.0,1:2,0,0,0,1710.0,0:32,674167
8476401,Daniel,Catenacci,1993-03-09,C,L,2015-16,11,0,0,0,0.0,-2,7,0.0,0,5768.0,8:44,2,0,2,100.0,22,2,2,0,2,0,0,0,25.0,0:2,0,0,0,6.0,0:0,611667
8476403,Klas,Dahlbeck,1991-07-06,D,L,2015-16,71,2,6,8,0.11,-5,64,3.12,28,67022.0,15:43,0,0,0,0.0,178,76,10,15,-5,0,0,0,205.0,0:2,0,1,1,11718.0,2:45,605000
8476404,Andy,Andreoff,1991-05-17,LW,L,2015-16,60,8,2,10,0.17,1,46,17.39,76,31655.0,8:47,134,134,268,50.0,82,11,12,12,0,0,0,0,343.0,0:5,0,0,0,151.0,0:2,587500
8476406,Nick,Shore,1992-09-26,C,R,2015-16,68,3,7,10,0.15,-10,90,3.33,32,50617.0,12:24,384,357,741,51.82,97,17,13,7,6,0,2,2,1240.0,0:18,0,0,0,4114.0,1:0,600000
8476409,Alan,Quine,1993-02-25,C,L,2015-16,2,1,0,1,0.5,0,5,20.0,0,2131.0,17:45,16,10,26,61.54,3,3,1,2,-1,0,0,0,232.0,1:56,1,0,1,187.0,1:33,595000
8476410,Josh,Leivo,1993-05-26,LW,R,2015-16,12,5,0,5,0.42,2,20,25.0,6,8868.0,12:19,1,1,2,50.0,7,3,4,4,0,1,0,1,1918.0,2:39,0,0,0,0.0,0:0,792500
8476414,Alexandre,Grenier,1991-09-05,RW,R,2015-16,6,0,0,0,0.0,-4,9,0.0,2,4131.0,11:28,1,1,2,50.0,5,3,3,3,0,0,0,0,0.0,0:0,0,0,0,0.0,0:0,585000
8476415,Kyle,Rau,1992-10-24,C,L,2015-16,9,0,0,0,0.0,-1,15,0.0,2,6799.0,12:35,0,0,0,0.0,4,3,3,1,2,0,0,0,272.0,0:30,0,0,0,132.0,0:14,858750
8476419,Jean-Gabriel,Pageau,1992-11-11,C,R,2015-16,82,19,24,43,0.52,17,133,14.29,26,82175.0,16:42,614,563,1177,52.17,166,60,30,37,-7,1,1,2,4115.0,0:50,7,2,9,10325.0,2:5,900000
8476422,Mike,Reilly,1993-07-13,D,L,2015-16,29,1,6,7,0.24,-4,27,3.7,8,21024.0,12:4,0,0,0,0.0,3,23,2,10,-8,0,2,2,3197.0,1:50,0,0,0,58.0,0:2,925000
8476423,Reid,Boucher,1993-09-08,C,L,2015-16,39,8,11,19,0.49,-13,74,10.81,6,33392.0,14:16,1,2,3,33.33,32,14,9,9,0,2,4,6,4395.0,1:52,0,0,0,1.0,0:0,692500
8476427,Ty,Rattie,1993-02-05,RW,R,2015-16,13,4,2,6,0.46,1,16,25.0,4,7244.0,9:17,0,0,0,0.0,6,2,2,2,0,0,0,0,95.0,0:7,0,0,0,0.0,0:0,772500
8476428,Rocco,Grimaldi,1993-02-08,C,R,2015-16,20,3,2,5,0.25,-4,29,10.34,2,14238.0,11:51,47,61,108,43.52,17,2,10,5,5,0,0,0,612.0,0:30,0,0,0,18.0,0:0,925000
8476429,Scott,Mayfield,1992-10-14,D,R,2015-16,6,1,0,1,0.17,-4,4,25.0,11,6159.0,17:6,0,0,0,0.0,12,15,0,3,-3,0,0,0,203.0,0:33,0,0,0,504.0,1:24,925000
8476430,Tomas,Jurco,1992-12-28,LW,L,2015-16,44,4,2,6,0.14,-6,43,9.3,16,24243.0,9:10,1,0,1,100.0,50,4,6,7,-1,0,0,0,1112.0,0:25,0,0,0,152.0,0:3,900000
8476431,Adam,Clendening,1992-10-26,D,R,2015-16,29,1,6,7,0.24,6,43,2.33,20,25745.0,14:47,0,0,0,0.0,19,34,5,19,-14,0,0,0,1402.0,0:48,0,0,0,5.0,0:0,761250
8476432,Boone,Jenner,1993-06-15,C,L,2015-16,82,30,19,49,0.6,-15,225,13.33,77,80733.0,16:24,156,138,294,53.06,213,71,39,25,14,9,5,14,10182.0,2:4,1,0,1,1269.0,0:15,778333
8476435,Alex,Khokhlachev,1993-09-09,C,L,2015-16,5,0,0,0,0.0,-2,4,0.0,0,3076.0,10:15,0,2,2,0.0,2,1,0,1,-1,0,0,0,0.0,0:0,0,0,0,2.0,0:0,786667
8476436,Dmitrij,Jaskin,1993-03-23,RW,L,2015-16,65,4,9,13,0.2,3,92,4.35,26,46251.0,11:51,8,20,28,28.57,126,16,21,8,13,0,0,0,1018.0,0:15,0,0,0,35.0,0:0,775000
8476437,Victor,Rask,1993-03-01,C,L,2015-16,80,21,27,48,0.6,-6,160,13.12,24,81519.0,16:58,479,456,935,51.23,32,34,42,31,11,5,13,18,12563.0,2:37,0,0,0,954.0,0:11,680833
8476438,Brandon,Saad,1992-10-27,LW,L,2015-16,78,31,22,53,0.68,1,233,13.3,14,80582.0,17:13,19,15,34,55.88,43,25,33,31,2,6,2,8,9906.0,2:7,0,1,1,2991.0,0:38,6000000
8476439,Brett,Ritchie,1993-07-01,RW,R,2015-16,8,0,1,1,0.12,-3,15,0.0,7,5569.0,11:36,0,0,0,0.0,30,3,2,3,-1,0,0,0,622.0,1:17,0,0,0,0.0,0:0,814167
8476440,Markus,Granlund,1993-04-16,C,L,2015-16,47,6,4,10,0.21,-4,56,10.71,14,38881.0,13:47,202,270,472,42.8,31,23,19,11,8,0,0,0,2106.0,0:44,1,1,2,3303.0,1:10,767500
8476441,Joel,Edmundson,1993-06-28,D,L,2015-16,67,1,8,9,0.13,0,90,1.11,63,60016.0,14:55,0,0,0,0.0,165,62,7,19,-12,0,0,0,79.0,0:1,0,0,0,4434.0,1:6,742500
8476442,Matt,Nieto,1992-11-05,LW,L,2015-16,67,8,9,17,0.25,-8,90,8.89,10,52901.0,13:9,2,6,8,25.0,33,33,17,27,-10,0,1,1,286.0,0:4,2,0,2,4842.0,1:12,759167
8476443,Xavier,Ouellet,1993-07-29,D,L,2015-16,5,0,1,1,0.2,-2,4,0.0,2,4873.0,16:14,0,0,0,0.0,5,3,3,1,2,0,0,0,0.0,0:0,0,0,0,339.0,1:7,670000
8476447,Miikka,Salomaki,1993-03-09,RW,L,2015-16,61,5,5,10,0.16,-1,61,8.2,28,43923.0,12:0,2,1,3,66.67,164,30,17,12,5,0,0,0,130.0,0:2,0,1,1,4815.0,1:18,780833
8476448,William,Karlsson,1993-01-08,C,L,2015-16,81,9,11,20,0.25,-9,108,8.33,6,70324.0,14:28,416,495,911,45.66,40,48,42,21,21,0,0,0,1314.0,0:16,0,0,0,10381.0,2:8,830833
8476449,Scott,Harrington,1993-03-10,D,L,2015-16,15,0,1,1,0.07,0,9,0.0,4,11785.0,13:5,0,0,0,0.0,23,16,1,3,-2,0,0,0,22.0,0:1,0,0,0,648.0,0:43,589167
8476451,Lucas,Lessio,1993-01-23,LW,L,2015-16,12,1,1,2,0.17,1,14,7.14,2,7542.0,10:28,0,2,2,0.0,24,5,2,2,0,0,0,0,330.0,0:27,0,0,0,0.0,0:0,830833
8476452,Tyler,Wotherspoon,1993-03-12,D,L,2015-16,11,0,1,1,0.09,0,9,0.0,0,9352.0,14:10,0,0,0,0.0,14,16,1,6,-5,0,0,0,47.0,0:4,0,0,0,763.0,1:9,925000
8476453,Nikita,Kucherov,1993-06-17,RW,L,2015-16,77,30,36,66,0.86,9,209,14.35,30,84141.0,18:12,0,1,1,0.0,61,28,34,58,-24,9,16,25,15072.0,3:15,0,0,0,127.0,0:1,711667
8476454,Ryan,Nugent-Hopkins,1993-04-12,C,L,2015-16,55,12,22,34,0.62,-9,108,11.11,18,62906.0,19:3,369,454,823,44.84,39,36,43,30,13,4,7,11,8631.0,2:36,0,0,0,3145.0,0:57,6000000
8476455,Gabriel,Landeskog,1992-11-23,LW,L,2015-16,75,20,33,53,0.71,-5,169,11.83,69,85166.0,18:55,31,25,56,55.36,141,66,37,30,7,4,10,14,12411.0,2:45,1,2,3,6467.0,1:26,5571429
8476456,Jonathan,Huberdeau,1993-06-04,LW,L,2015-16,76,20,39,59,0.78,17,174,11.49,43,82735.0,18:8,7,11,18,38.89,53,36,32,46,-14,4,9,13,12298.0,2:41,1,0,1,2398.0,0:31,3250000
8476457,Adam,Larsson,1992-11-12,D,R,2015-16,82,3,15,18,0.22,15,65,4.62,77,110747.0,22:30,0,0,0,0.0,163,148,22,27,-5,0,0,0,833.0,0:10,0,1,1,16460.0,3:20,4166666
8476458,Ryan,Strome,1993-07-11,C,R,2015-16,71,8,20,28,0.39,-9,132,6.06,28,66702.0,15:39,39,56,95,41.05,77,19,35,38,-3,1,3,4,6276.0,1:28,0,0,0,134.0,0:1,863333
8476459,Mika,Zibanejad,1993-04-18,C,R,2015-16,81,21,30,51,0.63,-2,184,11.41,18,86315.0,17:45,659,647,1306,50.46,111,43,39,52,-13,2,9,11,12202.0,2:30,2,0,2,6918.0,1:25,2625000
8476460,Mark,Scheifele,1993-03-15,C,R,2015-16,71,29,32,61,0.86,16,194,14.95,48,79018.0,18:32,515,651,1166,44.17,53,36,61,35,26,7,4,11,11423.0,2:40,0,0,0,1257.0,0:17,863333
8476461,Sean,Couturier,1992-12-07,C,L,2015-16,63,11,28,39,0.62,8,119,9.24,30,70311.0,18:36,537,568,1105,48.6,31,30,27,29,-2,2,5,7,7273.0,1:55,0,1,1,6972.0,1:50,1750000
8476462,Dougie,Hamilton,1993-06-17,D,R,2015-16,82,12,31,43,0.52,-14,190,6.32,46,97257.0,19:46,0,0,0,0.0,78,106,15,63,-48,5,11,16,11919.0,2:25,0,0,0,2338.0,0:28,5750000
8476463,Jonas,Brodin,1993-07-12,D,L,2015-16,68,2,5,7,0.1,-5,58,3.45,18,83311.0,20:25,0,0,0,0.0,34,110,27,23,4,0,0,0,424.0,0:6,0,0,0,7186.0,1:45,4166667
8476465,Ryan,Murphy,1993-03-31,D,R,2015-16,35,0,10,10,0.29,-1,47,0.0,10,36232.0,17:15,0,0,0,0.0,25,22,11,18,-7,0,1,1,3821.0,1:49,0,0,0,223.0,0:6,863333
8476466,Sven,Baertschi,1992-10-05,LW,L,2015-16,69,15,13,28,0.41,-14,108,13.89,14,55717.0,13:27,0,1,1,0.0,30,36,26,22,4,2,5,7,7110.0,1:43,0,0,0,125.0,0:1,900000
8476467,Jamie,Oleksiak,1992-12-21,D,L,2015-16,19,0,2,2,0.11,-5,13,0.0,21,14496.0,12:42,0,0,0,0.0,54,29,4,17,-13,0,0,0,11.0,0:0,0,0,0,700.0,0:36,875000
8476468,J.T.,Miller,1993-03-14,C,L,2015-16,82,22,21,43,0.52,10,135,16.3,46,73971.0,15:2,68,89,157,43.31,174,48,40,61,-21,2,2,4,6913.0,1:24,0,0,0,60.0,0:0,874000
8476469,Joel,Armia,1993-05-31,RW,R,2015-16,43,4,6,10,0.23,2,52,7.69,12,31376.0,12:9,0,2,2,0.0,59,20,23,13,10,0,0,0,1404.0,0:32,0,2,2,1009.0,0:23,894167
8476470,Nathan,Beaulieu,1992-12-05,D,L,2015-16,64,2,17,19,0.3,-6,74,2.7,55,67035.0,17:27,0,0,0,0.0,59,89,17,48,-31,1,2,3,4742.0,1:14,0,0,0,1928.0,0:30,1000000
8476471,Mark,McNeill,1993-02-22,C,R,2015-16,1,0,0,0,0.0,0,0,,0,764.0,12:44,0,1,1,0.0,3,0,1,0,1,0,0,0,55.0,0:55,0,0,0,2.0,0:2,863333
8476472,Oscar,Klefbom,1993-07-20,D,L,2015-16,30,4,8,12,0.4,-4,48,8.33,6,39393.0,21:53,0,0,0,0.0,21,62,10,31,-21,0,3,3,3374.0,1:52,0,0,0,4779.0,2:39,894167
8476473,Connor,Murphy,1993-03-26,D,R,2015-16,78,6,11,17,0.22,5,101,5.94,48,95985.0,20:30,0,0,0,0.0,175,139,21,29,-8,1,2,3,5234.0,1:7,0,0,0,9973.0,2:7,863333
8476474,Stefan,Noesen,1993-02-12,RW,R,2015-16,1,0,0,0,0.0,0,0,,0,602.0,10:2,0,0,0,0.0,3,0,0,0,0,0,0,0,117.0,1:57,0,0,0,31.0,0:31,863333
8476476,Joe,Morrow,1992-12-09,D,L,2015-16,33,1,6,7,0.21,-7,44,2.27,4,31498.0,15:54,0,0,0,0.0,28,35,9,8,1,0,2,2,1766.0,0:53,0,0,0,733.0,0:22,863333
8476477,Matt,Puempel,1993-01-24,LW,L,2015-16,26,2,1,3,0.12,-3,26,7.69,9,17687.0,11:20,1,1,2,50.0,18,10,6,5,1,0,0,0,790.0,0:30,0,0,0,0.0,0:0,863333
8476478,Stuart,Percy,1993-05-18,D,L,2015-16,3,0,0,0,0.0,-2,1,0.0,0,2369.0,13:9,0,0,0,0.0,4,3,1,1,0,0,0,0,0.0,0:0,0,0,0,0.0,0:0,863333
8476479,Phillip,Danault,1993-02-24,C,L,2015-16,51,4,6,10,0.2,-5,72,5.56,14,39037.0,12:45,247,272,519,47.59,45,28,18,11,7,0,0,0,323.0,0:6,0,0,0,2097.0,0:41,863333
8476480,Vladislav,Namestnikov,1992-11-22,C,L,2015-16,80,14,21,35,0.44,17,106,13.21,45,67756.0,14:6,175,216,391,44.76,49,33,15,18,-3,1,3,4,8663.0,1:48,0,0,0,119.0,0:1,874125
8476483,Rickard,Rakell,1993-05-05,C,R,2015-16,72,20,23,43,0.6,-1,169,11.83,19,69431.0,16:4,197,254,451,43.68,121,30,29,36,-7,4,6,10,9683.0,2:14,0,0,0,464.0,0:6,894167
8476495,Seth,Griffith,1993-01-04,C,R,2015-16,4,0,1,1,0.25,-4,2,0.0,4,2392.0,9:58,0,0,0,0.0,4,0,0,1,-1,0,1,1,460.0,1:55,0,0,0,0.0,0:0,759167
8476505,Turner,Elson,1992-09-13,C,L,2015-16,1,0,1,1,1.0,1,0,,0,894.0,14:54,0,0,0,0.0,2,0,0,0,0,0,0,0,0.0,0:0,0,0,0,179.0,2:59,605000
8476525,Colin,Miller,1992-10-29,D,R,2015-16,42,3,13,16,0.38,0,59,5.08,39,39803.0,15:47,0,0,0,0.0,45,36,6,20,-14,0,5,5,3179.0,1:15,0,0,0,139.0,0:3,602500
8476539,Jonathan,Marchessault,1990-12-27,C,R,2015-16,45,7,11,18,0.4,-10,81,8.64,17,32641.0,12:5,38,41,79,48.1,61,9,10,12,-2,4,3,7,7765.0,2:52,0,0,0,3.0,0:0,600000
8476545,Kurtis,Gabriel,1993-04-20,RW,R,2015-16,3,0,0,0,0.0,1,1,0.0,10,809.0,4:29,0,0,0,0.0,4,0,1,0,1,0,0,0,0.0,0:0,0,0,0,0.0,0:0,666667
8476624,Barclay,Goodrow,1993-02-26,RW,L,2015-16,14,0,3,3,0.21,1,7,0.0,16,8627.0,10:16,4,2,6,66.67,8,4,3,4,-1,0,0,0,28.0,0:2,0,1,1,789.0,0:56,626667
8476766,Cole,Schneider,1990-08-26,LW,L,2015-16,2,0,0,0,0.0,0,5,0.0,0,1515.0,12:37,0,0,0,0.0,3,0,0,0,0,0,0,0,91.0,0:45,0,0,0,0.0,0:0,700000
8476769,Bobby,Farnham,1989-01-21,RW,L,2015-16,53,8,2,10,0.19,-2,50,16.0,97,29616.0,9:18,2,2,4,50.0,93,19,11,7,4,0,0,0,180.0,0:3,0,0,0,216.0,0:4,575000
8476772,Brian,O'Neill,1988-06-01,RW,L,2015-16,22,0,2,2,0.09,-3,14,0.0,8,13677.0,10:21,2,4,6,33.33,36,9,4,3,1,0,0,0,430.0,0:19,0,0,0,615.0,0:27,562500
8476779,Brad,Hunt,1988-08-24,D,L,2015-16,7,0,0,0,0.0,-1,12,0.0,2,5955.0,14:10,0,0,0,0.0,7,7,2,6,-4,0,0,0,1059.0,2:31,0,0,0,15.0,0:2,600000
8476792,Torey,Krug,1991-04-12,D,L,2015-16,81,4,40,44,0.54,9,244,1.64,33,105043.0,21:36,2,0,2,100.0,61,94,20,57,-37,1,18,19,16016.0,3:17,0,0,0,3114.0,0:38,3400000
8476806,J.T.,Brown,1990-07-02,RW,R,2015-16,78,8,14,22,0.28,16,140,5.71,59,62531.0,13:21,23,27,50,46.0,103,40,21,14,7,0,0,0,479.0,0:6,0,2,2,6743.0,1:26,950000
8476807,Matt,Tennyson,1990-04-23,D,R,2015-16,29,1,3,4,0.14,1,23,4.35,0,18288.0,10:30,0,0,0,0.0,23,18,1,14,-13,1,0,1,2192.0,1:15,0,0,0,118.0,0:4,625000
8476808,Brian,Flynn,1988-07-26,C,R,2015-16,56,4,6,10,0.18,-3,73,5.48,6,39423.0,11:43,200,146,346,57.8,23,33,20,11,9,0,0,0,394.0,0:7,1,1,2,5447.0,1:37,950000
8476819,Jeremy,Welsh,1988-04-30,C,L,2015-16,2,0,0,0,0.0,0,0,,2,997.0,8:18,1,2,3,33.33,4,0,1,0,1,0,0,0,34.0,0:17,0,0,0,0.0,0:0,575000
8476822,Luke,Glendening,1989-04-28,RW,R,2015-16,81,8,13,21,0.26,4,88,9.09,46,70848.0,14:34,614,511,1125,54.58,143,71,20,11,9,0,0,0,462.0,0:5,0,0,0,15265.0,3:8,628333
8476826,Yanni,Gourde,1991-12-15,C,L,2015-16,2,0,1,1,0.5,1,0,,2,878.0,7:19,0,0,0,0.0,2,1,0,0,0,0,0,0,0.0,0:0,0,0,0,0.0,0:0,587500
8476850,Ryan,Murray,1993-09-27,D,L,2015-16,82,4,21,25,0.3,-10,90,4.44,40,112403.0,22:50,0,0,0,0.0,51,171,17,39,-22,1,10,11,12986.0,2:38,0,0,0,10565.0,2:8,894167
8476851,Alex,Galchenyuk,1994-02-12,LW,L,2015-16,82,30,26,56,0.68,-8,201,14.93,20,79996.0,16:15,359,390,749,47.93,62,36,31,36,-5,9,7,16,12583.0,2:33,0,0,0,182.0,0:2,2800000
8476852,Griffin,Reinhart,1994-01-24,D,L,2015-16,29,0,1,1,0.03,-6,24,0.0,20,31450.0,18:4,0,0,0,0.0,62,46,6,26,-20,0,0,0,192.0,0:6,0,0,0,2999.0,1:43,863333
8476853,Morgan,Rielly,1994-03-09,D,L,2015-16,82,9,27,36,0.44,-17,167,5.39,28,114277.0,23:13,0,0,0,0.0,58,122,35,72,-37,2,6,8,8994.0,1:49,1,0,1,11619.0,2:21,894167
8476854,Hampus,Lindholm,1994-01-20,D,L,2015-16,80,10,18,28,0.35,7,149,6.71,40,105609.0,22:0,0,0,0,0.0,68,115,18,65,-47,4,11,15,9764.0,2:2,1,0,1,10385.0,2:9,894167
8476855,Nail,Yakupov,1993-10-06,RW,L,2015-16,60,8,15,23,0.38,-16,127,6.3,24,51198.0,14:13,0,1,1,0.0,54,21,27,41,-14,1,5,6,6415.0,1:46,0,0,0,15.0,0:0,2500000
8476856,Matt,Dumba,1994-07-25,D,R,2015-16,81,10,16,26,0.32,1,152,6.58,38,81845.0,16:50,0,0,0,0.0,83,56,13,44,-31,6,6,12,10543.0,2:10,0,0,0,756.0,0:9,894167
8476858,Phillip,Di Giuseppe,1993-10-09,LW,L,2015-16,41,7,10,17,0.41,0,68,10.29,18,35095.0,14:15,7,13,20,35.0,113,21,17,5,12,0,0,0,1887.0,0:46,0,0,0,10.0,0:0,817500
8476867,Brendan,Gaunce,1994-03-25,C,L,2015-16,20,1,0,1,0.05,-9,34,2.94,2,15310.0,12:45,49,58,107,45.79,34,3,11,7,4,0,0,0,496.0,0:24,0,0,0,1297.0,1:4,863333
8476869,Brady,Skjei,1994-03-26,D,L,2015-16,7,0,0,0,0.0,1,6,0.0,4,7448.0,17:44,0,0,0,0.0,11,11,4,3,1,0,0,0,119.0,0:17,0,0,0,1046.0,2:29,925000
8476870,Stefan,Matteau,1994-02-23,C,L,2015-16,32,1,1,2,0.06,-13,27,3.7,17,19743.0,10:16,0,0,0,0.0,67,7,2,9,-7,0,0,0,842.0,0:26,0,0,0,22.0,0:0,612500
8476871,Tanner,Pearson,1992-08-10,LW,L,2015-16,79,15,21,36,0.46,11,137,10.95,18,68543.0,14:27,8,17,25,32.0,104,34,27,18,9,2,2,4,4607.0,0:58,0,0,0,5638.0,1:11,1400000
8476872,Scott,Laughton,1994-05-30,C,L,2015-16,71,7,14,21,0.3,-2,85,8.24,34,44448.0,10:26,170,218,388,43.81,86,29,23,21,2,0,0,0,345.0,0:4,0,0,0,3030.0,0:42,863333
8476874,Olli,Maatta,1994-08-22,D,L,2015-16,67,6,13,19,0.28,27,95,6.32,22,80240.0,19:57,0,0,0,0.0,81,87,8,34,-26,0,1,1,2767.0,0:41,0,1,1,7220.0,1:47,894167
8476875,Mike,Matheson,1994-02-27,D,L,2015-16,3,0,0,0,0.0,1,4,0.0,2,3156.0,17:32,0,0,0,0.0,1,1,1,1,0,0,0,0,3.0,0:1,0,0,0,24.0,0:8,925000
8476878,Zemgus,Girgensons,1994-01-05,C,L,2015-16,71,7,11,18,0.25,0,110,6.36,20,64054.0,15:2,153,182,335,45.67,125,41,16,18,-2,1,1,2,3653.0,0:51,0,1,1,4458.0,1:2,894167
8476879,Cody,Ceci,1993-12-21,D,R,2015-16,75,10,16,26,0.35,9,116,8.62,18,86851.0,19:18,0,0,0,0.0,70,130,15,41,-26,0,2,2,2423.0,0:32,0,0,0,11108.0,2:28,894167
8476880,Tom,Wilson,1994-03-29,RW,R,2015-16,82,7,16,23,0.28,3,99,7.07,163,63531.0,12:54,8,6,14,57.14,253,48,16,21,-5,0,1,1,515.0,0:6,0,1,1,7799.0,1:35,894167
8476881,Tomas,Hertl,1993-11-12,C,L,2015-16,81,21,25,46,0.57,16,202,10.4,26,77629.0,15:58,256,201,457,56.02,90,60,35,41,-6,3,4,7,7862.0,1:37,0,0,0,190.0,0:2,925000
8476882,Teuvo,Teravainen,1994-09-11,LW,L,2015-16,78,13,22,35,0.45,-2,136,9.56,20,71814.0,15:20,125,184,309,40.45,24,31,35,25,10,2,7,9,8224.0,1:45,0,1,1,3644.0,0:46,894167
8476884,Derrick,Pouliot,1994-01-16,D,L,2015-16,22,0,7,7,0.32,4,25,0.0,2,20398.0,15:27,0,0,0,0.0,16,18,6,3,3,0,0,0,1248.0,0:56,0,0,0,196.0,0:8,863333
8476885,Jacob,Trouba,1994-02-26,D,R,2015-16,81,6,15,21,0.26,10,133,4.51,62,107243.0,22:3,0,1,1,0.0,144,177,29,65,-36,0,4,4,6264.0,1:17,1,1,2,13222.0,2:43,894167
8476886,Slater,Koekkoek,1994-02-18,D,L,2015-16,9,0,1,1,0.11,-1,11,0.0,2,5569.0,10:18,0,0,0,0.0,6,5,3,3,0,0,0,0,11.0,0:1,0,0,0,18.0,0:2,894167
8476887,Filip,Forsberg,1994-08-13,LW,R,2015-16,82,33,31,64,0.78,1,247,13.36,47,93739.0,19:3,2,7,9,22.22,114,41,72,52,20,8,15,23,13027.0,2:38,1,0,1,8694.0,1:46,894167
8476888,Mikhail,Grigorenko,1994-05-16,C,L,2015-16,74,6,21,27,0.36,2,84,7.14,8,58904.0,13:16,151,198,349,43.27,23,39,21,18,3,1,3,4,6026.0,1:21,0,0,0,2476.0,0:33,675000
8476889,Radek,Faksa,1994-01-09,C,L,2015-16,45,5,7,12,0.27,9,67,7.46,16,33355.0,12:21,197,204,401,49.13,48,33,20,9,11,0,1,1,203.0,0:4,0,0,0,3543.0,1:18,863333
8476890,Patrick,Sieloff,1994-05-15,D,L,2015-16,1,1,0,1,1.0,1,1,100.0,2,1079.0,17:59,0,0,0,0.0,3,2,0,0,0,0,0,0,0.0,0:0,0,0,0,154.0,2:34,894167
8476892,Colton,Parayko,1993-05-12,D,R,2015-16,79,9,24,33,0.42,28,165,5.45,29,91894.0,19:23,0,0,0,0.0,102,122,33,21,12,3,4,7,7717.0,1:37,0,0,0,4646.0,0:58,858750
8476894,Brendan,Leipsic,1994-05-19,LW,L,2015-16,6,1,2,3,0.5,-1,11,9.09,2,5126.0,14:14,2,1,3,66.67,12,6,3,1,2,0,1,1,730.0,2:1,0,0,0,0.0,0:0,653333
8476897,Oskar,Sundqvist,1994-03-23,C,R,2015-16,18,1,3,4,0.22,0,13,7.69,4,11136.0,10:18,64,75,139,46.04,18,5,6,1,5,0,0,0,48.0,0:2,1,0,1,442.0,0:24,700833
8476902,Esa,Lindell,1994-05-23,D,L,2015-16,4,0,0,0,0.0,-3,2,0.0,0,3371.0,14:2,0,0,0,0.0,4,9,0,3,-3,0,0,0,0.0,0:0,0,0,0,97.0,0:24,745833
8476905,Chandler,Stephenson,1994-04-22,C,L,2015-16,9,0,0,0,0.0,-3,2,0.0,2,4243.0,7:51,30,25,55,54.55,5,4,3,1,2,0,0,0,25.0,0:2,0,0,0,8.0,0:0,725833
8476906,Shayne,Gostisbehere,1993-04-20,D,L,2015-16,64,17,29,46,0.72,8,152,11.18,24,77147.0,20:5,1,0,1,100.0,27,59,28,51,-23,8,14,22,15384.0,4:0,0,0,0,379.0,0:5,925000
8476910,Scott,Kosmachuk,1994-01-24,RW,R,2015-16,8,0,3,3,0.38,1,9,0.0,2,5536.0,11:32,0,0,0,0.0,7,2,1,2,-1,0,0,0,207.0,0:25,0,0,0,0.0,0:0,720000
8476913,Devin,Shore,1994-07-19,C,L,2015-16,3,0,0,0,0.0,2,1,0.0,0,2181.0,12:7,0,1,1,0.0,2,0,0,1,-1,0,0,0,5.0,0:1,0,0,0,0.0,0:0,870000
8476915,Jujhar,Khaira,1994-08-13,LW,L,2015-16,15,0,2,2,0.13,-2,14,0.0,13,9319.0,10:21,0,1,1,0.0,29,6,6,4,2,0,0,0,55.0,0:3,0,0,0,0.0,0:0,875000
8476917,Adam,Pelech,1994-08-16,D,L,2015-16,9,0,2,2,0.22,-1,8,0.0,0,9493.0,17:34,0,0,0,0.0,16,16,1,7,-6,0,0,0,284.0,0:31,0,0,0,1063.0,1:58,854333
8476919,Chris,Tierney,1994-07-01,C,L,2015-16,79,7,13,20,0.25,-16,96,7.29,20,62531.0,13:11,368,437,805,45.71,24,39,31,40,-9,1,0,1,820.0,0:10,1,0,1,7196.0,1:31,711667
8476921,Jordan,Martinook,1992-07-25,LW,L,2015-16,81,9,15,24,0.3,-9,109,8.26,18,73827.0,15:11,18,15,33,54.55,52,40,52,12,40,0,1,1,1709.0,0:21,1,1,2,12568.0,2:35,612500
8476923,Damon,Severson,1994-08-07,D,R,2015-16,72,1,20,21,0.29,-8,94,1.06,32,78472.0,18:9,0,0,0,0.0,66,41,16,36,-20,0,5,5,7360.0,1:42,0,0,0,1307.0,0:18,605833
8476925,Colton,Sissons,1993-11-05,C,R,2015-16,34,4,2,6,0.18,5,25,16.0,12,20317.0,9:57,141,111,252,55.95,35,20,7,5,2,0,0,0,140.0,0:4,0,0,0,2204.0,1:4,635000
8476931,Jake,McCabe,1993-10-12,D,L,2015-16,77,4,10,14,0.18,6,62,6.45,51,88323.0,19:7,0,2,2,0.0,114,109,17,34,-17,0,0,0,745.0,0:9,0,0,0,6542.0,1:24,925000
8476934,Brock,McGinn,1994-02-02,LW,L,2015-16,21,3,1,4,0.19,-14,25,12.0,10,14092.0,11:11,0,1,1,0.0,28,6,4,4,0,0,0,0,198.0,0:9,0,0,0,428.0,0:20,811667
8476941,Connor,Carrick,1994-04-13,D,R,2015-16,19,2,2,4,0.21,-5,21,9.52,15,17708.0,15:32,0,0,0,0.0,38,19,6,17,-11,0,1,1,624.0,0:32,0,0,0,454.0,0:23,636667
8476944,Brendan,Woods,1992-06-11,LW,L,2015-16,5,0,0,0,0.0,0,5,0.0,7,2612.0,8:42,0,1,1,0.0,3,0,1,1,0,0,0,0,0.0,0:0,0,0,0,0.0,0:0,725000
8476948,Charles,Hudon,1994-06-23,LW,L,2015-16,3,0,2,2,0.67,2,3,0.0,0,1925.0,10:41,0,1,1,0.0,7,1,2,0,2,0,0,0,131.0,0:43,0,0,0,0.0,0:0,625000
8476953,Trevor,Carrick,1994-07-04,D,L,2015-16,2,0,0,0,0.0,-1,3,0.0,0,1999.0,16:39,0,0,0,0.0,1,2,4,1,3,0,0,0,57.0,0:28,0,0,0,0.0,0:0,675000
8476955,Taylor,Leier,1994-02-15,LW,L,2015-16,6,0,0,0,0.0,0,3,0.0,0,2780.0,7:43,0,0,0,0.0,2,3,3,1,2,0,0,0,7.0,0:1,0,0,0,17.0,0:2,779617
8476958,Jaccob,Slavin,1994-05-01,D,L,2015-16,63,2,18,20,0.32,1,84,2.38,8,79331.0,20:59,0,0,0,0.0,41,119,54,25,29,0,4,4,3255.0,0:51,0,1,1,7960.0,2:6,742500
8476960,Andreas,Athanasiou,1994-08-06,LW,L,2015-16,37,9,5,14,0.38,1,53,16.98,5,20019.0,9:1,53,76,129,41.09,17,8,11,7,4,0,0,0,42.0,0:1,1,0,1,1127.0,0:30,628333
8476967,Brett,Kulak,1994-01-06,D,L,2015-16,8,0,0,0,0.0,-2,9,0.0,0,5926.0,12:20,0,0,0,0.0,2,3,3,4,-1,0,0,0,0.0,0:0,0,0,0,50.0,0:6,656667
8476975,Cedric,Paquette,1993-08-13,C,L,2015-16,56,6,5,11,0.2,-2,50,12.0,51,42804.0,12:44,141,142,283,49.82,137,31,16,13,3,0,0,0,534.0,0:9,1,0,1,5064.0,1:30,633333
8476979,Erik,Gustafsson,1992-03-14,D,L,2015-16,41,0,14,14,0.34,11,58,0.0,4,38006.0,15:26,0,0,0,0.0,29,37,9,12,-3,0,1,1,4129.0,1:40,0,0,0,181.0,0:4,667500
8476981,Josh,Anderson,1994-05-07,RW,R,2015-16,12,1,3,4,0.33,0,11,9.09,2,7703.0,10:41,0,0,0,0.0,40,4,4,1,3,0,0,0,15.0,0:1,0,0,0,47.0,0:3,678333
8476989,Petteri,Lindbohm,1993-09-23,D,L,2015-16,10,0,0,0,0.0,-4,9,0.0,7,8273.0,13:47,0,0,0,0.0,14,11,2,1,1,0,0,0,8.0,0:0,0,0,0,58.0,0:5,636667
8476994,Vinnie,Hinostroza,1994-04-03,LW,R,2015-16,7,0,0,0,0.0,-1,6,0.0,6,3650.0,8:41,13,19,32,40.62,2,2,3,1,2,0,0,0,62.0,0:8,0,0,0,0.0,0:0,717500
8477006,Christoph,Bertschy,1994-04-05,C,R,2015-16,3,0,0,0,0.0,0,3,0.0,0,1250.0,6:56,0,0,0,0.0,7,2,0,0,0,0,0,0,0.0,0:0,0,0,0,0.0,0:0,775833
8477010,Joseph,Blandisi,1994-07-18,LW,L,2015-16,41,5,12,17,0.41,-14,43,11.63,34,38382.0,15:36,11,22,33,33.33,39,13,19,8,11,4,2,6,5129.0,2:5,0,0,0,77.0,0:1,648333
8477015,Connor,Brown,1994-01-14,RW,R,2015-16,7,1,5,6,0.86,-2,11,9.09,0,6288.0,14:58,0,0,0,0.0,1,2,4,0,4,1,3,4,1443.0,3:26,0,1,1,197.0,0:28,686667
8477018,Ben,Hutton,1993-04-20,D,L,2015-16,75,1,24,25,0.33,-21,104,0.96,14,89430.0,19:52,0,0,0,0.0,42,100,30,53,-23,0,7,7,10273.0,2:16,0,0,0,4102.0,0:54,896250
8477033,Viktor,Loov,1992-11-16,D,L,2015-16,4,0,2,2,0.5,4,1,0.0,0,2510.0,10:27,0,0,0,0.0,8,1,0,0,0,0,0,0,0.0,0:0,0,0,0,78.0,0:19,692500
8477076,JC,Lipon,1993-07-10,RW,R,2015-16,9,0,1,1,0.11,0,4,0.0,5,3762.0,6:58,0,0,0,0.0,29,2,1,0,1,0,0,0,0.0,0:0,0,0,0,0.0,0:0,645000
8477126,Jayson,Megna,1990-02-01,C,R,2015-16,6,1,1,2,0.33,-1,9,11.11,2,4409.0,12:14,1,0,1,100.0,6,1,1,2,-1,0,0,0,625.0,1:44,0,0,0,0.0,0:0,600000
8477205,Andrej,Sustr,1990-11-29,D,R,2015-16,77,4,17,21,0.27,-2,65,6.15,30,77784.0,16:50,0,0,0,0.0,29,66,16,34,-18,0,0,0,390.0,0:5,0,0,0,8426.0,1:49,1450000
8477210,Buddy,Robinson,1991-09-30,RW,R,2015-16,3,1,1,2,0.67,2,5,20.0,4,1548.0,8:36,0,1,1,0.0,11,1,0,1,-1,0,0,0,4.0,0:1,0,0,0,0.0,0:0,925000
8477213,Tim,Schaller,1990-11-16,C,L,2015-16,17,1,2,3,0.18,3,18,5.56,2,8490.0,8:19,40,73,113,35.4,13,9,3,4,-1,0,0,0,10.0,0:0,1,0,1,1205.0,1:10,874125
8477215,Danny,DeKeyser,1990-03-07,D,L,2015-16,78,8,12,20,0.26,2,72,11.11,44,102045.0,21:48,0,0,0,0.0,88,107,17,38,-21,0,0,0,2401.0,0:30,0,0,0,12570.0,2:41,2187500
8477220,Nate,Schmidt,1991-07-16,D,L,2015-16,72,2,14,16,0.22,12,80,2.5,16,78061.0,18:4,0,0,0,0.0,69,111,34,42,-8,0,0,0,257.0,0:3,0,0,0,5816.0,1:20,812500
8477244,Chad,Ruhwedel,1990-05-07,D,R,2015-16,1,0,0,0,0.0,0,1,0.0,2,930.0,15:30,0,0,0,0.0,3,2,0,1,-1,0,0,0,121.0,2:1,0,0,0,0.0,0:0,650000
8477249,Andrew,Miller,1988-09-18,C,R,2015-16,6,0,0,0,0.0,-1,3,0.0,0,3284.0,9:7,13,16,29,44.83,4,0,1,0,1,0,0,0,67.0,0:11,0,0,0,0.0,0:0,630000
8477290,Michael,Raffl,1988-12-01,LW,L,2015-16,82,13,18,31,0.38,9,132,9.85,30,70353.0,14:17,33,49,82,40.24,135,34,31,22,9,1,1,2,6362.0,1:17,0,0,0,355.0,0:4,1100000
8477300,Viktor,Svedberg,1991-05-24,D,L,2015-16,27,2,2,4,0.15,-5,40,5.0,4,25520.0,15:45,0,0,0,0.0,11,28,7,10,-3,0,0,0,402.0,0:14,0,0,0,1466.0,0:54,575000
8477326,Joel,Vermin,1992-02-05,RW,L,2015-16,6,0,1,1,0.17,1,1,0.0,0,3290.0,9:8,1,0,1,100.0,6,2,0,1,-1,0,0,0,302.0,0:50,0,0,0,0.0,0:0,600000
8477392,Hudson,Fasching,1995-07-28,RW,R,2015-16,7,1,1,2,0.29,2,9,11.11,4,4839.0,11:31,0,0,0,0.0,8,1,4,2,2,0,0,0,0.0,0:0,0,0,0,0.0,0:0,925000
8477406,Mattias,Janmark,1992-12-08,C,L,2015-16,73,15,14,29,0.4,12,108,13.89,16,62077.0,14:10,94,166,260,36.15,4,21,26,36,-10,0,1,1,2747.0,0:37,1,0,1,1888.0,0:25,733750
8477407,Anthony,Duclair,1995-08-26,LW,L,2015-16,81,20,24,44,0.54,12,105,19.05,49,69884.0,14:22,0,1,1,0.0,27,27,26,18,8,8,4,12,13776.0,2:50,0,0,0,34.0,0:0,772500
8477413,Sven,Andrighetto,1993-03-21,RW,L,2015-16,44,7,10,17,0.39,1,74,9.46,6,37271.0,14:7,3,4,7,42.86,71,17,9,13,-4,1,1,2,3548.0,1:20,0,0,0,28.0,0:0,633333
8477415,Anton,Slepyshev,1994-05-13,LW,R,2015-16,11,0,1,1,0.09,-5,5,0.0,2,5736.0,8:41,1,0,1,100.0,13,1,2,2,0,0,0,0,134.0,0:12,0,0,0,0.0,0:0,925000
8477416,Oliver,Bjorkstrand,1995-04-10,RW,R,2015-16,12,4,4,8,0.67,6,25,16.0,0,11503.0,15:58,0,0,0,0.0,9,5,6,6,0,0,0,0,1533.0,2:7,0,0,0,31.0,0:2,655833
8477425,Miles,Wood,1995-09-13,LW,L,2015-16,1,0,0,0,0.0,0,2,0.0,0,786.0,13:6,0,0,0,0.0,1,0,0,0,0,0,0,0,7.0,0:7,0,0,0,0.0,0:0,925000
8477426,Nick,Paul,1995-03-20,LW,L,2015-16,24,2,3,5,0.21,-3,28,7.14,6,17559.0,12:11,31,29,60,51.67,43,9,9,2,7,0,0,0,245.0,0:10,0,0,0,134.0,0:5,670000
8477427,Tobias,Lindberg,1995-07-22,RW,L,2015-16,6,0,2,2,0.33,0,12,0.0,4,5702.0,15:50,0,3,3,0.0,10,1,2,2,0,0,0,0,693.0,1:55,0,0,0,232.0,0:38,693333
8477429,Andrew,Copp,1994-07-08,C,L,2015-16,77,7,6,13,0.17,8,54,12.96,6,36975.0,8:0,224,262,486,46.09,87,18,10,18,-8,0,0,0,147.0,0:1,0,0,0,3725.0,0:48,925000
8477433,Ben,Harpur,1995-01-12,D,L,2015-16,5,0,1,1,0.2,1,3,0.0,2,4098.0,13:39,0,0,0,0.0,9,7,0,2,-2,0,0,0,0.0,0:0,0,0,0,88.0,0:17,653333
8477444,Andre,Burakovsky,1995-02-09,LW,L,2015-16,79,17,21,38,0.48,4,126,13.49,12,61736.0,13:1,17,20,37,45.95,37,24,34,30,4,0,4,4,3785.0,0:47,0,0,0,1.0,0:0,894167
8477445,Hunter,Shinkaruk,1994-10-13,C,L,2015-16,8,2,1,3,0.38,-4,12,16.67,2,7183.0,14:57,0,1,1,0.0,9,3,1,2,-1,1,1,2,894.0,1:51,0,0,0,16.0,0:2,863333
8477446,Michael,McCarron,1995-03-07,RW,R,2015-16,20,1,1,2,0.1,-10,41,2.44,37,14018.0,11:40,85,84,169,50.3,49,8,4,7,-3,0,0,0,1462.0,1:13,0,0,0,0.0,0:0,863333
8477447,Shea,Theodore,1995-08-03,D,L,2015-16,19,3,5,8,0.42,7,28,10.71,2,21784.0,19:6,0,0,0,0.0,6,22,10,17,-7,2,1,3,3169.0,2:46,0,0,0,1355.0,1:11,863333
8477448,Marko,Dano,1994-11-30,C,L,2015-16,34,5,5,10,0.29,-7,54,9.26,10,24993.0,12:15,2,4,6,33.33,62,15,10,15,-5,0,1,1,1697.0,0:49,0,0,0,17.0,0:0,925000
8477450,Jason,Dickinson,1995-07-04,C,L,2015-16,1,1,0,1,1.0,1,2,50.0,0,715.0,11:55,1,6,7,14.29,0,1,0,1,-1,0,0,0,0.0,0:0,0,0,0,0.0,0:0,894167
8477451,Ryan,Hartman,1994-09-20,RW,R,2015-16,3,0,1,1,0.33,-1,3,0.0,0,1663.0,9:14,1,3,4,25.0,5,3,3,1,2,0,0,0,0.0,0:0,0,0,0,0.0,0:0,863333
8477453,Chris,Bigras,1995-02-22,D,L,2015-16,31,1,2,3,0.1,-2,21,4.76,16,24816.0,13:20,0,0,0,0.0,17,17,4,8,-4,0,0,0,44.0,0:1,0,0,0,1024.0,0:33,843333
8477455,Jacob,de la Rose,1995-05-20,LW,L,2015-16,22,0,1,1,0.05,-6,20,0.0,6,16414.0,12:26,67,63,130,51.54,39,19,6,3,3,0,0,0,57.0,0:2,0,0,0,1734.0,1:18,925000
8477460,Laurent,Dauphin,1995-03-27,C,L,2015-16,8,1,0,1,0.12,0,7,14.29,4,5431.0,11:18,32,41,73,43.84,6,7,3,0,3,0,0,0,55.0,0:6,0,0,0,425.0,0:53,745000
8477463,Steven,Santini,1995-03-07,D,R,2015-16,1,0,0,0,0.0,2,1,0.0,2,875.0,14:35,0,0,0,0.0,0,2,0,1,-1,0,0,0,22.0,0:22,0,0,0,0.0,0:0,925000
8477464,Nic,Petan,1995-03-22,LW,L,2015-16,26,2,4,6,0.23,2,25,8.0,10,18326.0,11:44,12,9,21,57.14,7,4,11,8,3,0,1,1,2827.0,1:48,0,0,0,29.0,0:1,758333
8477467,Gustav,Olofsson,1994-12-01,D,L,2015-16,2,0,0,0,0.0,0,1,0.0,0,1103.0,9:11,0,0,0,0.0,2,0,0,2,-2,0,0,0,0.0,0:0,0,0,0,39.0,0:19,795000
8477473,Justin,Bailey,1995-07-01,RW,R,2015-16,8,0,0,0,0.0,-2,22,0.0,2,5569.0,11:36,0,0,0,0.0,8,6,4,3,1,0,0,0,133.0,0:16,0,0,0,0.0,0:0,670000
8477486,Emile,Poirier,1994-12-14,LW,L,2015-16,2,0,0,0,0.0,-1,3,0.0,2,1667.0,13:53,0,0,0,0.0,4,1,1,0,1,0,0,0,56.0,0:28,0,0,0,0.0,0:0,863333
8477488,Brett,Pesce,1994-11-15,D,R,2015-16,69,4,12,16,0.23,-7,85,4.71,16,77700.0,18:46,0,1,1,0.0,30,83,43,22,21,1,4,5,3965.0,0:57,0,0,0,4656.0,1:7,809167
8477492,Nathan,MacKinnon,1995-09-01,C,R,2015-16,72,21,31,52,0.72,-4,245,8.57,20,81501.0,18:51,507,540,1047,48.42,46,53,28,39,-11,7,9,16,12620.0,2:55,0,1,1,2503.0,0:34,925000
8477493,Aleksander,Barkov,1995-09-02,C,L,2015-16,66,28,31,59,0.89,18,171,16.37,8,76943.0,19:25,569,587,1156,49.22,43,39,45,29,16,9,7,16,11255.0,2:50,1,1,2,7086.0,1:47,925000
8477494,Jonathan,Drouin,1995-03-28,LW,L,2015-16,21,4,6,10,0.48,1,25,16.0,4,18198.0,14:26,9,10,19,47.37,18,2,8,11,-3,0,2,2,2539.0,2:0,0,0,0,29.0,0:1,894167
8477495,Seth,Jones,1994-10-03,D,R,2015-16,81,3,28,31,0.38,-14,157,1.91,22,107292.0,22:4,0,0,0,0.0,86,118,25,69,-44,1,12,13,12373.0,2:32,0,1,1,9966.0,2:3,925000
8477496,Elias,Lindholm,1994-12-02,C,R,2015-16,82,11,28,39,0.48,-23,176,6.25,24,89108.0,18:6,213,221,434,49.08,112,45,33,34,-1,2,14,16,12771.0,2:35,0,0,0,4017.0,0:48,925000
8477497,Sean,Monahan,1994-10-12,C,L,2015-16,81,27,36,63,0.78,-6,197,13.71,18,93166.0,19:10,887,852,1739,51.01,38,37,55,38,17,7,13,20,15727.0,3:14,0,0,0,3901.0,0:48,925000
8477498,Darnell,Nurse,1995-02-04,D,L,2015-16,69,3,7,10,0.14,-13,120,2.5,60,83755.0,20:13,0,0,0,0.0,160,103,13,43,-30,0,1,1,922.0,0:13,0,1,1,8457.0,2:2,863333
8477499,Rasmus,Ristolainen,1994-10-27,D,R,2015-16,82,9,32,41,0.5,-21,202,4.46,33,124381.0,25:16,0,0,0,0.0,139,137,20,48,-28,4,17,21,15377.0,3:7,0,0,0,12990.0,2:38,925000
8477500,Bo,Horvat,1995-04-05,C,L,2015-16,82,16,24,40,0.49,-30,155,10.32,18,84291.0,17:7,760,733,1493,50.9,69,53,27,17,10,4,8,12,8843.0,1:47,0,0,0,11145.0,2:15,894167
8477501,Valeri,Nichushkin,1995-03-04,RW,L,2015-16,79,9,20,29,0.37,2,139,6.47,12,66036.0,13:55,0,1,1,0.0,68,33,33,46,-13,1,1,2,4693.0,0:59,0,0,0,32.0,0:0,925000
8477503,Max,Domi,1995-03-02,LW,L,2015-16,81,18,34,52,0.64,3,156,11.54,72,79579.0,16:22,20,35,55,36.36,34,25,28,41,-13,3,12,15,14652.0,3:0,0,1,1,1129.0,0:13,863333
8477504,Josh,Morrissey,1995-03-28,D,L,2015-16,1,0,0,0,0.0,0,1,0.0,0,954.0,15:54,0,0,0,0.0,1,2,0,1,-1,0,0,0,9.0,0:9,0,0,0,0.0,0:0,863333
8477505,Alexander,Wennberg,1994-09-22,C,L,2015-16,69,8,32,40,0.58,-1,97,8.25,2,65663.0,15:51,400,522,922,43.38,32,46,42,21,21,1,11,12,8988.0,2:10,0,0,0,2916.0,0:42,925000
8477506,Ryan,Pulock,1994-10-06,D,R,2015-16,15,2,2,4,0.27,1,15,13.33,5,14156.0,15:43,0,0,0,0.0,13,11,3,5,-2,0,0,0,1082.0,1:12,0,0,0,311.0,0:20,863333
8477507,Nikita,Zadorov,1995-04-16,D,L,2015-16,22,0,2,2,0.09,-5,18,0.0,12,22351.0,16:55,0,0,0,0.0,53,16,6,10,-4,0,0,0,576.0,0:26,0,0,0,1127.0,0:51,894167
8477508,Curtis,Lazar,1995-02-02,C,R,2015-16,76,6,14,20,0.26,-1,78,7.69,18,63196.0,13:51,168,216,384,43.75,118,47,24,15,9,1,1,2,3895.0,0:51,1,3,4,6453.0,1:24,894167
8477509,Mirco,Mueller,1995-03-21,D,L,2015-16,11,0,0,0,0.0,-4,8,0.0,7,6998.0,10:36,0,0,0,0.0,2,3,1,6,-5,0,0,0,234.0,0:21,0,0,0,0.0,0:0,894167
8477510,Kerby,Rychel,1994-10-07,LW,L,2015-16,32,2,7,9,0.28,5,32,6.25,15,18267.0,9:30,1,2,3,33.33,39,9,9,9,0,0,0,0,72.0,0:2,0,0,0,9.0,0:0,863333
8477511,Anthony,Mantha,1994-09-16,RW,L,2015-16,10,2,1,3,0.3,-6,18,11.11,2,7020.0,11:42,0,0,0,0.0,4,3,4,2,2,2,0,2,1170.0,1:57,0,0,0,0.0,0:0,863333
8477512,Frederik,Gauthier,1995-04-26,C,L,2015-16,7,0,1,1,0.14,-5,3,0.0,0,5815.0,13:50,52,58,110,47.27,10,7,1,1,0,0,0,0,19.0,0:2,0,1,1,1254.0,2:59,863333
8477527,Ross,Johnston,1994-02-18,LW,L,2015-16,1,0,0,0,0.0,0,0,,4,977.0,16:17,0,0,0,0.0,6,0,2,0,2,0,0,0,82.0,1:22,0,0,0,25.0,0:25,666667
8477566,Sergey,Tolchinsky,1995-02-03,LW,L,2015-16,2,0,1,1,0.5,1,1,0.0,0,1415.0,11:47,0,1,1,0.0,1,0,1,0,1,0,0,0,0.0,0:0,0,0,0,0.0,0:0,616667
8477589,Ronalds,Kenins,1991-02-28,LW,L,2015-16,8,0,0,0,0.0,-1,6,0.0,6,5477.0,11:24,1,2,3,33.33,19,2,3,2,1,0,0,0,2.0,0:0,0,0,0,50.0,0:6,600000
8477591,Josh,Jooris,1990-07-14,RW,R,2015-16,59,4,9,13,0.22,-1,80,5.0,39,43501.0,12:17,114,143,257,44.36,62,33,14,14,0,0,0,0,589.0,0:9,0,2,2,5486.0,1:32,975000
8477642,Rinat,Valiev,1995-05-11,D,L,2015-16,10,0,0,0,0.0,0,7,0.0,0,7350.0,12:15,0,0,0,0.0,9,4,1,3,-2,0,0,0,0.0,0:0,0,0,0,5.0,0:0,778333
8477715,Tyler,Gaudet,1993-04-04,C,L,2015-16,14,1,2,3,0.21,-2,6,16.67,0,8904.0,10:36,43,49,92,46.74,23,4,2,3,-1,0,0,0,34.0,0:2,0,0,0,1153.0,1:22,925000
8477810,Joel,Hanley,1991-06-08,D,L,2015-16,10,0,6,6,0.6,0,10,0.0,0,9599.0,15:59,0,0,0,0.0,6,19,2,4,-2,0,0,0,441.0,0:44,0,0,0,556.0,0:55,667500
8477816,Michael,Zalewski,1992-08-18,LW,L,2015-16,3,0,1,1,0.33,1,2,0.0,2,2134.0,11:51,6,4,10,60.0,7,0,0,1,-1,0,0,0,0.0,0:0,0,0,0,0.0,0:0,575000
8477839,Conor,Sheary,1992-06-08,LW,L,2015-16,44,7,3,10,0.23,-1,51,13.73,8,25748.0,9:45,1,7,8,12.5,15,5,7,9,-2,0,0,0,2004.0,0:45,0,0,0,24.0,0:0,667500
8477845,Trevor,van Riemsdyk,1991-07-24,D,R,2015-16,82,3,11,14,0.17,-5,85,3.53,31,98320.0,19:59,0,0,0,0.0,44,155,17,45,-28,0,2,2,2842.0,0:34,0,1,1,8463.0,1:43,925000
8477846,Ryan,Carpenter,1991-01-18,C,R,2015-16,1,0,0,0,0.0,0,0,,0,447.0,7:27,0,2,2,0.0,1,0,0,0,0,0,0,0,0.0,0:0,0,0,0,0.0,0:0,925000
8477850,Christian,Folin,1991-02-09,D,R,2015-16,26,0,4,4,0.15,-1,14,0.0,11,22745.0,14:34,0,0,0,0.0,38,30,4,10,-6,0,0,0,10.0,0:0,0,0,0,2301.0,1:28,725000
8477851,Jordan,Oesterle,1992-06-25,D,L,2015-16,17,0,5,5,0.29,1,24,0.0,0,22123.0,21:41,0,0,0,0.0,11,26,8,12,-4,0,0,0,1957.0,1:55,0,0,0,1331.0,1:18,767500
8477887,Patrick,Brown,1992-05-29,C,R,2015-16,7,1,1,2,0.29,4,8,12.5,4,5294.0,12:36,0,0,0,0.0,11,6,2,4,-2,0,0,0,40.0,0:5,0,0,0,0.0,0:0,652500
8477901,Daniel,Carr,1991-11-01,LW,L,2015-16,23,6,3,9,0.39,0,39,15.38,8,16661.0,12:4,0,0,0,0.0,25,5,7,4,3,1,0,1,1315.0,0:57,0,0,0,0.0,0:0,842500
8477902,Dennis,Everberg,1991-12-31,RW,L,2015-16,15,0,0,0,0.0,-5,9,0.0,0,8049.0,8:56,0,0,0,0.0,11,12,0,3,-3,0,0,0,16.0,0:1,0,0,0,772.0,0:51,612500
8477903,Garnet,Hathaway,1991-11-23,RW,R,2015-16,14,0,3,3,0.21,-1,11,0.0,31,10095.0,12:1,1,3,4,25.0,50,17,4,3,1,0,0,0,97.0,0:6,0,1,1,518.0,0:37,690000
8477916,Borna,Rendulic,1992-03-25,RW,R,2015-16,3,0,0,0,0.0,-2,1,0.0,0,1355.0,7:31,0,3,3,0.0,1,3,1,0,1,0,0,0,0.0,0:0,0,0,0,0.0,0:0,622500
8477922,Melker,Karlsson,1990-07-18,C,R,2015-16,65,10,9,19,0.29,5,96,10.42,16,52742.0,13:31,11,12,23,47.83,76,48,24,14,10,0,0,0,1762.0,0:27,0,0,0,4604.0,1:10,1650000
8477923,Michael,Keranen,1990-01-04,LW,L,2015-16,1,0,0,0,0.0,-1,0,,0,369.0,6:9,0,0,0,0.0,1,0,0,0,0,0,0,0,0.0,0:0,0,0,0,0.0,0:0,675000
8477929,Dennis,Rasmussen,1990-07-03,C,L,2015-16,44,4,5,9,0.2,9,42,9.52,4,24192.0,9:9,144,163,307,46.91,36,20,7,5,2,0,0,0,118.0,0:2,0,0,0,98.0,0:2,575000
8477930,Pierre-Edouard,Bellemare,1985-03-06,LW,L,2015-16,74,7,7,14,0.19,-8,102,6.86,27,60246.0,13:34,272,307,579,46.98,65,61,37,23,14,0,0,0,255.0,0:3,1,1,2,11474.0,2:35,712500
8477931,Tomas,Nosek,1992-09-01,LW,L,2015-16,6,0,0,0,0.0,-2,2,0.0,2,3650.0,10:8,4,4,8,50.0,6,0,3,0,3,0,0,0,25.0,0:4,0,0,0,525.0,1:27,792500
8477932,Aaron,Ekblad,1996-02-07,D,R,2015-16,78,15,21,36,0.46,18,182,8.24,41,101449.0,21:40,0,0,0,0.0,87,59,24,41,-17,3,6,9,13275.0,2:50,0,0,0,3477.0,0:44,925000
8477933,Sam,Reinhart,1995-11-06,C,R,2015-16,79,23,19,42,0.53,-8,165,13.94,8,79803.0,16:50,36,72,108,33.33,26,26,19,20,-1,8,2,10,13904.0,2:56,0,0,0,120.0,0:1,894167
8477934,Leon,Draisaitl,1995-10-27,C,L,2015-16,72,19,32,51,0.71,-2,133,14.29,20,78014.0,18:3,502,536,1038,48.36,38,18,40,61,-21,5,4,9,11037.0,2:33,0,0,0,239.0,0:3,925000
8477935,Sam,Bennett,1996-06-20,C,L,2015-16,77,18,18,36,0.47,-11,136,13.24,37,69975.0,15:8,160,187,347,46.11,110,32,34,27,7,3,5,8,9058.0,1:57,0,0,0,134.0,0:1,925000
8477937,Jake,Virtanen,1996-08-17,RW,R,2015-16,55,7,6,13,0.24,-7,94,7.45,45,38161.0,11:33,2,3,5,40.0,128,22,22,15,7,1,0,1,3012.0,0:54,0,0,0,0.0,0:0,894167
8477939,William,Nylander,1996-05-01,C,R,2015-16,22,6,7,13,0.59,1,43,13.95,4,21566.0,16:20,143,148,291,49.14,5,5,16,10,6,1,2,3,3585.0,2:42,0,0,0,14.0,0:0,894167
8477940,Nikolaj,Ehlers,1996-02-14,LW,L,2015-16,72,15,23,38,0.53,3,167,8.98,21,69556.0,16:6,0,2,2,0.0,29,25,20,37,-17,4,7,11,9972.0,2:18,0,0,0,69.0,0:0,894167
8477941,Nick,Ritchie,1995-12-05,LW,L,2015-16,33,2,2,4,0.12,-2,55,3.64,37,23289.0,11:45,1,2,3,33.33,93,10,8,4,4,0,0,0,1376.0,0:41,0,0,0,22.0,0:0,894167
8477942,Kevin,Fiala,1996-07-22,LW,L,2015-16,5,1,0,1,0.2,0,11,9.09,0,3946.0,13:9,0,0,0,0.0,2,2,0,3,-3,0,0,0,193.0,0:38,0,0,0,0.0,0:0,894167
8477946,Dylan,Larkin,1996-07-30,C,L,2015-16,80,23,22,45,0.56,11,221,10.41,34,79412.0,16:32,41,59,100,41.0,65,25,43,39,4,4,1,5,9806.0,2:2,0,0,0,505.0,0:6,925000
8477947,Sonny,Milano,1996-05-12,LW,L,2015-16,3,0,1,1,0.33,1,2,0.0,0,2408.0,13:22,0,0,0,0.0,4,2,1,1,0,0,0,0,0.0,0:0,0,0,0,0.0,0:0,894167
8477952,Robby,Fabbri,1996-01-22,C,L,2015-16,72,18,19,37,0.51,-2,114,15.79,25,57521.0,13:18,6,9,15,40.0,51,9,27,20,7,2,6,8,6227.0,1:26,0,0,0,55.0,0:0,894167
8477953,Kasperi,Kapanen,1996-07-23,RW,R,2015-16,9,0,0,0,0.0,-3,14,0.0,2,7981.0,14:46,0,0,0,0.0,10,1,4,1,3,0,0,0,944.0,1:44,0,0,0,0.0,0:0,894167
8477955,Jared,McCann,1996-05-31,C,L,2015-16,69,9,9,18,0.26,-6,106,8.49,32,51841.0,12:31,181,341,522,34.67,45,19,30,26,4,1,2,3,4655.0,1:7,0,0,0,131.0,0:1,894167
8477956,David,Pastrnak,1996-05-25,RW,R,2015-16,51,15,11,26,0.51,3,108,13.89,20,42672.0,13:56,0,3,3,0.0,52,15,35,51,-16,0,1,1,1432.0,0:28,0,0,0,25.0,0:0,925000
8477958,Nikolay,Goldobin,1995-10-07,RW,L,2015-16,9,1,1,2,0.22,1,7,14.29,0,6040.0,11:11,0,0,0,0.0,0,1,3,1,2,0,0,0,13.0,0:1,0,0,0,13.0,0:1,894167
8477997,Nikita,Tryamkin,1994-08-30,D,L,2015-16,13,1,1,2,0.15,-3,11,9.09,10,13665.0,17:31,0,0,0,0.0,31,23,1,3,-2,0,0,0,87.0,0:6,0,0,0,972.0,1:14,925000
8478004,Brett,Lernout,1995-09-24,D,R,2015-16,1,0,0,0,0.0,0,0,,0,390.0,6:30,0,0,0,0.0,1,0,0,0,0,0,0,0,0.0,0:0,0,0,0,0.0,0:0,665000
8478029,Chase,De Leo,1995-10-25,C,L,2015-16,2,0,0,0,0.0,1,2,0.0,0,1130.0,9:25,1,0,1,100.0,3,0,0,0,0,0,0,0,49.0,0:24,0,0,0,0.0,0:0,720833
8478042,Viktor,Arvidsson,1993-04-08,LW,R,2015-16,56,8,8,16,0.29,-8,139,5.76,35,41668.0,12:24,0,0,0,0.0,27,35,15,17,-2,1,0,1,1128.0,0:20,0,0,0,346.0,0:6,631667
8478137,Jiri,Sekac,1992-06-10,LW,L,2015-16,39,1,5,6,0.15,-5,49,2.04,16,27297.0,11:39,2,2,4,50.0,50,18,14,9,5,1,1,2,1850.0,0:47,0,0,0,22.0,0:0,925000
8478366,Frank,Vatrano,1994-03-14,C,L,2015-16,39,8,3,11,0.28,-3,99,8.08,14,27800.0,11:52,0,3,3,0.0,61,23,16,11,5,0,0,0,464.0,0:11,0,0,0,13.0,0:0,792500
8478373,Nikita,Soshnikov,1993-10-14,RW,L,2015-16,11,2,3,5,0.45,-4,33,6.06,6,10310.0,15:37,0,1,1,0.0,34,6,2,3,-1,1,0,1,1004.0,1:31,0,0,0,32.0,0:2,736666
8478393,Kyle,Baun,1992-05-04,RW,R,2015-16,2,0,0,0,0.0,-2,1,0.0,0,1086.0,9:3,0,0,0,0.0,3,0,0,0,0,0,0,0,0.0,0:0,0,0,0,0.0,0:0,858750
8478396,Noah,Hanifin,1997-01-25,D,L,2015-16,79,4,18,22,0.28,-14,122,3.28,22,84865.0,17:54,0,0,0,0.0,67,78,42,49,-7,1,6,7,11230.0,2:22,0,0,0,416.0,0:5,925000
8478401,Pavel,Zacha,1997-04-06,C,L,2015-16,1,0,2,2,2.0,4,3,0.0,0,1011.0,16:51,3,6,9,33.33,1,0,2,0,2,0,0,0,254.0,4:14,0,0,0,55.0,0:55,925000
8478402,Connor,McDavid,1997-01-13,C,L,2015-16,45,16,32,48,1.07,-1,105,15.24,18,50989.0,18:53,249,355,604,41.23,12,10,33,17,16,3,11,14,8002.0,2:57,0,0,0,2109.0,0:46,925000
8478403,Jack,Eichel,1996-10-28,C,R,2015-16,81,24,32,56,0.69,-16,238,10.08,22,92931.0,19:7,402,578,980,41.02,43,25,43,49,-6,8,13,21,14781.0,3:2,0,0,0,1827.0,0:22,925000
8478420,Mikko,Rantanen,1996-10-29,RW,L,2015-16,9,0,0,0,0.0,-7,9,0.0,2,4837.0,8:57,13,11,24,54.17,0,11,1,1,0,0,0,0,0.0,0:0,0,0,0,18.0,0:2,925000
8478430,Oliver,Kylington,1997-05-19,D,L,2015-16,1,0,0,0,0.0,0,1,0.0,0,1042.0,17:22,0,0,0,0.0,0,1,0,0,0,0,0,0,38.0,0:38,0,0,0,1.0,0:1,792500
8478466,Daniel,Sprong,1997-03-17,RW,R,2015-16,18,2,0,2,0.11,-1,23,8.7,0,9423.0,8:43,1,1,2,50.0,14,3,4,5,-1,0,0,0,442.0,0:24,0,0,0,64.0,0:3,692500
8478528,Tanner,Kero,1992-07-24,C,L,2015-16,17,1,2,3,0.18,-2,26,3.85,2,12539.0,12:17,55,68,123,44.72,19,10,8,0,8,0,0,0,173.0,0:10,0,0,0,1652.0,1:37,667500
8478541,Markus,Hannikainen,1993-03-26,LW,L,2015-16,4,0,0,0,0.0,-2,3,0.0,0,1715.0,7:8,0,0,0,0.0,7,0,1,0,1,0,0,0,14.0,0:3,0,0,0,12.0,0:3,717500
8478542,Evan,Rodrigues,1993-07-28,LW,R,2015-16,2,1,1,2,1.0,2,8,12.5,0,1410.0,11:45,0,0,0,0.0,3,0,0,0,0,0,0,0,91.0,0:45,0,0,0,0.0,0:0,842500
8478550,Artemi,Panarin,1991-10-30,LW,R,2015-16,80,30,47,77,0.96,8,187,16.04,32,88898.0,18:31,0,0,0,0.0,46,14,29,35,-6,8,16,24,13622.0,2:50,0,0,0,65.0,0:0,812500
8478561,Andreas,Martinsen,1990-06-13,LW,L,2015-16,55,4,7,11,0.2,-4,52,7.69,47,36621.0,11:5,1,3,4,25.0,155,27,11,5,6,0,0,0,258.0,0:4,0,0,0,114.0,0:2,742500
8478562,Jakub,Nakladal,1987-12-30,D,R,2015-16,27,2,3,5,0.19,-5,42,4.76,6,22988.0,14:11,0,0,0,0.0,41,23,4,11,-7,0,1,1,2590.0,1:35,0,0,0,15.0,0:0,817500
8478563,Evgeny,Medvedev,1982-08-27,D,L,2015-16,45,4,8,12,0.27,5,71,5.63,34,50837.0,18:49,0,0,0,0.0,38,34,13,27,-14,1,2,3,4794.0,1:46,0,0,0,2281.0,0:50,-111
8478564,Joonas,Kemppainen,1988-04-07,C,L,2015-16,44,2,3,5,0.11,-6,35,5.71,4,33100.0,12:32,227,232,459,49.46,36,18,28,9,19,0,0,0,379.0,0:8,1,0,1,4258.0,1:36,792500
8478566,Sergey,Kalinin,1991-03-17,C,L,2015-16,78,8,7,15,0.19,-9,70,11.43,33,62366.0,13:19,134,188,322,41.61,146,30,25,17,8,3,0,3,6092.0,1:18,0,0,0,1131.0,0:14,925000
8478567,Dean,Kukan,1993-07-08,D,L,2015-16,8,0,0,0,0.0,9,3,0.0,0,8330.0,17:21,0,0,0,0.0,7,10,4,3,1,0,0,0,177.0,0:22,0,0,0,156.0,0:19,767500
8478569,Noel,Acciari,1991-12-01,C,R,2015-16,19,0,1,1,0.05,-4,18,0.0,8,11277.0,9:53,60,76,136,44.12,52,4,1,4,-3,0,0,0,101.0,0:5,0,0,0,1460.0,1:16,792500
8478584,Vojtech,Mozik,1992-12-26,D,R,2015-16,7,0,0,0,0.0,0,6,0.0,4,5561.0,13:14,0,0,0,0.0,12,5,0,1,-1,0,0,0,30.0,0:4,0,0,0,0.0,0:0,680000
8478585,Derek,Ryan,1986-12-29,C,R,2015-16,6,2,0,2,0.33,1,5,40.0,2,4393.0,12:12,35,24,59,59.32,2,0,4,2,2,1,0,1,323.0,0:53,0,0,0,0.0,0:0,600000
8478866,Dominik,Simon,1994-08-08,C,L,2015-16,3,0,1,1,0.33,0,2,0.0,0,1093.0,6:4,0,0,0,0.0,1,1,0,1,-1,0,0,0,0.0,0:0,0,0,0,0.0,0:0,692500
8478928,Sergei,Plotnikov,1990-06-03,LW,L,2015-16,45,0,3,3,0.07,-3,41,0.0,24,26672.0,9:52,1,1,2,50.0,107,10,12,15,-3,0,0,0,313.0,0:6,0,0,0,273.0,0:6,925000
8478963,Ryan,Johnston,1992-02-14,D,R,2015-16,3,0,0,0,0.0,1,1,0.0,0,2930.0,16:16,0,0,0,0.0,2,2,0,1,-1,0,0,0,63.0,0:21,0,0,0,0.0,0:0,680000
8479268,Casey,Nelson,1992-07-18,D,R,2015-16,7,0,4,4,0.57,1,5,0.0,8,6225.0,14:49,0,0,0,0.0,5,4,1,2,-1,0,2,2,785.0,1:52,0,0,0,0.0,0:0,1738026
8479293,Brandon,Tanev,1991-12-31,LW,L,2015-16,3,0,0,0,0.0,0,4,0.0,2,2168.0,12:2,0,0,0,0.0,7,2,0,0,0,0,0,0,21.0,0:7,0,0,0,187.0,1:2,2266250
