player_id,firstName,lastName,birthDate,primaryPosition,shootsCatches,season,gamesPlayed,goals,assists,points,pointsPerGame,plusMinus,shots,shootingPercentage,penaltyMinutes,timeOnIce,avgTimeOnIce,faceOffWins,faceOffLosses,faceOffTaken,faceOffPercentage,hits,blocks,takeaways,giveaways,turnoverDifferential,powerPlayGoals,powerPlayAssists,powerPlayPoints,powerPlayTimeOnIce,avgPowerPlayTimeOnIce,shortHandedGoals,shortHandedAssists,shortHandedPoints,shortHandedTimeOnIce,avgShortHandedTimeOnIce,salary
8448208,Jaromir,Jagr,1972-02-15,RW,L,2016-17,82,16,30,46,0.56,2,181,8.84,56,83639.0,16:59,1,1,2,50.0,21,4,40,44,-4,8,5,13,13609.0,2:45,0,0,0,76.0,0:0,4000000
8462038,Shane,Doan,1976-10-10,RW,R,2016-17,74,6,21,27,0.36,-3,144,4.17,48,66813.0,15:2,94,105,199,47.24,101,22,26,34,-8,3,2,5,6909.0,1:33,0,0,0,1.0,0:0,3876134
8462042,Jarome,Iginla,1977-07-01,RW,R,2016-17,80,14,13,27,0.34,-30,153,9.15,70,72610.0,15:7,16,14,30,53.33,116,21,24,26,-2,7,4,11,10897.0,2:16,0,0,0,110.0,0:1,5333333
8464989,Matt,Cullen,1976-11-02,C,L,2016-17,72,13,18,31,0.43,4,93,13.98,30,60128.0,13:55,440,419,859,51.22,36,27,20,32,-12,2,2,4,1625.0,0:22,2,0,2,10060.0,2:19,1000000
8465009,Zdeno,Chara,1977-03-18,D,L,2016-17,75,10,19,29,0.39,18,136,7.35,59,104997.0,23:19,0,1,1,0.0,130,140,35,62,-27,1,2,3,2040.0,0:27,2,0,2,16973.0,3:46,6916667
8465058,Michal,Rozsival,1978-09-03,D,R,2016-17,22,1,2,3,0.14,-3,16,6.25,14,20454.0,15:29,0,0,0,0.0,47,25,5,10,-5,0,0,0,196.0,0:8,0,0,0,1483.0,1:7,600000
8465978,Shawn,Thornton,1977-07-23,LW,R,2016-17,50,2,2,4,0.08,-7,42,4.76,67,23069.0,7:41,5,10,15,33.33,52,8,8,8,0,0,0,0,458.0,0:9,0,0,0,11.0,0:0,600000
8466138,Joe,Thornton,1979-07-02,C,L,2016-17,79,7,43,50,0.63,7,81,8.64,51,85607.0,18:3,375,362,737,50.88,52,31,64,74,-10,1,18,19,15818.0,3:20,0,0,0,146.0,0:1,6750000
8466139,Patrick,Marleau,1979-09-15,C,L,2016-17,82,27,19,46,0.56,4,190,14.21,28,84416.0,17:9,115,100,215,53.49,82,32,46,51,-5,7,9,16,14866.0,3:1,0,0,0,484.0,0:5,6666667
8466148,Marian,Hossa,1979-01-12,RW,L,2016-17,73,26,19,45,0.62,7,167,15.57,8,73836.0,16:51,5,9,14,35.71,32,36,47,29,18,5,6,11,7585.0,1:43,1,0,1,6739.0,1:32,5275000
8466251,Jason,Chimera,1979-05-02,LW,L,2016-17,82,20,13,33,0.4,1,121,16.53,40,64270.0,13:3,16,18,34,47.06,149,30,20,26,-6,0,0,0,743.0,0:9,1,0,1,5894.0,1:11,2250000
8466285,Brian,Campbell,1979-05-23,D,L,2016-17,80,5,12,17,0.21,12,74,6.76,24,88462.0,18:25,0,0,0,0.0,43,83,11,59,-48,2,3,5,7737.0,1:36,0,0,0,549.0,0:6,1500000
8467370,Mike,Fisher,1980-06-05,C,R,2016-17,72,18,24,42,0.58,1,120,15.0,55,71785.0,16:37,703,577,1280,54.92,160,64,21,19,2,7,10,17,9970.0,2:18,0,0,0,7711.0,1:47,4400000
8467371,Mike,Ribeiro,1980-02-10,C,L,2016-17,46,4,21,25,0.54,-5,38,10.53,14,44077.0,15:58,183,261,444,41.22,33,6,10,27,-17,2,5,7,7085.0,2:34,0,0,0,81.0,0:1,5500000
8467400,Francois,Beauchemin,1980-06-04,D,L,2016-17,81,5,13,18,0.22,-14,132,3.79,32,104566.0,21:30,0,0,0,0.0,73,156,28,47,-19,0,3,3,5202.0,1:4,0,0,0,14746.0,3:2,4500000
8467407,Brian,Gionta,1979-01-18,RW,R,2016-17,82,15,20,35,0.43,-11,149,10.07,22,81698.0,16:36,46,60,106,43.4,54,30,28,26,2,3,4,7,7614.0,1:32,1,1,2,9077.0,1:50,4250000
8467493,Chris,Neil,1979-06-18,RW,R,2016-17,53,1,3,4,0.08,-11,42,2.38,63,24077.0,7:34,0,0,0,0.0,108,20,11,9,2,0,0,0,140.0,0:2,0,0,0,9.0,0:0,1500000
8467496,Andrei,Markov,1978-12-20,D,L,2016-17,62,6,30,36,0.58,18,98,6.12,16,81230.0,21:50,0,0,0,0.0,39,73,28,69,-41,1,11,12,9698.0,2:36,0,1,1,6433.0,1:43,5750000
8467875,Daniel,Sedin,1980-09-26,LW,L,2016-17,82,15,29,44,0.54,-16,216,6.94,32,90456.0,18:23,3,3,6,50.0,20,18,26,30,-4,6,8,14,14325.0,2:54,0,0,0,592.0,0:7,7000000
8467876,Henrik,Sedin,1980-09-26,C,L,2016-17,82,15,35,50,0.61,-27,99,15.15,28,93680.0,19:2,611,635,1246,49.04,15,11,29,52,-23,1,14,15,14656.0,2:58,0,0,0,805.0,0:9,7000000
8467967,Chris,Kelly,1980-11-11,C,L,2016-17,82,5,7,12,0.15,-17,85,5.88,23,58740.0,11:56,223,278,501,44.51,71,48,18,24,-6,0,0,0,187.0,0:2,1,0,1,10329.0,2:5,900000
8468001,Derek,MacKenzie,1981-06-11,C,L,2016-17,82,6,10,16,0.2,-7,91,6.59,50,61819.0,12:33,386,386,772,50.0,192,45,34,25,9,0,0,0,756.0,0:9,2,3,5,11070.0,2:15,1300000
8468083,Henrik,Zetterberg,1980-10-09,C,L,2016-17,82,17,51,68,0.83,15,195,8.72,22,97008.0,19:43,705,657,1362,51.76,58,30,38,37,1,2,11,13,14591.0,2:57,0,0,0,286.0,0:3,6083333
8468085,Radim,Vrbata,1981-06-13,RW,R,2016-17,81,20,35,55,0.68,-18,233,8.58,16,82121.0,16:53,17,30,47,36.17,48,31,34,32,2,4,11,15,13091.0,2:41,0,0,0,1215.0,0:15,1000000
8468208,Joel,Ward,1980-12-02,RW,R,2016-17,78,10,19,29,0.37,-2,105,9.52,30,74613.0,15:56,223,233,456,48.9,61,56,34,52,-18,1,2,3,5799.0,1:14,2,0,2,6398.0,1:22,3275000
8468309,Mark,Streit,1977-12-11,D,L,2016-17,68,6,21,27,0.4,-12,114,5.26,28,76492.0,18:44,0,0,0,0.0,38,92,16,39,-23,1,12,13,9340.0,2:17,0,0,0,2271.0,0:33,5250000
8468483,Marian,Gaborik,1982-02-14,RW,L,2016-17,56,10,11,21,0.38,-4,123,8.13,18,49693.0,14:47,0,1,1,0.0,21,15,7,24,-17,3,2,5,4949.0,1:28,0,0,0,244.0,0:4,4875000
8468486,Scott,Hartnell,1982-04-18,LW,L,2016-17,78,13,24,37,0.47,14,104,12.5,63,56450.0,12:3,3,3,6,50.0,94,40,17,30,-13,2,1,3,6589.0,1:24,0,0,0,26.0,0:0,4750000
8468493,Ron,Hainsey,1981-03-24,D,L,2016-17,72,4,13,17,0.24,-8,71,5.63,21,95169.0,22:1,0,0,0,0.0,93,120,25,47,-22,0,0,0,808.0,0:11,1,2,3,13032.0,3:1,2833333
8468498,Brooks,Orpik,1980-09-26,D,L,2016-17,79,0,14,14,0.18,32,93,0.0,48,84306.0,17:47,0,0,0,0.0,181,132,12,36,-24,0,0,0,92.0,0:1,0,0,0,11365.0,2:23,5500000
8468505,Steve,Ott,1982-08-19,C,L,2016-17,53,3,4,7,0.13,-8,45,6.67,80,34229.0,10:45,153,125,278,55.04,144,23,11,8,3,0,0,0,237.0,0:4,0,0,0,5496.0,1:43,800000
8468508,Justin,Williams,1981-10-04,RW,R,2016-17,80,24,24,48,0.6,14,167,14.37,50,74288.0,15:28,64,53,117,54.7,28,41,37,44,-7,5,5,10,9933.0,2:4,0,0,0,1854.0,0:23,3250000
8468509,Niklas,Kronwall,1981-01-12,D,L,2016-17,57,2,11,13,0.23,-7,67,2.99,32,66530.0,19:27,0,0,0,0.0,77,81,6,23,-17,0,6,6,8461.0,2:28,0,0,0,3472.0,1:0,4750000
8468513,Nick,Schultz,1982-08-25,D,L,2016-17,28,0,4,4,0.14,1,25,0.0,10,25627.0,15:15,0,0,0,0.0,45,61,2,13,-11,0,0,0,37.0,0:1,0,0,0,3107.0,1:50,2250000
8468535,Antoine,Vermette,1982-07-20,C,L,2016-17,72,9,19,28,0.39,-7,88,10.23,42,68703.0,15:54,744,451,1195,62.26,51,45,14,28,-14,5,6,11,8160.0,1:53,0,0,0,3968.0,0:55,3750000
8468542,Paul,Martin,1981-03-05,D,L,2016-17,81,4,22,26,0.32,10,57,7.02,20,93441.0,19:13,0,0,0,0.0,41,124,36,57,-21,0,0,0,866.0,0:10,0,0,0,9057.0,1:51,4850000
8468575,Dominic,Moore,1980-08-03,C,L,2016-17,82,11,14,25,0.3,2,96,11.46,44,63673.0,12:56,357,297,654,54.59,63,42,31,26,5,0,0,0,1071.0,0:13,3,1,4,9682.0,1:58,900000
8468611,Matt,Hendricks,1981-06-17,C,L,2016-17,42,4,3,7,0.17,-3,42,9.52,29,27087.0,10:44,132,100,232,56.9,79,39,10,9,1,0,0,0,194.0,0:4,0,0,0,3804.0,1:30,1850000
8468639,John-Michael,Liles,1980-11-25,D,L,2016-17,36,0,5,5,0.14,1,36,0.0,4,35007.0,16:12,2,0,2,100.0,25,41,11,8,3,0,3,3,3349.0,1:33,0,0,0,2885.0,1:20,2000000
8468674,Deryk,Engelland,1982-04-03,D,R,2016-17,81,4,12,16,0.2,2,107,3.74,85,89083.0,18:19,1,0,1,100.0,135,134,19,49,-30,0,0,0,125.0,0:1,0,0,0,15674.0,3:13,2916667
8469455,Jason,Spezza,1983-06-13,C,R,2016-17,68,15,35,50,0.74,-18,149,10.07,29,65977.0,16:10,354,324,678,52.21,13,31,32,49,-17,2,17,19,10912.0,2:40,1,0,1,1110.0,0:16,7500000
8469459,Mikko,Koivu,1983-03-12,C,L,2016-17,80,18,40,58,0.72,27,139,12.95,34,91753.0,19:6,938,761,1699,55.21,32,65,39,28,11,2,18,20,10691.0,2:13,0,2,2,8762.0,1:49,6750000
8469465,Dan,Hamhuis,1982-12-13,D,L,2016-17,79,1,15,16,0.2,-7,83,1.2,23,91766.0,19:21,0,0,0,0.0,93,100,19,37,-18,1,0,1,7434.0,1:34,0,2,2,9566.0,2:1,3750000
8469466,Ales,Hemsky,1983-08-13,RW,R,2016-17,15,4,3,7,0.47,-1,30,13.33,0,12978.0,14:25,0,0,0,0.0,1,4,9,6,3,1,1,2,1386.0,1:32,0,0,0,82.0,0:5,4000000
8469492,Fedor,Tyutin,1983-07-19,D,L,2016-17,69,1,12,13,0.19,-25,46,2.17,38,78405.0,18:56,0,0,0,0.0,116,90,15,19,-4,0,0,0,139.0,0:2,0,0,0,10362.0,2:30,4500000
8469500,Michael,Cammalleri,1982-06-08,LW,L,2016-17,61,10,21,31,0.51,-9,142,7.04,21,63519.0,17:21,17,11,28,60.71,44,14,24,32,-8,1,9,10,9215.0,2:31,0,0,0,204.0,0:3,5000000
8469501,Chris,Thorburn,1983-06-03,RW,R,2016-17,64,3,1,4,0.06,-7,36,8.33,95,26789.0,6:58,13,13,26,50.0,90,25,4,4,0,0,0,0,127.0,0:1,1,0,1,2376.0,0:37,1200000
8469506,Jason,Pominville,1982-11-30,RW,R,2016-17,78,13,34,47,0.6,2,176,7.39,4,66579.0,14:13,39,39,78,50.0,44,38,22,13,9,0,7,7,5287.0,1:7,0,0,0,4243.0,0:54,5600000
8469508,Jay,McClement,1983-03-02,C,L,2016-17,65,5,3,8,0.12,-8,37,13.51,18,44392.0,11:22,253,272,525,48.19,49,40,29,15,14,0,0,0,415.0,0:6,1,0,1,7252.0,1:51,1200000
8469521,Tomas,Plekanec,1982-10-31,C,L,2016-17,78,10,18,28,0.36,10,139,7.19,24,78712.0,16:49,692,660,1352,51.18,57,45,30,29,1,3,4,7,4452.0,0:57,2,0,2,9228.0,1:58,6000000
8469544,Patrick,Sharp,1981-12-27,LW,R,2016-17,48,8,10,18,0.38,-22,146,5.48,31,45917.0,15:56,29,32,61,47.54,24,24,16,21,-5,1,0,1,6038.0,2:5,1,0,1,787.0,0:16,5900000
8469547,Jordin,Tootoo,1983-02-02,RW,R,2016-17,50,2,1,3,0.06,-6,43,4.65,28,20241.0,6:44,1,0,1,100.0,52,8,9,9,0,0,0,0,64.0,0:1,0,0,0,0.0,0:0,750000
8469598,Kevin,Bieksa,1981-06-16,D,R,2016-17,81,3,11,14,0.17,0,94,3.19,63,91130.0,18:45,0,0,0,0.0,173,100,13,54,-41,1,2,3,4574.0,0:56,0,0,0,8215.0,1:41,4000000
8469619,Dennis,Seidenberg,1981-07-18,D,L,2016-17,73,5,17,22,0.3,25,89,5.62,32,85089.0,19:25,0,0,0,0.0,154,146,10,33,-23,0,0,0,848.0,0:11,0,0,0,8201.0,1:52,4000000
8469638,Jussi,Jokinen,1983-04-01,LW,L,2016-17,69,11,17,28,0.41,-15,118,9.32,39,72080.0,17:24,75,69,144,52.08,28,33,27,59,-32,4,6,10,10207.0,2:27,1,0,1,5627.0,1:21,4000000
8469665,Johnny,Oduya,1981-10-01,D,L,2016-17,52,2,7,9,0.17,-4,37,5.41,18,57011.0,18:16,0,0,0,0.0,29,123,14,37,-23,0,0,0,424.0,0:8,0,0,0,7243.0,2:19,3750000
8469707,PA,Parenteau,1983-03-24,RW,R,2016-17,67,13,15,28,0.42,-18,123,10.57,35,59084.0,14:41,6,14,20,30.0,60,9,21,31,-10,4,4,8,8893.0,2:12,0,0,0,154.0,0:2,1250000
8469759,Vernon,Fiddler,1980-05-09,C,L,2016-17,59,2,2,4,0.07,-15,48,4.17,66,41249.0,11:39,370,319,689,53.7,57,33,12,21,-9,0,0,0,266.0,0:4,1,0,1,6294.0,1:46,1250000
8469760,Zbynek,Michalek,1982-12-23,D,R,2016-17,3,0,0,0,0.0,1,3,0.0,0,3179.0,17:39,0,0,0,0.0,7,5,0,3,-3,0,0,0,0.0,0:0,0,0,0,235.0,1:18,3200000
8469770,Dennis,Wideman,1983-03-20,D,R,2016-17,57,5,13,18,0.32,-6,87,5.75,32,69185.0,20:13,0,0,0,0.0,61,74,21,49,-28,2,3,5,3586.0,1:2,0,0,0,7398.0,2:9,5250000
8470041,Rick,Nash,1984-06-16,LW,L,2016-17,67,23,15,38,0.57,9,195,11.79,26,66186.0,16:27,0,1,1,0.0,63,35,43,46,-3,6,3,9,8094.0,2:0,1,0,1,4842.0,1:12,7800000
8470047,Valtteri,Filppula,1984-03-20,C,L,2016-17,79,12,30,42,0.53,-1,97,12.37,26,82505.0,17:24,556,606,1162,47.85,26,39,30,39,-9,0,7,7,8952.0,1:53,0,0,0,8282.0,1:44,5000000
8470104,Tom,Gilbert,1983-01-10,D,R,2016-17,18,1,4,5,0.28,-4,12,8.33,6,16693.0,15:27,0,0,0,0.0,10,28,1,7,-6,0,1,1,1691.0,1:33,0,0,0,1217.0,1:7,1400000
8470105,Scottie,Upshall,1983-10-07,RW,L,2016-17,73,10,8,18,0.25,-1,85,11.76,45,48107.0,10:59,3,9,12,25.0,99,21,16,18,-2,0,0,0,247.0,0:3,2,0,2,7761.0,1:46,900000
8470110,Trevor,Daley,1983-10-09,D,L,2016-17,56,5,14,19,0.34,7,84,5.95,37,68471.0,20:22,0,0,0,0.0,29,83,20,18,2,1,3,4,5503.0,1:38,0,1,1,7982.0,2:22,3300000
8470121,Matt,Greene,1983-05-13,D,R,2016-17,26,1,1,2,0.08,3,14,7.14,19,20564.0,13:10,0,0,0,0.0,71,27,3,17,-14,0,0,0,6.0,0:0,0,0,0,1894.0,1:12,2500000
8470144,Frans,Nielsen,1984-04-24,C,L,2016-17,79,17,24,41,0.52,-19,162,10.49,18,81281.0,17:8,653,561,1214,53.79,64,54,29,26,3,4,11,15,11386.0,2:24,2,0,2,9087.0,1:55,5250000
8470151,Jay,Bouwmeester,1983-09-27,D,L,2016-17,81,1,14,15,0.19,6,106,0.94,28,108889.0,22:24,0,0,0,0.0,67,111,11,37,-26,0,1,1,715.0,0:8,0,0,0,14503.0,2:59,5400000
8470159,Boyd,Gordon,1983-10-19,C,R,2016-17,13,1,0,1,0.08,-5,8,12.5,2,6379.0,8:10,48,38,86,55.81,4,7,2,0,2,0,0,0,2.0,0:0,0,0,0,1190.0,1:31,950000
8470162,Matt,Stajan,1983-12-19,C,L,2016-17,81,6,17,23,0.28,3,59,10.17,40,61631.0,12:40,385,383,768,50.13,60,39,30,22,8,0,0,0,404.0,0:4,0,2,2,8700.0,1:47,3125000
8470187,Johnny,Boychuk,1984-01-19,D,R,2016-17,66,6,17,23,0.35,11,155,3.87,19,82095.0,20:43,1,0,1,100.0,160,133,13,45,-32,1,3,4,7194.0,1:49,1,1,2,8308.0,2:5,6000000
8470201,Jiri,Hudler,1984-01-04,RW,L,2016-17,32,3,8,11,0.34,-3,27,11.11,4,22752.0,11:51,3,2,5,60.0,9,3,12,7,5,1,0,1,3947.0,2:3,0,0,0,5.0,0:0,2000000
8470257,Alexander,Steen,1984-03-01,LW,L,2016-17,76,16,35,51,0.67,-2,117,13.68,53,88034.0,19:18,101,146,247,40.89,33,69,27,18,9,3,13,16,13297.0,2:54,0,0,0,8477.0,1:51,5800000
8470281,Duncan,Keith,1983-07-16,D,L,2016-17,80,6,47,53,0.66,22,183,3.28,16,122960.0,25:37,0,0,0,0.0,24,107,32,73,-41,2,13,15,15191.0,3:9,0,0,0,11716.0,2:26,5538462
8470318,Jonathan,Ericsson,1984-03-02,D,L,2016-17,51,1,8,9,0.18,-2,43,2.33,63,58815.0,19:13,0,0,0,0.0,86,36,9,27,-18,0,0,0,383.0,0:7,0,0,0,6309.0,2:3,4250000
8470324,Josh,Gorges,1984-08-14,D,L,2016-17,66,1,5,6,0.09,-3,40,2.5,50,73091.0,18:27,0,1,1,0.0,143,108,7,17,-10,0,0,0,95.0,0:1,0,0,0,10599.0,2:40,3900000
8470358,Alexandre,Burrows,1981-04-11,RW,L,2016-17,75,15,16,31,0.41,3,143,10.49,62,65910.0,14:38,5,9,14,35.71,68,34,35,19,16,1,0,1,3172.0,0:42,0,1,1,5310.0,1:10,4500000
8470543,Chris,Kunitz,1979-09-26,LW,L,2016-17,71,9,20,29,0.41,0,134,6.72,36,66088.0,15:30,3,10,13,23.08,216,28,25,28,-3,0,5,5,6713.0,1:34,0,0,0,3108.0,0:43,3850000
8470595,Eric,Staal,1984-10-29,C,L,2016-17,82,28,37,65,0.79,17,211,13.27,34,91548.0,18:36,577,597,1174,49.15,42,39,51,24,27,4,12,16,11679.0,2:22,1,1,2,6731.0,1:22,3500000
8470598,Thomas,Vanek,1984-01-19,LW,R,2016-17,68,17,31,48,0.71,-5,133,12.78,22,58769.0,14:24,6,9,15,40.0,29,5,21,34,-13,5,8,13,10909.0,2:40,0,0,0,65.0,0:0,6500000
8470599,Milan,Michalek,1984-12-07,LW,L,2016-17,5,1,1,2,0.4,-2,6,16.67,2,4281.0,14:16,0,1,1,0.0,7,9,3,1,2,0,0,0,399.0,1:19,0,0,0,325.0,1:5,4000000
8470600,Ryan,Suter,1985-01-21,D,L,2016-17,82,9,31,40,0.49,34,164,5.49,36,132469.0,26:55,0,0,0,0.0,72,105,41,38,3,4,8,12,13569.0,2:45,1,1,2,11451.0,2:19,7538462
8470601,Braydon,Coburn,1985-02-27,D,L,2016-17,80,5,7,12,0.15,-1,102,4.9,50,80335.0,16:44,0,0,0,0.0,109,76,6,35,-29,0,0,0,386.0,0:4,1,0,1,9765.0,2:2,3700000
8470602,Dion,Phaneuf,1985-04-10,D,L,2016-17,81,9,21,30,0.37,-6,156,5.77,100,111982.0,23:2,0,0,0,0.0,132,156,16,54,-38,4,12,16,12498.0,2:34,1,0,1,11880.0,2:26,7000000
8470604,Jeff,Carter,1985-01-01,C,R,2016-17,82,32,34,66,0.8,2,250,12.8,41,88717.0,18:1,735,680,1415,51.94,86,37,24,46,-22,10,12,22,14247.0,2:53,1,0,1,7469.0,1:31,5272727
8470606,Dustin,Brown,1984-11-04,RW,R,2016-17,80,14,22,36,0.45,-4,175,8.0,22,76801.0,16:0,2,3,5,40.0,190,31,25,27,-2,4,2,6,7221.0,1:30,1,0,1,6230.0,1:17,5875000
8470607,Brent,Seabrook,1985-04-20,D,R,2016-17,79,3,36,39,0.49,5,131,2.29,26,103767.0,21:53,0,1,1,0.0,111,147,24,88,-64,2,12,14,12772.0,2:41,0,0,0,8944.0,1:53,6875000
8470610,Zach,Parise,1984-07-28,LW,L,2016-17,69,19,23,42,0.61,-3,194,9.79,30,72156.0,17:25,8,5,13,61.54,46,69,33,17,16,6,6,12,9453.0,2:17,0,0,0,4316.0,1:2,7538462
8470611,Eric,Fehr,1985-09-07,C,R,2016-17,53,6,5,11,0.21,2,62,9.68,14,34751.0,10:55,79,75,154,51.3,82,35,24,10,14,0,0,0,809.0,0:15,0,0,0,5697.0,1:47,2000000
8470612,Ryan,Getzlaf,1985-05-10,C,R,2016-17,74,15,58,73,0.99,7,138,10.87,49,93553.0,21:4,509,503,1012,50.3,99,88,61,68,-7,6,14,20,13664.0,3:4,2,1,3,7471.0,1:40,8250000
8470613,Brent,Burns,1985-03-09,D,R,2016-17,82,29,47,76,0.93,19,320,9.06,40,122324.0,24:51,0,0,0,0.0,69,142,53,153,-100,8,17,25,17695.0,3:35,0,1,1,8510.0,1:43,5760000
8470614,Mark,Stuart,1984-04-27,D,L,2016-17,42,2,2,4,0.1,4,24,8.33,27,31385.0,12:27,0,0,0,0.0,68,79,3,23,-20,0,0,0,12.0,0:0,0,0,0,5716.0,2:16,2625000
8470616,Ryan,Kesler,1984-08-31,C,R,2016-17,82,22,36,58,0.71,8,186,11.83,83,104814.0,21:18,1029,764,1793,57.39,146,75,22,39,-17,8,12,20,14041.0,2:51,0,0,0,13391.0,2:43,6875000
8470619,Brian,Boyle,1984-12-18,C,L,2016-17,75,13,12,25,0.33,3,131,9.92,66,58649.0,13:1,303,278,581,52.15,115,41,22,19,3,3,3,6,5293.0,1:10,0,0,0,4841.0,1:4,2000000
8470621,Corey,Perry,1985-05-16,RW,R,2016-17,82,19,34,53,0.65,2,215,8.84,76,87162.0,17:42,7,13,20,35.0,81,35,32,38,-6,5,15,20,14206.0,2:53,0,0,0,146.0,0:1,8625000
8470622,Patrick,Eaves,1984-05-01,RW,R,2016-17,79,32,19,51,0.65,-2,209,15.31,24,77776.0,16:24,2,2,4,50.0,89,43,30,19,11,13,5,18,14001.0,2:57,0,0,0,812.0,0:10,1000000
8470626,Loui,Eriksson,1985-07-17,LW,L,2016-17,65,11,13,24,0.37,-9,132,8.33,8,72843.0,18:40,0,1,1,0.0,11,26,37,16,21,5,2,7,9645.0,2:28,0,1,1,5555.0,1:25,6000000
8470630,Kevin,Klein,1984-12-13,D,R,2016-17,60,3,11,14,0.23,5,54,5.56,31,63490.0,17:38,0,0,0,0.0,135,123,12,35,-23,0,1,1,210.0,0:3,0,1,1,4567.0,1:16,2900000
8470638,Patrice,Bergeron,1985-07-24,C,R,2016-17,79,21,32,53,0.67,12,302,6.95,24,92065.0,19:25,1089,723,1812,60.1,54,47,65,23,42,8,9,17,13995.0,2:57,0,3,3,10206.0,2:9,6875000
8470640,Matt,Carle,1984-09-25,D,L,2016-17,6,0,1,1,0.17,-1,2,0.0,0,4732.0,13:8,0,0,0,0.0,3,5,0,4,-4,0,0,0,11.0,0:1,0,0,0,231.0,0:38,5500000
8470642,Shea,Weber,1985-08-14,D,R,2016-17,78,17,25,42,0.54,20,183,9.29,38,117286.0,25:3,0,0,0,0.0,140,157,11,80,-69,12,10,22,15151.0,3:14,0,2,2,13750.0,2:56,7857143
8470644,Colin,McDonald,1984-09-30,RW,R,2016-17,3,1,0,1,0.33,1,5,20.0,0,1624.0,9:1,0,1,1,0.0,9,0,0,0,0,0,0,0,16.0,0:5,0,0,0,0.0,0:0,637500
8470655,David,Backes,1984-05-01,RW,R,2016-17,74,17,21,38,0.51,2,175,9.71,69,76007.0,17:7,60,63,123,48.78,226,47,28,35,-7,2,5,7,9504.0,2:8,0,0,0,2372.0,0:32,6000000
8470667,Clarke,MacArthur,1985-04-06,LW,L,2016-17,4,0,0,0,0.0,-1,5,0.0,0,3237.0,13:29,0,1,1,0.0,4,1,1,1,0,0,0,0,533.0,2:13,0,0,0,0.0,0:0,4650000
8470724,Kyle,Quincey,1985-08-12,D,L,2016-17,73,6,9,15,0.21,4,79,7.59,51,78375.0,17:53,0,0,0,0.0,97,97,19,38,-19,0,0,0,1158.0,0:15,0,0,0,8014.0,1:49,1250000
8470740,Lee,Stempniak,1983-02-04,RW,R,2016-17,82,16,24,40,0.49,2,131,12.21,32,77952.0,15:50,3,5,8,37.5,113,16,57,49,8,2,4,6,9602.0,1:57,0,0,0,49.0,0:0,2500000
8470750,John,Mitchell,1985-01-22,C,L,2016-17,65,3,4,7,0.11,-12,57,5.26,45,48960.0,12:33,298,240,538,55.39,88,45,29,17,12,0,0,0,830.0,0:12,0,0,0,2437.0,0:37,1800000
8470755,Brad,Richardson,1985-02-04,C,L,2016-17,16,5,4,9,0.56,-1,25,20.0,15,14732.0,15:20,121,109,230,52.61,19,7,10,3,7,0,0,0,181.0,0:11,2,1,3,1944.0,2:1,2083333
8470760,Marc,Methot,1985-06-21,D,L,2016-17,68,0,12,12,0.18,13,69,0.0,24,80877.0,19:49,0,0,0,0.0,164,77,11,38,-27,0,0,0,242.0,0:3,0,0,0,8438.0,2:4,4900000
8470775,Nate,Thompson,1984-10-05,C,L,2016-17,30,1,1,2,0.07,4,19,5.26,14,18694.0,10:23,130,115,245,53.06,69,9,6,5,1,0,0,0,220.0,0:7,0,0,0,2862.0,1:35,1600000
8470778,Drew,Miller,1984-02-17,LW,L,2016-17,55,5,2,7,0.13,-12,43,11.63,18,33929.0,10:16,2,1,3,66.67,71,52,13,5,8,0,0,0,166.0,0:3,0,0,0,4537.0,1:22,1025000
8470794,Joe,Pavelski,1984-07-11,C,R,2016-17,81,29,39,68,0.84,11,233,12.45,34,92910.0,19:7,449,407,856,52.45,130,73,33,84,-51,7,15,22,16230.0,3:20,1,0,1,1460.0,0:18,6000000
8470803,Kyle,Brodziak,1984-05-25,C,R,2016-17,69,8,7,15,0.22,2,55,14.55,27,46394.0,11:12,323,330,653,49.46,56,39,33,6,27,0,0,0,116.0,0:1,0,0,0,8369.0,2:1,950000
8470828,Toby,Enstrom,1984-11-05,D,L,2016-17,60,1,13,14,0.23,-7,46,2.17,42,78856.0,21:54,0,0,0,0.0,24,94,8,33,-25,0,6,6,5261.0,1:27,1,0,1,10789.0,2:59,5750000
8470834,Dustin,Byfuglien,1985-03-27,D,R,2016-17,80,13,39,52,0.65,10,241,5.39,117,131734.0,27:26,0,0,0,0.0,183,124,65,85,-20,1,13,14,15857.0,3:18,0,2,2,11252.0,2:20,7600000
8470852,Matt,Moulson,1983-11-01,LW,L,2016-17,81,14,18,32,0.4,-4,134,10.45,10,56408.0,11:36,1,3,4,25.0,37,18,18,12,6,11,7,18,10305.0,2:7,0,0,0,42.0,0:0,5000000
8470854,Tanner,Glass,1983-11-29,LW,L,2016-17,11,1,1,2,0.18,0,8,12.5,17,7201.0,10:54,2,0,2,100.0,37,4,2,0,2,0,0,0,31.0,0:2,0,0,0,166.0,0:15,1450000
8470886,Clayton,Stoner,1985-02-19,D,L,2016-17,14,1,2,3,0.21,0,16,6.25,28,14743.0,17:33,0,0,0,0.0,35,17,2,3,-1,0,0,0,46.0,0:3,0,0,0,1859.0,2:12,3250000
8470966,Mark,Giordano,1983-10-03,D,L,2016-17,81,12,27,39,0.48,22,151,7.95,59,114610.0,23:34,0,0,0,0.0,78,184,45,43,2,3,11,14,12582.0,2:35,2,1,3,15743.0,3:14,6750000
8471214,Alex,Ovechkin,1985-09-17,LW,R,2016-17,82,33,36,69,0.84,6,313,10.54,50,90361.0,18:21,0,1,1,0.0,216,29,29,46,-17,17,9,26,18321.0,3:43,0,0,0,134.0,0:1,9538462
8471215,Evgeni,Malkin,1986-07-31,C,L,2016-17,62,33,39,72,1.16,18,191,17.28,77,69263.0,18:37,365,481,846,43.14,40,25,52,54,-2,11,12,23,13653.0,3:40,0,0,0,149.0,0:2,9500000
8471217,Andrew,Ladd,1985-12-12,LW,L,2016-17,78,23,8,31,0.4,-14,142,16.2,45,75702.0,16:10,4,6,10,40.0,112,54,37,43,-6,3,2,5,9765.0,2:5,1,0,1,3920.0,0:50,5500000
8471218,Blake,Wheeler,1986-08-31,RW,R,2016-17,82,26,48,74,0.9,6,259,10.04,47,99099.0,20:8,43,51,94,45.74,100,51,39,44,-5,5,16,21,14504.0,2:56,2,1,3,6856.0,1:23,5600000
8471226,Drew,Stafford,1985-10-30,RW,R,2016-17,58,8,13,21,0.36,6,109,7.34,24,47331.0,13:36,7,15,22,31.82,62,3,13,28,-15,3,1,4,4599.0,1:19,0,0,0,702.0,0:12,4350000
8471228,Alexander,Radulov,1986-07-05,RW,L,2016-17,76,18,36,54,0.71,10,147,12.24,62,83405.0,18:17,6,6,12,50.0,76,41,42,52,-10,6,10,16,12988.0,2:50,0,0,0,93.0,0:1,5750000
8471232,Lauri,Korpikoski,1986-07-28,LW,L,2016-17,69,8,12,20,0.29,5,108,7.41,10,51364.0,12:24,0,7,7,0.0,37,36,12,21,-9,0,0,0,1127.0,0:16,0,1,1,5545.0,1:20,2500000
8471233,Travis,Zajac,1985-05-13,C,R,2016-17,80,14,31,45,0.56,-8,126,11.11,33,94682.0,19:43,884,733,1617,54.67,81,26,44,25,19,6,6,12,12333.0,2:34,1,1,2,11139.0,2:19,5750000
8471242,Mike,Green,1985-10-12,D,R,2016-17,72,14,22,36,0.5,-20,125,11.2,40,101763.0,23:33,0,0,0,0.0,67,92,24,52,-28,3,7,10,11872.0,2:44,0,0,0,2540.0,0:35,6000000
8471254,Bryan,Bickell,1986-03-09,LW,L,2016-17,11,1,0,1,0.09,-4,8,12.5,4,6891.0,10:26,0,2,2,0.0,16,3,3,2,1,1,0,1,892.0,1:21,0,0,0,0.0,0:0,4000000
8471260,Blake,Comeau,1986-02-18,LW,R,2016-17,77,8,12,20,0.26,-19,103,7.77,58,69229.0,14:59,114,132,246,46.34,129,22,35,18,17,2,0,2,2867.0,0:37,1,0,1,8822.0,1:54,2400000
8471262,Carl,Soderberg,1985-10-12,C,L,2016-17,80,6,8,14,0.18,-26,128,4.69,22,64537.0,13:26,365,337,702,51.99,34,42,30,19,11,1,1,2,4705.0,0:58,0,0,0,3347.0,0:41,4750000
8471269,Nicklas,Grossmann,1985-01-22,D,L,2016-17,3,0,0,0,0.0,-4,3,0.0,2,2342.0,13:0,0,0,0,0.0,7,1,0,1,-1,0,0,0,0.0,0:0,0,0,0,195.0,1:5,575000
8471273,Brandon,Dubinsky,1986-04-29,C,L,2016-17,80,12,29,41,0.51,16,115,10.43,91,85898.0,17:53,770,718,1488,51.75,248,60,38,32,6,1,3,4,6813.0,1:25,1,0,1,8283.0,1:43,5850000
8471274,Alex,Goligoski,1985-07-30,D,L,2016-17,82,6,30,36,0.44,-9,112,5.36,28,114780.0,23:19,0,0,0,0.0,137,143,15,57,-42,1,7,8,10706.0,2:10,1,1,2,12122.0,2:27,5475000
8471276,David,Krejci,1986-04-28,C,R,2016-17,82,23,31,54,0.66,-12,158,14.56,26,89860.0,18:15,659,620,1279,51.52,40,51,60,51,9,8,6,14,12404.0,2:31,0,0,0,2394.0,0:29,7250000
8471284,Andrej,Sekera,1986-06-08,D,L,2016-17,80,8,27,35,0.44,14,128,6.25,18,103118.0,21:28,0,0,0,0.0,55,166,38,95,-57,1,10,11,10554.0,2:11,1,0,1,9681.0,2:1,5500000
8471296,Alexei,Emelin,1986-04-25,D,L,2016-17,76,2,8,10,0.13,1,82,2.44,71,97227.0,21:19,0,0,0,0.0,241,127,16,84,-68,0,0,0,283.0,0:3,0,0,0,11749.0,2:34,4100000
8471303,Alexander,Edler,1986-04-21,D,L,2016-17,68,6,15,21,0.31,-20,138,4.35,36,99200.0,24:18,2,1,3,66.67,106,138,17,37,-20,2,2,4,8376.0,2:3,0,0,0,10528.0,2:34,5000000
8471331,Kevin,Porter,1986-03-12,C,L,2016-17,2,0,0,0,0.0,-1,0,,0,1350.0,11:15,7,12,19,36.84,5,1,2,0,2,0,0,0,0.0,0:0,0,0,0,171.0,1:25,575000
8471338,Torrey,Mitchell,1985-01-30,C,R,2016-17,78,8,9,17,0.22,5,68,11.76,38,58992.0,12:36,410,342,752,54.52,47,56,43,39,4,0,0,0,379.0,0:4,0,0,0,8579.0,1:49,1200000
8471339,Ryan,Callahan,1985-03-21,RW,R,2016-17,18,2,2,4,0.22,-4,22,9.09,23,15274.0,14:8,5,4,9,55.56,48,13,7,10,-3,0,0,0,254.0,0:14,0,0,0,2139.0,1:58,5800000
8471346,Kris,Versteeg,1986-05-13,RW,R,2016-17,69,15,22,37,0.54,-3,136,11.03,46,60971.0,14:43,53,49,102,51.96,5,28,38,31,7,8,8,16,10540.0,2:32,0,0,0,94.0,0:1,950000
8471385,Adam,Pardy,1984-03-29,D,L,2016-17,4,0,0,0,0.0,-1,4,0.0,6,2638.0,10:59,0,0,0,0.0,3,3,1,0,1,0,0,0,0.0,0:0,0,0,0,20.0,0:5,575000
8471392,Roman,Polak,1986-04-28,D,R,2016-17,75,4,7,11,0.15,10,64,6.25,65,80643.0,17:55,0,1,1,0.0,232,133,16,49,-33,0,0,0,54.0,0:0,0,0,0,13061.0,2:54,2250000
8471426,Troy,Brouwer,1985-08-17,RW,R,2016-17,74,13,12,25,0.34,-11,86,15.12,31,72029.0,16:13,20,44,64,31.25,171,39,22,30,-8,5,6,11,10725.0,2:24,1,1,2,6894.0,1:33,4500000
8471436,Matt,Hunwick,1985-05-21,D,L,2016-17,72,1,18,19,0.26,8,73,1.37,18,77667.0,17:58,0,0,0,0.0,91,90,26,44,-18,0,0,0,241.0,0:3,0,0,0,11500.0,2:39,1200000
8471476,Daniel,Winnik,1985-03-06,LW,L,2016-17,72,12,13,25,0.35,15,82,14.63,49,55793.0,12:54,9,12,21,42.86,25,34,30,30,0,0,0,0,209.0,0:2,2,0,2,10901.0,2:31,2250000
8471490,Adam,Cracknell,1985-07-15,RW,R,2016-17,69,10,6,16,0.23,9,87,11.49,12,43305.0,10:27,135,160,295,45.76,91,37,19,16,3,0,0,0,426.0,0:6,1,0,1,2139.0,0:31,600000
8471498,Jannik,Hansen,1986-03-15,RW,R,2016-17,43,8,12,20,0.47,2,73,10.96,34,41414.0,16:3,0,1,1,0.0,43,15,21,14,7,0,0,0,510.0,0:11,0,0,0,3836.0,1:29,2500000
8471504,Rene,Bourque,1981-12-10,RW,L,2016-17,65,12,6,18,0.28,-19,111,10.81,56,54382.0,13:56,0,5,5,0.0,75,26,24,12,12,2,0,2,5927.0,1:31,0,0,0,666.0,0:10,650000
8471657,Cody,McLeod,1984-06-26,LW,L,2016-17,59,5,1,6,0.1,-3,30,16.67,145,25366.0,7:9,0,1,1,0.0,150,14,4,2,2,0,0,0,289.0,0:4,0,0,0,81.0,0:1,1333333
8471663,Mike,Blunden,1986-12-15,RW,R,2016-17,2,0,0,0,0.0,0,1,0.0,4,974.0,8:7,0,0,0,0.0,6,0,0,0,0,0,0,0,0.0,0:0,0,0,0,0.0,0:0,737500
8471664,Mason,Raymond,1985-09-17,LW,L,2016-17,4,0,0,0,0.0,-2,3,0.0,0,2138.0,8:54,0,1,1,0.0,3,0,0,1,-1,0,0,0,39.0,0:9,0,0,0,0.0,0:0,3150000
8471669,Paul,Stastny,1985-12-27,C,L,2016-17,66,18,22,40,0.61,4,112,16.07,36,75793.0,19:8,786,624,1410,55.74,51,35,24,9,15,5,8,13,10226.0,2:34,0,0,0,6451.0,1:37,7000000
8471675,Sidney,Crosby,1987-08-07,C,L,2016-17,75,44,45,89,1.19,17,255,17.25,24,89450.0,19:52,842,906,1748,48.17,80,27,39,70,-31,14,11,25,16185.0,3:35,0,0,0,531.0,0:7,8700000
8471676,Bobby,Ryan,1987-03-17,RW,R,2016-17,62,13,12,25,0.4,-3,111,11.71,24,57801.0,15:32,6,3,9,66.67,109,36,27,27,0,2,3,5,8943.0,2:24,0,0,0,66.0,0:1,7250000
8471677,Jack,Johnson,1987-01-13,D,L,2016-17,82,5,18,23,0.28,23,116,4.31,32,107366.0,21:49,1,0,1,100.0,94,134,20,27,-7,1,1,2,1202.0,0:14,0,1,1,11905.0,2:25,4357143
8471678,Benoit,Pouliot,1986-09-29,LW,L,2016-17,67,8,6,14,0.21,-5,77,10.39,34,56497.0,14:3,7,21,28,25.0,39,39,39,48,-9,0,0,0,3456.0,0:51,0,0,0,5443.0,1:21,4000000
8471681,Jack,Skille,1987-05-19,RW,R,2016-17,55,5,4,9,0.16,0,73,6.85,12,29037.0,8:47,2,0,2,100.0,74,24,14,9,5,0,0,0,218.0,0:3,0,0,0,2.0,0:0,700000
8471682,Devin,Setoguchi,1987-01-01,RW,R,2016-17,45,4,8,12,0.27,-5,60,6.67,14,33593.0,12:26,2,2,4,50.0,53,10,15,19,-4,0,1,1,1555.0,0:34,0,0,0,27.0,0:0,575000
8471685,Anze,Kopitar,1987-08-24,C,L,2016-17,76,12,40,52,0.68,-10,150,8.0,28,94694.0,20:45,892,801,1693,52.69,78,59,29,37,-8,5,14,19,13706.0,3:0,0,1,1,8681.0,1:54,10000000
8471686,Marc,Staal,1987-01-13,D,L,2016-17,72,3,7,10,0.14,9,70,4.29,34,82842.0,19:10,0,1,1,0.0,89,97,22,47,-25,0,0,0,206.0,0:2,0,1,1,8470.0,1:57,5700000
8471691,Martin,Hanzal,1987-02-20,C,L,2016-17,71,20,19,39,0.55,-17,169,11.83,53,75486.0,17:43,767,593,1360,56.4,145,58,31,30,1,5,4,9,10535.0,2:28,0,0,0,5800.0,1:21,3100000
8471693,Jakub,Kindl,1987-02-10,D,L,2016-17,39,0,4,4,0.1,-11,41,0.0,28,34376.0,14:41,0,0,0,0.0,49,37,9,13,-4,0,0,0,649.0,0:16,0,0,0,433.0,0:11,2400000
8471698,T.J.,Oshie,1986-12-23,RW,R,2016-17,68,33,23,56,0.82,28,143,23.08,36,72848.0,17:51,87,93,180,48.33,95,50,49,33,16,7,6,13,11835.0,2:54,1,2,3,4042.0,0:59,4175000
8471699,Andrew,Cogliano,1987-06-14,LW,L,2016-17,82,16,19,35,0.43,11,178,8.99,26,74479.0,15:8,8,10,18,44.44,76,27,19,26,-7,0,0,0,406.0,0:4,3,1,4,8735.0,1:46,3000000
8471702,Matt,Niskanen,1986-12-06,D,R,2016-17,78,5,34,39,0.5,20,154,3.25,32,103784.0,22:10,0,0,0,0.0,147,93,36,67,-31,1,8,9,8395.0,1:47,0,1,1,12119.0,2:35,5750000
8471707,James,Neal,1987-09-03,LW,L,2016-17,70,23,18,41,0.59,-10,202,11.39,35,74312.0,17:41,3,3,6,50.0,84,18,40,30,10,5,8,13,11523.0,2:44,0,0,0,262.0,0:3,5000000
8471709,Marc-Edouard,Vlasic,1987-03-30,D,L,2016-17,75,6,22,28,0.37,4,144,4.17,35,95555.0,21:14,0,0,0,0.0,18,146,23,62,-39,1,6,7,8663.0,1:55,0,1,1,9351.0,2:4,4250000
8471710,Taylor,Chorney,1987-04-27,D,L,2016-17,18,1,4,5,0.28,8,19,5.26,11,15405.0,14:15,0,0,0,0.0,27,29,3,7,-4,0,0,0,0.0,0:0,0,0,0,770.0,0:42,800000
8471716,Justin,Abdelkader,1987-02-25,LW,L,2016-17,64,7,14,21,0.33,-20,104,6.73,50,63969.0,16:39,5,12,17,29.41,144,27,15,18,-3,5,2,7,8902.0,2:19,0,1,1,4665.0,1:12,4250000
8471717,Adam,McQuaid,1986-10-12,D,R,2016-17,77,2,8,10,0.13,4,64,3.12,71,84300.0,18:14,0,0,0,0.0,157,144,10,24,-14,0,0,0,306.0,0:3,0,1,1,11016.0,2:23,2750000
8471724,Kris,Letang,1987-04-24,D,R,2016-17,41,5,29,34,0.83,2,122,4.1,32,62774.0,25:31,0,0,0,0.0,70,70,30,43,-13,2,12,14,9041.0,3:40,0,1,1,5270.0,2:8,7250000
8471729,Kris,Russell,1987-05-02,D,L,2016-17,68,1,12,13,0.19,5,68,1.47,23,86565.0,21:13,0,0,0,0.0,67,213,36,60,-24,0,1,1,1192.0,0:17,0,0,0,9435.0,2:18,3100000
8471735,Keith,Yandle,1986-09-09,D,L,2016-17,82,5,36,41,0.5,-6,178,2.81,39,108436.0,22:2,0,0,0,0.0,28,76,24,76,-52,2,16,18,15178.0,3:5,0,1,1,8354.0,1:41,6350000
8471742,Cody,Franson,1987-08-08,D,R,2016-17,68,3,16,19,0.28,-5,93,3.23,34,75408.0,18:28,0,0,0,0.0,87,68,14,30,-16,1,1,2,5955.0,1:27,0,0,0,3427.0,0:50,3325000
8471743,Vladimir,Sobotka,1987-07-02,LW,L,2016-17,1,1,0,1,1.0,0,2,50.0,0,1001.0,16:41,6,6,12,50.0,0,0,1,0,1,0,0,0,262.0,4:22,0,0,0,108.0,1:48,2725000
8471760,Cody,Bass,1987-01-07,C,R,2016-17,9,0,0,0,0.0,-1,1,0.0,19,3654.0,6:46,0,2,2,0.0,14,4,2,1,1,0,0,0,0.0,0:0,0,0,0,329.0,0:36,612500
8471761,Chris,Butler,1986-10-27,D,L,2016-17,1,0,0,0,0.0,0,1,0.0,0,1288.0,21:28,0,0,0,0.0,0,2,0,1,-1,0,0,0,17.0,0:17,0,0,0,95.0,1:35,600000
8471762,Chris,VandeVelde,1987-03-15,C,L,2016-17,81,6,9,15,0.19,-5,69,8.7,16,56187.0,11:33,22,20,42,52.38,114,60,14,12,2,0,0,0,271.0,0:3,0,0,0,12159.0,2:30,712500
8471766,Jared,Boll,1986-05-13,RW,R,2016-17,51,0,3,3,0.06,-3,13,0.0,87,17793.0,5:48,0,1,1,0.0,68,14,2,5,-3,0,0,0,138.0,0:2,0,0,0,0.0,0:0,1700000
8471768,Tom,Pyatt,1987-02-14,LW,L,2016-17,82,9,14,23,0.28,9,95,9.47,16,76887.0,15:37,21,28,49,42.86,46,89,35,20,15,0,0,0,677.0,0:8,0,2,2,10401.0,2:6,800000
8471769,Niklas,Hjalmarsson,1987-06-06,D,L,2016-17,73,5,13,18,0.25,12,61,8.2,20,94148.0,21:29,0,0,0,0.0,23,181,23,70,-47,0,0,0,435.0,0:5,0,1,1,12265.0,2:48,4100000
8471794,Darren,Helm,1987-01-21,LW,L,2016-17,50,8,9,17,0.34,-6,98,8.16,20,46108.0,15:22,216,204,420,51.43,71,18,17,20,-3,2,2,4,2504.0,0:50,0,1,1,4946.0,1:38,3850000
8471811,Cal,O'Reilly,1986-09-30,C,L,2016-17,11,0,1,1,0.09,-6,3,0.0,0,5235.0,7:55,32,34,66,48.48,2,3,3,2,1,0,0,0,587.0,0:53,0,0,0,0.0,0:0,700000
8471816,Mark,Fayne,1987-05-15,D,R,2016-17,4,0,2,2,0.5,1,4,0.0,0,1900.0,7:55,0,0,0,0.0,1,2,0,2,-2,0,0,0,0.0,0:0,0,0,0,0.0,0:0,3625000
8471817,Ryan,Reaves,1987-01-20,RW,R,2016-17,80,7,6,13,0.16,4,58,12.07,104,42648.0,8:53,0,5,5,0.0,239,26,11,4,7,0,0,0,109.0,0:1,0,0,0,8.0,0:0,1125000
8471873,Anton,Stralman,1986-08-01,D,R,2016-17,73,5,17,22,0.3,1,130,3.85,20,100304.0,22:54,0,0,0,0.0,106,96,26,27,-1,1,6,7,7391.0,1:41,0,0,0,11470.0,2:37,4500000
8471887,Patric,Hornqvist,1987-01-01,RW,R,2016-17,70,21,23,44,0.63,16,223,9.42,28,66995.0,15:57,3,8,11,27.27,227,62,30,11,19,10,7,17,12641.0,3:0,0,0,0,67.0,0:0,4250000
8471956,Andrew,Desjardins,1986-07-27,LW,L,2016-17,46,0,1,1,0.02,-6,46,0.0,22,25948.0,9:24,39,30,69,56.52,73,17,9,10,-1,0,0,0,9.0,0:0,0,0,0,1801.0,0:39,800000
8471958,Dan,Girardi,1984-04-29,D,R,2016-17,63,4,11,15,0.24,8,56,7.14,16,72208.0,19:6,0,0,0,0.0,107,166,10,46,-36,0,0,0,158.0,0:2,1,1,2,8505.0,2:15,5500000
8471976,David,Desharnais,1986-09-14,C,L,2016-17,49,6,8,14,0.29,4,46,13.04,12,36628.0,12:27,170,162,332,51.2,5,15,21,12,9,0,2,2,2929.0,0:59,0,0,0,60.0,0:1,3500000
8471996,Bracken,Kearns,1981-05-12,C,L,2016-17,2,0,0,0,0.0,-1,3,0.0,2,1343.0,11:11,10,7,17,58.82,5,2,0,0,0,0,0,0,0.0,0:0,0,0,0,0.0,0:0,800000
8472382,Andy,Greene,1982-10-30,D,L,2016-17,66,4,9,13,0.2,-16,83,4.82,8,86898.0,21:56,0,0,0,0.0,50,125,26,36,-10,1,3,4,4892.0,1:14,1,0,1,12711.0,3:12,5000000
8472410,Stephen,Gionta,1983-10-09,RW,R,2016-17,26,1,5,6,0.23,9,17,5.88,2,17483.0,11:12,56,64,120,46.67,56,7,5,6,-1,0,0,0,167.0,0:6,0,0,0,2031.0,1:18,575000
8473412,Bryan,Little,1987-11-12,C,R,2016-17,59,21,26,47,0.8,-7,119,17.65,18,62152.0,17:33,610,487,1097,55.61,35,23,31,19,12,6,6,12,7945.0,2:14,0,0,0,4055.0,1:8,4700000
8473415,Alex,Biega,1988-04-04,D,R,2016-17,36,0,3,3,0.08,-4,37,0.0,18,28444.0,13:10,0,0,0,0.0,97,24,5,7,-2,0,0,0,477.0,0:13,0,0,0,1387.0,0:38,750000
8473419,Brad,Marchand,1988-05-11,LW,L,2016-17,80,39,46,85,1.06,18,226,17.26,81,93295.0,19:26,13,23,36,36.11,51,35,69,84,-15,9,15,24,12944.0,2:41,3,2,5,9107.0,1:53,4500000
8473422,Nick,Foligno,1987-10-31,LW,L,2016-17,79,26,25,51,0.65,-4,185,14.05,55,87336.0,18:25,41,48,89,46.07,157,50,44,35,9,11,10,21,12733.0,2:41,0,0,0,2797.0,0:35,5500000
8473432,Derek,Dorsett,1986-12-20,RW,R,2016-17,14,1,3,4,0.29,-6,24,4.17,33,8343.0,9:55,1,0,1,100.0,35,6,2,1,1,0,0,0,12.0,0:0,0,0,0,301.0,0:21,2650000
8473446,Erik,Johnson,1988-03-21,D,R,2016-17,46,2,15,17,0.37,-6,96,2.08,9,60945.0,22:4,0,0,0,0.0,87,98,18,23,-5,0,6,6,5798.0,2:6,0,0,0,7812.0,2:49,6000000
8473449,Kyle,Okposo,1988-04-16,RW,R,2016-17,65,19,26,45,0.69,-7,156,12.18,24,73983.0,18:58,54,45,99,54.55,53,25,26,36,-10,7,16,23,12504.0,3:12,0,0,0,492.0,0:7,6000000
8473453,Trevor,Lewis,1987-01-08,C,R,2016-17,82,12,12,24,0.29,-6,145,8.28,30,70224.0,14:16,44,66,110,40.0,174,30,18,12,6,1,1,2,972.0,0:11,0,0,0,6044.0,1:13,2000000
8473463,Leo,Komarov,1987-01-23,C,L,2016-17,82,14,18,32,0.39,6,114,12.28,31,84002.0,17:4,91,111,202,45.05,232,50,46,25,21,4,6,10,10118.0,2:3,1,1,2,10583.0,2:9,2950000
8473465,Jamie,McGinn,1988-08-05,LW,L,2016-17,72,9,8,17,0.24,-23,116,7.76,23,56906.0,13:10,1,2,3,33.33,116,18,5,27,-22,0,2,2,4228.0,0:58,0,0,0,15.0,0:0,3333333
8473466,Ryan,White,1988-03-17,C,R,2016-17,65,9,7,16,0.25,-16,60,15.0,84,41566.0,10:39,39,52,91,42.86,187,33,11,10,1,0,0,0,250.0,0:3,0,0,0,1101.0,0:16,1000000
8473468,Eric,Gryba,1988-04-14,D,R,2016-17,40,2,4,6,0.15,-5,45,4.44,65,38735.0,16:8,0,0,0,0.0,145,47,6,21,-15,0,0,0,48.0,0:1,0,0,0,3146.0,1:18,950000
8473473,Milan,Lucic,1988-06-07,LW,L,2016-17,82,23,27,50,0.61,-3,175,13.14,50,84435.0,17:9,4,3,7,57.14,202,20,26,49,-23,12,13,25,13437.0,2:43,0,0,0,40.0,0:0,6000000
8473485,Chris,Stewart,1987-10-30,RW,R,2016-17,79,13,8,21,0.27,3,82,15.85,94,49244.0,10:23,2,9,11,18.18,85,19,15,15,0,0,2,2,785.0,0:9,0,0,0,13.0,0:0,1150000
8473492,Matt,Beleskey,1988-06-07,LW,L,2016-17,49,3,5,8,0.16,-10,79,3.8,47,39001.0,13:15,29,41,70,41.43,98,18,7,12,-5,0,2,2,4252.0,1:26,0,0,0,1499.0,0:30,3800000
8473504,Cal,Clutterbuck,1987-11-18,RW,R,2016-17,66,5,15,20,0.3,2,115,4.35,28,55429.0,13:59,3,5,8,37.5,222,25,30,16,14,0,1,1,1707.0,0:25,0,0,0,8236.0,2:4,2750000
8473507,Jeff,Petry,1987-12-09,D,R,2016-17,80,8,20,28,0.35,3,172,4.65,22,106152.0,22:6,0,0,0,0.0,171,145,19,102,-83,2,5,7,8476.0,1:45,0,0,0,8664.0,1:48,5500000
8473512,Claude,Giroux,1988-01-12,C,R,2016-17,82,14,44,58,0.71,-15,199,7.04,38,94082.0,19:7,977,771,1748,55.89,68,28,38,35,3,5,26,31,18425.0,3:44,0,1,1,1253.0,0:15,8275000
8473533,Jordan,Staal,1988-09-10,C,L,2016-17,75,16,29,45,0.6,-1,164,9.76,38,83977.0,18:39,689,477,1166,59.09,139,29,55,42,13,4,4,8,10138.0,2:15,1,0,1,7066.0,1:34,6000000
8473534,Patrik,Berglund,1988-06-02,C,L,2016-17,82,23,11,34,0.41,-7,153,15.03,32,78668.0,15:59,584,585,1169,49.96,155,42,43,23,20,4,4,8,6983.0,1:25,0,0,0,6145.0,1:14,3700000
8473537,Viktor,Stalberg,1986-01-17,LW,L,2016-17,75,11,5,16,0.21,-9,101,10.89,41,54903.0,12:12,0,3,3,0.0,141,28,37,27,10,1,1,2,1634.0,0:21,2,0,2,6075.0,1:21,3000000
8473542,Tom,Sestito,1987-09-28,LW,L,2016-17,13,0,2,2,0.15,0,3,0.0,48,4315.0,5:31,0,0,0,0.0,19,2,0,2,-2,0,0,0,25.0,0:1,0,0,0,0.0,0:0,575000
8473544,Derick,Brassard,1987-09-22,C,L,2016-17,81,14,25,39,0.48,12,195,7.18,24,84461.0,17:22,612,613,1225,49.96,92,24,37,37,0,3,4,7,12392.0,2:32,0,0,0,336.0,0:4,5000000
8473546,Michael,Grabner,1987-10-05,RW,L,2016-17,76,27,13,40,0.53,22,162,16.67,10,64272.0,14:5,7,6,13,53.85,41,34,48,22,26,0,0,0,363.0,0:4,1,2,3,7704.0,1:41,1650000
8473548,Phil,Kessel,1987-10-02,RW,R,2016-17,82,23,47,70,0.85,3,229,10.04,20,88259.0,17:56,5,10,15,33.33,12,15,15,51,-36,8,22,30,17461.0,3:32,0,0,0,67.0,0:0,8000000
8473560,Korbinian,Holzer,1988-02-16,D,R,2016-17,32,2,5,7,0.22,0,14,14.29,23,25945.0,13:30,0,0,0,0.0,71,34,3,11,-8,0,0,0,64.0,0:2,0,0,0,1651.0,0:51,700000
8473563,Nicklas,Backstrom,1987-11-23,C,L,2016-17,82,23,63,86,1.05,17,162,14.2,38,89839.0,18:15,685,648,1333,51.39,45,33,61,54,7,8,27,35,15061.0,3:3,0,0,0,3416.0,0:41,6700000
8473564,Michael,Frolik,1988-02-17,RW,L,2016-17,82,17,27,44,0.54,13,202,8.42,58,84044.0,17:4,13,16,29,44.83,60,48,45,38,7,3,5,8,5856.0,1:11,2,1,3,10011.0,2:2,4300000
8473565,Brian,Strait,1988-01-04,D,L,2016-17,5,0,2,2,0.4,-1,3,0.0,0,4779.0,15:55,0,0,0,0.0,5,8,0,0,0,0,0,0,57.0,0:11,0,0,0,92.0,0:18,600000
8473571,Jamie,McBain,1988-02-25,D,R,2016-17,3,0,0,0,0.0,-1,3,0.0,0,3000.0,16:40,0,0,0,0.0,0,4,1,1,0,0,0,0,342.0,1:54,0,0,0,0.0,0:0,650000
8473573,Artem,Anisimov,1988-05-24,C,L,2016-17,64,22,23,45,0.7,9,105,20.95,30,68529.0,17:50,416,506,922,45.12,18,27,35,16,19,4,4,8,9100.0,2:22,0,0,0,3185.0,0:49,4550000
8473574,Shawn,Matthias,1988-02-19,LW,L,2016-17,45,8,4,12,0.27,0,51,15.69,13,36612.0,13:33,5,11,16,31.25,47,19,10,8,2,0,0,0,174.0,0:3,1,0,1,4046.0,1:29,2125000
8473579,Nikolay,Kulemin,1986-07-14,LW,L,2016-17,72,12,11,23,0.32,3,74,16.22,18,59691.0,13:49,14,13,27,51.85,78,45,30,17,13,1,1,2,668.0,0:9,1,1,2,8037.0,1:51,4187500
8473584,Andrew,MacDonald,1986-09-07,D,L,2016-17,73,2,16,18,0.25,-5,65,3.08,26,88074.0,20:6,0,0,0,0.0,39,151,8,50,-42,0,0,0,486.0,0:6,0,1,1,12480.0,2:50,5000000
8473588,Erik,Condra,1986-08-06,RW,R,2016-17,13,0,0,0,0.0,-4,8,0.0,4,7519.0,9:38,1,0,1,100.0,5,7,3,2,1,0,0,0,62.0,0:4,0,0,0,138.0,0:10,1250000
8473604,Jonathan,Toews,1988-04-29,C,L,2016-17,72,21,37,58,0.81,7,199,10.55,35,87066.0,20:9,852,700,1552,54.9,43,32,37,37,0,6,11,17,11596.0,2:41,0,0,0,5630.0,1:18,10500000
8473618,Mathieu,Perreault,1988-01-05,C,L,2016-17,65,13,32,45,0.69,-11,134,9.7,30,63525.0,16:17,97,92,189,51.32,97,26,33,20,13,3,12,15,10299.0,2:38,0,0,0,110.0,0:1,3000000
8473673,David,Schlemko,1987-05-07,D,L,2016-17,62,2,16,18,0.29,4,118,1.69,14,62297.0,16:44,0,0,0,0.0,35,112,28,42,-14,1,2,3,5658.0,1:31,0,0,0,1656.0,0:26,2100000
8473914,Mark,Letestu,1985-02-04,C,R,2016-17,78,16,19,35,0.45,-2,120,13.33,17,66630.0,14:14,452,444,896,50.45,71,34,24,24,0,11,3,14,10633.0,2:16,2,1,3,9984.0,2:8,1800000
8473933,Ben,Lovejoy,1984-02-20,D,R,2016-17,82,1,6,7,0.09,-7,84,1.19,39,102209.0,20:46,0,0,0,0.0,82,150,18,40,-22,0,0,0,541.0,0:6,0,0,0,16017.0,3:15,2666667
8473942,Trevor,Smith,1985-02-08,C,L,2016-17,1,0,0,0,0.0,0,0,,0,440.0,7:20,0,8,8,0.0,0,2,0,0,0,0,0,0,0.0,0:0,0,0,0,0.0,0:0,612500
8473962,Teddy,Purcell,1985-09-08,LW,R,2016-17,12,0,2,2,0.17,0,10,0.0,0,9282.0,12:53,3,0,3,100.0,7,2,2,3,-1,0,0,0,614.0,0:51,0,0,0,19.0,0:1,1600000
8473986,Alex,Killorn,1989-09-14,LW,L,2016-17,81,19,17,36,0.44,-9,176,10.8,66,87494.0,18:0,4,8,12,33.33,99,25,33,43,-10,4,6,10,11744.0,2:24,1,1,2,7046.0,1:26,4450000
8473989,Luke,Gazdic,1989-07-25,LW,L,2016-17,11,0,0,0,0.0,-2,3,0.0,12,4707.0,7:7,0,0,0,0.0,16,6,1,0,1,0,0,0,31.0,0:2,0,0,0,0.0,0:0,700000
8473991,Karl,Alzner,1988-09-24,D,L,2016-17,82,3,10,13,0.16,23,81,3.7,28,97371.0,19:47,0,0,0,0.0,105,162,17,52,-35,0,0,0,204.0,0:2,0,0,0,15054.0,3:3,2800000
8473992,Justin,Falk,1988-10-11,D,L,2016-17,52,0,8,8,0.15,-3,33,0.0,29,42738.0,13:41,0,0,0,0.0,101,40,7,22,-15,0,0,0,49.0,0:0,0,0,0,2337.0,0:44,650000
8473994,Jamie,Benn,1989-07-18,LW,L,2016-17,77,26,43,69,0.9,-9,201,12.94,66,89507.0,19:22,212,200,412,51.46,89,47,55,55,0,12,14,26,14360.0,3:6,1,0,1,6732.0,1:27,5250000
8474000,Steven,Kampfer,1988-09-24,D,R,2016-17,11,1,1,2,0.18,-2,10,10.0,6,8750.0,13:15,0,0,0,0.0,24,10,2,3,-1,0,0,0,33.0,0:3,0,0,0,78.0,0:7,612500
8474008,Paul,Carey,1988-09-24,C,L,2016-17,6,0,0,0,0.0,-2,8,0.0,0,3773.0,10:28,0,0,0,0.0,5,1,5,4,1,0,0,0,5.0,0:0,0,0,0,201.0,0:33,575000
8474009,Nick,Bonino,1988-04-20,C,L,2016-17,80,18,19,37,0.46,-5,142,12.68,16,79931.0,16:39,582,631,1213,47.98,60,99,41,24,17,6,5,11,8314.0,1:43,1,0,1,10995.0,2:17,1900000
8474013,Ian,Cole,1989-02-21,D,L,2016-17,81,5,21,26,0.32,26,89,5.62,72,96325.0,19:49,0,0,0,0.0,164,194,32,50,-18,0,1,1,479.0,0:5,0,0,0,11703.0,2:24,2100000
8474018,Christopher,DiDomenico,1989-02-20,LW,R,2016-17,3,0,0,0,0.0,0,5,0.0,6,1983.0,11:1,2,1,3,66.67,2,2,0,0,0,0,0,0,153.0,0:51,0,0,0,0.0,0:0,-111
8474027,Justin,Braun,1987-02-10,D,R,2016-17,81,4,9,13,0.16,1,95,4.21,28,97589.0,20:4,0,0,0,0.0,136,161,40,59,-19,0,0,0,630.0,0:7,0,2,2,10365.0,2:7,3800000
8474031,Kevin,Shattenkirk,1989-01-29,D,R,2016-17,80,13,43,56,0.7,-7,161,8.07,47,95715.0,19:56,0,0,0,0.0,88,95,36,40,-4,8,19,27,15383.0,3:12,0,0,0,1476.0,0:18,4250000
8474034,Patrick,Maroon,1988-04-23,LW,L,2016-17,81,27,15,42,0.52,13,178,15.17,95,81345.0,16:44,6,9,15,40.0,189,23,33,49,-16,3,3,6,9364.0,1:55,0,0,0,59.0,0:0,2000000
8474037,James,van Riemsdyk,1989-05-04,LW,L,2016-17,82,29,33,62,0.76,-2,238,12.18,37,78179.0,15:53,1,4,5,20.0,62,29,37,23,14,6,13,19,11815.0,2:24,0,0,0,254.0,0:3,4250000
8474038,Paul,Byron,1989-04-27,LW,L,2016-17,81,22,21,43,0.53,21,96,22.92,29,73228.0,15:4,10,5,15,66.67,119,34,40,22,18,0,4,4,2654.0,0:32,1,0,1,9632.0,1:58,1166667
8474040,Sam,Gagner,1989-08-10,C,R,2016-17,81,18,32,50,0.62,10,178,10.11,22,66654.0,13:42,202,223,425,47.53,22,16,17,27,-10,8,10,18,11793.0,2:25,0,0,0,52.0,0:0,650000
8474052,Chris,Terry,1989-04-07,LW,L,2016-17,14,2,2,4,0.29,-1,15,13.33,4,8306.0,9:53,1,1,2,50.0,10,1,5,8,-3,0,0,0,180.0,0:12,0,0,0,196.0,0:14,600000
8474053,Logan,Couture,1989-03-28,C,L,2016-17,73,25,27,52,0.71,11,174,14.37,12,77114.0,17:36,297,456,753,39.44,57,65,39,76,-37,11,4,15,13218.0,3:1,0,1,1,4809.0,1:5,6000000
8474056,P.K.,Subban,1989-05-13,D,R,2016-17,66,10,30,40,0.61,-8,142,7.04,44,96640.0,24:24,0,0,0,0.0,78,104,30,58,-28,3,13,16,10320.0,2:36,0,1,1,8277.0,2:5,9000000
8474062,Riley,Nash,1989-05-09,C,R,2016-17,81,7,10,17,0.21,-1,125,5.6,14,67094.0,13:48,276,286,562,49.11,67,36,48,18,30,0,0,0,266.0,0:3,1,2,3,9454.0,1:56,900000
8474066,Thomas,Hickey,1989-02-08,D,L,2016-17,76,4,16,20,0.26,-1,87,4.6,35,79885.0,17:31,0,0,0,0.0,89,103,16,43,-27,0,3,3,3065.0,0:40,0,0,0,8494.0,1:51,2200000
8474068,Kyle,Turris,1989-08-14,C,R,2016-17,78,27,28,55,0.71,-3,185,14.59,47,91261.0,19:30,650,575,1225,53.06,21,61,25,57,-32,6,11,17,13658.0,2:55,0,0,0,3366.0,0:43,3500000
8474074,Paul,Postma,1989-02-22,D,R,2016-17,65,1,13,14,0.22,3,50,2.0,15,42332.0,10:51,0,0,0,0.0,36,42,10,29,-19,0,0,0,118.0,0:1,0,0,0,128.0,0:1,887500
8474090,Brendan,Smith,1989-02-08,D,L,2016-17,51,3,6,9,0.18,1,62,4.84,63,58880.0,19:14,0,0,0,0.0,59,65,11,37,-26,1,2,3,2719.0,0:53,0,0,0,5732.0,1:52,2750000
8474091,Brandon,Sutter,1989-02-14,C,R,2016-17,81,17,17,34,0.42,-20,160,10.62,12,91382.0,18:48,788,664,1452,54.27,78,53,32,21,11,4,4,8,12552.0,2:34,0,0,0,9179.0,1:53,4375000
8474098,Colton,Sceviour,1989-04-20,C,R,2016-17,80,9,15,24,0.3,-16,172,5.23,25,70241.0,14:38,31,27,58,53.45,108,64,40,23,17,1,2,3,3998.0,0:49,3,1,4,9654.0,2:0,950000
8474100,Dwight,King,1989-07-05,LW,L,2016-17,80,9,7,16,0.2,-2,110,8.18,12,69152.0,14:24,4,12,16,25.0,120,28,15,18,-3,0,0,0,1114.0,0:13,0,0,0,6576.0,1:22,1950000
8474102,David,Perron,1988-05-28,LW,R,2016-17,82,18,28,46,0.56,-2,151,11.92,54,85106.0,17:17,32,34,66,48.48,87,28,48,21,27,3,10,13,10420.0,2:7,1,0,1,5623.0,1:8,3750000
8474125,Carl,Gunnarsson,1986-11-09,D,L,2016-17,56,0,6,6,0.11,-5,32,0.0,4,45681.0,13:35,0,0,0,0.0,42,68,2,8,-6,0,0,0,20.0,0:0,0,0,0,2723.0,0:48,2900000
8474130,Corey,Tropp,1989-07-25,RW,R,2016-17,1,0,0,0,0.0,-1,0,,0,568.0,9:28,0,0,0,0.0,2,0,0,0,0,0,0,0,0.0,0:0,0,0,0,0.0,0:0,625000
8474134,Yannick,Weber,1988-09-23,D,R,2016-17,73,1,7,8,0.11,1,72,1.39,25,52209.0,11:55,0,0,0,0.0,72,53,9,27,-18,0,0,0,718.0,0:9,0,0,0,805.0,0:11,575000
8474141,Patrick,Kane,1988-11-19,RW,L,2016-17,82,34,55,89,1.09,11,292,11.64,32,105263.0,21:23,7,44,51,13.73,28,15,49,42,7,7,16,23,16742.0,3:24,0,0,0,374.0,0:4,10500000
8474145,Robert,Bortuzzo,1989-03-18,D,R,2016-17,38,1,3,4,0.11,11,45,2.22,15,32118.0,14:5,0,0,0,0.0,77,50,4,13,-9,0,0,0,83.0,0:2,0,0,0,1995.0,0:52,1050000
8474150,Mikael,Backlund,1989-03-17,C,L,2016-17,81,22,31,53,0.65,9,197,11.17,36,85565.0,17:36,711,768,1479,48.07,55,41,57,49,8,7,9,16,9941.0,2:2,0,3,3,10924.0,2:14,3575000
8474151,Ryan,McDonagh,1989-06-13,D,L,2016-17,77,6,36,42,0.55,20,153,3.92,37,112530.0,24:21,0,0,0,0.0,80,160,45,60,-15,1,14,15,14297.0,3:5,1,0,1,10924.0,2:21,4700000
8474157,Max,Pacioretty,1988-11-20,LW,L,2016-17,81,35,32,67,0.83,15,268,13.06,38,93198.0,19:10,27,23,50,54.0,63,35,44,47,-3,8,5,13,13214.0,2:43,1,1,2,4700.0,0:58,4500000
8474161,Jakub,Voracek,1989-08-15,RW,L,2016-17,82,20,41,61,0.74,-24,253,7.91,56,93911.0,19:5,3,11,14,21.43,30,22,24,56,-32,5,18,23,17699.0,3:35,0,0,0,94.0,0:1,8250000
8474162,Jake,Muzzin,1989-02-21,D,L,2016-17,82,9,19,28,0.34,-21,184,4.89,46,109688.0,22:17,0,0,0,0.0,162,122,15,70,-55,4,6,10,11965.0,2:25,0,0,0,10599.0,2:9,4000000
8474166,Alec,Martinez,1987-07-26,D,L,2016-17,82,9,30,39,0.48,-17,144,6.25,24,106475.0,21:38,0,1,1,0.0,137,167,5,51,-46,2,13,15,10661.0,2:10,1,0,1,10973.0,2:13,4000000
8474176,Carl,Hagelin,1988-08-23,LW,L,2016-17,61,6,16,22,0.36,10,128,4.69,16,56693.0,15:29,3,3,6,50.0,66,24,19,21,-2,0,0,0,366.0,0:6,0,1,1,8278.0,2:15,4000000
8474189,Lars,Eller,1989-05-08,C,L,2016-17,81,12,13,25,0.31,15,115,10.43,36,67558.0,13:54,416,467,883,47.11,71,30,31,32,-1,0,1,1,874.0,0:10,1,0,1,10530.0,2:10,3500000
8474190,Wayne,Simmonds,1988-08-26,RW,R,2016-17,82,31,23,54,0.66,-18,224,13.84,122,93343.0,18:58,8,9,17,47.06,162,60,38,39,-1,16,9,25,18272.0,3:42,2,0,2,7447.0,1:30,3975000
8474207,Nick,Holden,1987-05-15,D,L,2016-17,80,11,23,34,0.42,13,84,13.1,35,98941.0,20:36,0,1,1,0.0,164,88,23,61,-38,3,1,4,2927.0,0:36,0,1,1,8172.0,1:42,1650000
8474218,Jason,Demers,1988-06-09,D,R,2016-17,81,9,19,28,0.35,-14,98,9.18,53,95309.0,19:36,0,1,1,0.0,106,90,19,31,-12,0,5,5,7868.0,1:37,0,2,2,8536.0,1:45,4500000
8474230,Micheal,Haley,1986-03-30,C,L,2016-17,58,2,10,12,0.21,6,37,5.41,128,31939.0,9:10,66,83,149,44.3,129,23,18,19,-1,0,0,0,103.0,0:1,0,0,0,66.0,0:1,625000
8474250,Zack,Smith,1988-04-05,LW,L,2016-17,74,16,16,32,0.43,6,137,11.68,61,72721.0,16:22,317,292,609,52.05,140,38,31,35,-4,1,0,1,6166.0,1:23,4,0,4,8713.0,1:57,1887500
8474291,Jay,Beagle,1985-10-16,C,R,2016-17,81,13,17,30,0.37,20,100,13.0,22,66251.0,13:37,624,483,1107,56.37,55,44,11,26,-15,0,0,0,448.0,0:5,1,2,3,13431.0,2:45,1750000
8474520,Jason,Garrison,1984-11-13,D,L,2016-17,70,1,8,9,0.13,-8,96,1.04,14,77969.0,18:33,0,0,0,0.0,93,91,8,33,-25,0,0,0,696.0,0:9,0,0,0,9162.0,2:10,4600000
8474563,Drew,Doughty,1989-12-08,D,R,2016-17,82,12,32,44,0.54,8,181,6.63,46,133550.0,27:8,1,0,1,100.0,129,109,24,86,-62,5,14,19,16179.0,3:17,0,1,1,12643.0,2:34,7000000
8474564,Steven,Stamkos,1990-02-07,C,R,2016-17,17,9,11,20,1.18,3,58,15.52,14,18234.0,17:52,106,92,198,53.54,21,3,15,6,9,3,4,7,3473.0,3:24,0,0,0,784.0,0:46,8500000
8474565,Alex,Pietrangelo,1990-01-18,D,R,2016-17,80,14,34,48,0.6,3,181,7.73,24,121353.0,25:16,0,1,1,0.0,38,158,53,27,26,6,13,19,11767.0,2:27,0,0,0,14521.0,3:1,6500000
8474567,Zach,Bogosian,1990-07-15,D,R,2016-17,56,2,9,11,0.2,-17,73,2.74,46,67493.0,20:5,0,0,0,0.0,59,97,11,31,-20,0,1,1,403.0,0:7,0,0,0,5854.0,1:44,5142857
8474568,Luke,Schenn,1989-11-02,D,R,2016-17,78,1,7,8,0.1,-9,94,1.06,85,84469.0,18:2,0,0,0,0.0,286,134,11,31,-20,0,0,0,63.0,0:0,0,0,0,10478.0,2:14,1250000
8474569,Colin,Wilson,1989-10-20,C,L,2016-17,70,12,23,35,0.5,7,113,10.62,18,62821.0,14:57,16,23,39,41.03,50,23,23,25,-2,6,1,7,8146.0,1:56,0,0,0,75.0,0:1,3937500
8474571,Mikkel,Boedker,1989-12-16,LW,L,2016-17,81,10,16,26,0.32,0,122,8.2,10,69738.0,14:20,5,13,18,27.78,71,35,31,37,-6,0,1,1,7476.0,1:32,1,0,1,4088.0,0:50,4000000
8474573,Josh,Bailey,1989-10-02,RW,L,2016-17,82,13,43,56,0.68,5,173,7.51,12,90388.0,18:22,8,7,15,53.33,37,53,54,61,-7,3,9,12,13955.0,2:50,0,0,0,2159.0,0:26,3300000
8474574,Tyler,Myers,1990-02-01,D,R,2016-17,11,2,3,5,0.45,5,16,12.5,13,14657.0,22:12,0,0,0,0.0,12,21,6,10,-4,0,0,0,1119.0,1:41,0,1,1,1947.0,2:57,5500000
8474577,Joe,Colborne,1990-01-30,C,L,2016-17,62,4,4,8,0.13,-21,48,8.33,34,39800.0,10:41,45,72,117,38.46,86,14,10,18,-8,2,1,3,2966.0,0:47,0,0,0,1757.0,0:28,2500000
8474578,Erik,Karlsson,1990-05-31,D,R,2016-17,77,17,54,71,0.92,10,218,7.8,28,123989.0,26:50,0,0,0,0.0,67,201,59,106,-47,4,23,27,17019.0,3:41,0,2,2,9937.0,2:9,6500000
8474579,Luca,Sbisa,1990-01-30,D,L,2016-17,82,2,11,13,0.16,-1,75,2.67,40,93364.0,18:58,0,0,0,0.0,130,122,19,50,-31,0,0,0,265.0,0:3,0,0,0,10863.0,2:12,3600000
8474581,Jake,Gardiner,1990-07-04,D,L,2016-17,82,9,34,43,0.52,24,127,7.09,34,105945.0,21:32,0,0,0,0.0,69,83,44,79,-35,2,11,13,12498.0,2:32,0,0,0,1556.0,0:18,4050000
8474584,Michael,Del Zotto,1990-06-24,D,L,2016-17,51,6,12,18,0.35,-5,92,6.52,28,59682.0,19:30,0,1,1,0.0,173,85,9,30,-21,0,1,1,2926.0,0:57,0,1,1,3916.0,1:16,3875000
8474586,Jordan,Eberle,1990-05-15,C,R,2016-17,82,20,31,51,0.62,3,208,9.62,16,82497.0,16:46,10,10,20,50.0,26,37,38,44,-6,4,10,14,11025.0,2:14,0,0,0,71.0,0:0,6000000
8474589,Tyler,Ennis,1989-10-06,LW,L,2016-17,51,5,8,13,0.25,-10,89,5.62,12,39278.0,12:50,3,13,16,18.75,45,23,19,17,2,0,3,3,4145.0,1:21,0,0,0,0.0,0:0,4600000
8474590,John,Carlson,1990-01-10,D,R,2016-17,72,9,28,37,0.51,7,180,5.0,10,98106.0,22:42,0,0,0,0.0,58,127,51,88,-37,3,13,16,11425.0,2:38,0,1,1,12863.0,2:58,3966667
8474597,Cody,Goloubef,1989-11-30,D,R,2016-17,33,0,5,5,0.15,-11,35,0.0,25,33639.0,16:59,0,0,0,0.0,30,33,5,7,-2,0,0,0,44.0,0:1,0,0,0,3495.0,1:45,750000
8474600,Roman,Josi,1990-06-01,D,L,2016-17,72,12,37,49,0.68,7,217,5.53,18,108323.0,25:4,0,0,0,0.0,54,119,16,41,-25,7,11,18,13065.0,3:1,0,1,1,9922.0,2:17,4000000
8474602,Justin,Schultz,1990-07-06,D,R,2016-17,78,12,39,51,0.65,27,154,7.79,34,95699.0,20:26,0,0,0,0.0,67,116,22,37,-15,3,17,20,12946.0,2:45,0,0,0,322.0,0:4,1400000
8474604,Aaron,Ness,1990-05-18,D,L,2016-17,2,0,0,0,0.0,-1,0,,0,1540.0,12:50,0,0,0,0.0,2,2,0,1,-1,0,0,0,0.0,0:0,0,0,0,0.0,0:0,612500
8474605,Patrick,Wiercioch,1990-09-12,D,L,2016-17,57,4,8,12,0.21,-18,63,6.35,23,56999.0,16:39,0,0,0,0.0,52,57,6,15,-9,0,0,0,3164.0,0:55,0,0,0,4840.0,1:24,800000
8474610,Zac,Dalpe,1989-11-01,C,R,2016-17,9,1,2,3,0.33,0,8,12.5,9,4620.0,8:33,27,32,59,45.76,5,5,3,0,3,0,0,0,6.0,0:0,0,0,0,0.0,0:0,600000
8474611,Cameron,Gaunce,1990-03-19,D,L,2016-17,12,1,3,4,0.33,1,8,12.5,13,9013.0,12:31,0,0,0,0.0,23,10,2,5,-3,0,0,0,0.0,0:0,0,0,0,743.0,1:1,575000
8474612,Travis,Hamonic,1990-08-16,D,R,2016-17,49,3,11,14,0.29,-21,74,4.05,60,60139.0,20:27,0,0,0,0.0,58,108,14,39,-25,0,1,1,1642.0,0:33,0,0,0,6791.0,2:18,3857143
8474613,Derek,Stepan,1990-06-18,C,R,2016-17,81,17,38,55,0.68,19,209,8.13,16,90437.0,18:36,716,806,1522,47.04,26,45,51,56,-5,4,14,18,12342.0,2:32,1,0,1,6682.0,1:22,6500000
8474618,Marco,Scandella,1990-02-23,D,L,2016-17,71,4,9,13,0.18,-2,88,4.55,25,78122.0,18:20,0,0,0,0.0,50,85,28,36,-8,0,0,0,1182.0,0:16,0,0,0,7137.0,1:40,4000000
8474625,Jimmy,Hayes,1989-11-21,RW,R,2016-17,58,2,3,5,0.09,-3,74,2.7,29,32121.0,9:13,14,41,55,25.45,74,10,14,12,2,0,0,0,1097.0,0:18,0,0,0,13.0,0:0,2300000
8474627,Jori,Lehtera,1987-12-23,C,L,2016-17,64,7,15,22,0.34,-6,67,10.45,34,58273.0,15:10,409,423,832,49.16,64,29,21,14,7,0,3,3,5243.0,1:21,0,0,0,1653.0,0:25,4700000
8474628,Michael,Stone,1990-06-07,D,R,2016-17,64,3,12,15,0.23,0,81,3.7,32,76099.0,19:49,1,0,1,100.0,125,143,5,26,-21,1,4,5,4980.0,1:17,0,0,0,6977.0,1:49,4000000
8474641,Adam,Henrique,1990-02-06,C,L,2016-17,82,20,20,40,0.49,-20,142,14.08,38,89407.0,18:10,585,629,1214,48.19,88,68,45,28,17,6,4,10,12100.0,2:27,2,1,3,11147.0,2:15,4000000
8474642,Lance,Bouma,1990-03-25,LW,L,2016-17,61,3,4,7,0.11,-2,53,5.66,35,41528.0,11:20,4,8,12,33.33,127,44,17,9,8,0,0,0,172.0,0:2,0,0,0,5840.0,1:35,2200000
8474660,David,Warsofsky,1990-05-30,D,L,2016-17,7,0,1,1,0.14,-3,14,0.0,6,6608.0,15:44,0,0,0,0.0,3,12,2,3,-1,0,0,0,384.0,0:54,0,0,0,343.0,0:49,575000
8474668,Dale,Weise,1988-08-05,RW,R,2016-17,64,8,7,15,0.23,1,94,8.51,39,49466.0,12:52,3,0,3,100.0,135,24,13,14,-1,1,1,2,3734.0,0:58,0,0,0,31.0,0:0,2350000
8474673,TJ,Brodie,1990-06-07,D,L,2016-17,82,6,30,36,0.44,-16,78,7.69,24,116019.0,23:34,0,0,0,0.0,30,115,57,76,-19,1,11,12,13623.0,2:46,1,1,2,11481.0,2:20,4650400
8474679,Gustav,Nyquist,1989-09-01,RW,L,2016-17,76,12,36,48,0.63,0,165,7.27,18,79502.0,17:26,4,1,5,80.0,54,20,32,35,-3,2,7,9,12847.0,2:49,0,0,0,134.0,0:1,4750000
8474683,Derek,Grant,1990-04-20,C,L,2016-17,46,0,4,4,0.09,-5,40,0.0,24,26938.0,9:45,201,183,384,52.34,27,29,10,9,1,0,0,0,1185.0,0:25,0,0,0,6042.0,2:11,650000
8474685,Matt,Calvert,1989-12-24,LW,L,2016-17,65,10,5,15,0.23,-4,92,10.87,48,52054.0,13:20,2,14,16,12.5,61,34,23,15,8,0,0,0,537.0,0:8,3,1,4,6614.0,1:41,2200000
8474688,Greg,Pateryn,1990-06-20,D,R,2016-17,36,1,8,9,0.25,-1,42,2.38,10,33312.0,15:25,0,0,0,0.0,69,66,4,22,-18,0,0,0,68.0,0:1,0,0,0,1482.0,0:41,800000
8474697,Mark,Borowiecki,1989-07-12,D,L,2016-17,70,1,2,3,0.04,-3,50,2.0,154,58845.0,14:0,1,0,1,100.0,364,90,6,18,-12,0,0,0,71.0,0:1,0,0,0,2997.0,0:42,1100000
8474707,Philip,Larsen,1989-12-07,D,R,2016-17,26,1,5,6,0.23,-8,32,3.12,4,25675.0,16:27,0,0,0,0.0,12,22,4,14,-10,0,2,2,3517.0,2:15,0,0,0,49.0,0:1,1025000
8474709,Matt,Martin,1989-05-08,LW,L,2016-17,82,5,4,9,0.11,0,66,7.58,123,43776.0,8:53,0,11,11,0.0,300,26,16,13,3,0,0,0,105.0,0:1,0,0,0,1612.0,0:19,2500000
8474715,Cam,Atkinson,1989-06-05,RW,R,2016-17,82,35,27,62,0.76,13,240,14.58,22,88972.0,18:5,2,1,3,66.67,33,34,36,21,15,10,11,21,12473.0,2:32,3,0,3,7663.0,1:33,3500000
8474716,Jared,Spurgeon,1989-11-29,D,R,2016-17,76,10,28,38,0.5,33,144,6.94,20,109591.0,24:1,0,0,0,0.0,49,140,23,22,1,1,4,5,10217.0,2:14,0,1,1,9880.0,2:10,5187500
8474717,Mark,Barberio,1990-03-23,D,L,2016-17,60,2,11,13,0.22,-5,80,2.5,14,65740.0,18:15,0,0,0,0.0,20,55,16,33,-17,1,3,4,5880.0,1:38,0,0,0,1811.0,0:30,750000
8474722,Luke,Witkowski,1990-04-14,RW,R,2016-17,34,0,4,4,0.12,-1,24,0.0,39,20136.0,9:52,0,0,0,0.0,81,21,3,8,-5,0,0,0,189.0,0:5,0,0,0,65.0,0:1,575000
8474727,Ben,Smith,1988-07-11,RW,R,2016-17,40,2,2,4,0.1,-7,30,6.67,4,27519.0,11:27,241,227,468,51.5,29,41,9,5,4,0,0,0,23.0,0:0,0,0,0,5242.0,2:11,675000
8474739,Tommy,Wingels,1988-04-12,C,R,2016-17,73,7,5,12,0.16,-11,81,8.64,27,45998.0,10:30,111,149,260,42.69,126,47,13,15,-2,0,0,0,283.0,0:3,0,0,0,3111.0,0:42,2475000
8474743,Zach,Redmond,1988-07-26,D,R,2016-17,16,0,5,5,0.31,6,12,0.0,2,11818.0,12:18,0,0,0,0.0,25,13,5,6,-1,0,0,0,8.0,0:0,0,0,0,82.0,0:5,612500
8474749,Matt,Bartkowski,1988-06-04,D,L,2016-17,24,1,1,2,0.08,-4,16,6.25,26,22158.0,15:23,0,0,0,0.0,46,12,3,13,-10,0,0,0,45.0,0:1,0,0,0,638.0,0:26,612500
8474774,Dalton,Prout,1990-03-13,D,R,2016-17,29,0,6,6,0.21,-1,13,0.0,44,24302.0,13:58,0,0,0,0.0,44,24,3,12,-9,0,0,0,23.0,0:0,0,0,0,1549.0,0:53,1575000
8474818,Jordie,Benn,1987-07-26,D,L,2016-17,71,4,13,17,0.24,-4,68,5.88,28,77900.0,18:17,0,0,0,0.0,64,144,14,49,-35,0,2,2,4201.0,0:59,0,1,1,10096.0,2:22,1100000
8474849,Antoine,Roussel,1989-11-21,LW,L,2016-17,60,12,15,27,0.45,1,82,14.63,115,55866.0,15:31,7,9,16,43.75,69,45,16,37,-21,0,3,3,4147.0,1:9,0,0,0,7139.0,1:58,2000000
8474870,Tyler,Johnson,1990-07-29,C,R,2016-17,66,19,26,45,0.68,-5,130,14.62,28,74534.0,18:49,583,539,1122,51.96,46,30,26,32,-6,6,11,17,11339.0,2:51,0,0,0,8121.0,2:3,3333333
8474873,Brian,Lashoff,1990-07-16,D,L,2016-17,5,0,0,0,0.0,-3,1,0.0,0,3754.0,12:30,0,0,0,0.0,8,4,0,1,-1,0,0,0,0.0,0:0,0,0,0,220.0,0:44,650000
8474884,Mike,Hoffman,1989-11-24,LW,L,2016-17,74,26,35,61,0.82,17,224,11.61,51,78113.0,17:35,12,9,21,57.14,41,21,45,54,-9,13,13,26,14137.0,3:11,0,0,0,55.0,0:0,5187500
8475098,Tyler,Bozak,1986-03-19,C,R,2016-17,78,18,37,55,0.71,-1,145,12.41,30,76890.0,16:25,774,592,1366,56.66,45,26,52,48,4,7,11,18,11080.0,2:22,0,0,0,403.0,0:5,4200000
8475147,Jordan,Schroeder,1990-09-29,LW,R,2016-17,37,6,7,13,0.35,5,37,16.22,0,21710.0,9:46,19,21,40,47.5,29,15,11,5,6,0,0,0,36.0,0:0,0,0,0,3.0,0:0,650000
8475149,Marcus,Johansson,1990-10-06,LW,L,2016-17,82,24,34,58,0.71,25,129,18.6,10,83610.0,16:59,13,15,28,46.43,32,22,40,48,-8,5,14,19,13882.0,2:49,0,0,0,157.0,0:1,4583333
8475151,Kyle,Palmieri,1991-02-01,RW,R,2016-17,80,26,27,53,0.66,2,192,13.54,46,83275.0,17:20,12,17,29,41.38,124,36,29,34,-5,8,11,19,12654.0,2:38,1,0,1,4547.0,0:56,4650000
8475155,Simon,Despres,1991-07-27,D,L,2016-17,1,0,0,0,0.0,0,1,0.0,0,968.0,16:8,0,0,0,0.0,1,1,0,0,0,0,0,0,231.0,3:51,0,0,0,169.0,2:49,3700000
8475158,Ryan,O'Reilly,1991-02-07,C,L,2016-17,72,20,35,55,0.76,-1,189,10.58,10,92700.0,21:27,1039,752,1791,58.01,21,45,58,27,31,8,16,24,12522.0,2:53,1,1,2,10059.0,2:19,7500000
8475160,Kyle,Clifford,1991-01-13,LW,L,2016-17,73,6,6,12,0.16,-2,122,4.92,92,46968.0,10:43,2,3,5,40.0,146,7,17,7,10,0,0,0,438.0,0:6,0,0,0,124.0,0:1,1600000
8475163,Alex,Chiasson,1990-10-01,RW,R,2016-17,81,12,12,24,0.3,-6,104,11.54,46,65069.0,13:23,7,22,29,24.14,74,18,32,22,10,0,2,2,3118.0,0:38,1,0,1,4518.0,0:55,800000
8475164,Jakob,Silfverberg,1990-10-13,RW,R,2016-17,79,23,26,49,0.62,10,227,10.13,20,87616.0,18:29,1,6,7,14.29,47,46,46,38,8,5,4,9,9312.0,1:57,1,0,1,7741.0,1:37,3750000
8475165,Anton,Lander,1991-04-24,C,L,2016-17,22,1,3,4,0.18,2,12,8.33,6,12902.0,9:46,79,62,141,56.03,28,7,8,4,4,0,0,0,113.0,0:5,0,0,0,2496.0,1:53,987500
8475166,John,Tavares,1990-09-20,C,L,2016-17,77,28,38,66,0.86,4,260,10.77,38,94335.0,20:25,824,804,1628,50.61,42,20,63,81,-18,7,11,18,14760.0,3:11,1,1,2,4414.0,0:57,5500000
8475167,Victor,Hedman,1990-12-18,D,L,2016-17,79,16,56,72,0.91,3,166,9.64,47,116175.0,24:30,0,0,0,0.0,93,132,39,73,-34,4,29,33,14277.0,3:0,0,0,0,9748.0,2:3,4000000
8475168,Matt,Duchene,1991-01-16,C,L,2016-17,77,18,23,41,0.53,-34,160,11.25,12,84565.0,18:18,687,411,1098,62.57,42,41,60,46,14,3,6,9,11601.0,2:30,1,0,1,4424.0,0:57,6000000
8475169,Evander,Kane,1991-08-02,LW,L,2016-17,70,28,15,43,0.61,-17,260,10.77,113,80648.0,19:12,55,67,122,45.08,109,29,34,33,1,3,5,8,7481.0,1:46,0,0,0,5488.0,1:18,5250000
8475170,Brayden,Schenn,1991-08-22,C,L,2016-17,79,25,30,55,0.7,-13,178,14.04,38,84404.0,17:48,232,262,494,46.96,189,42,18,36,-18,17,11,28,17769.0,3:44,0,0,0,59.0,0:0,5125000
8475171,Oliver,Ekman-Larsson,1991-07-17,D,L,2016-17,79,12,27,39,0.49,-25,145,8.28,48,116677.0,24:36,0,0,0,0.0,112,85,18,48,-30,8,11,19,17491.0,3:41,0,0,0,7593.0,1:36,5500000
8475172,Nazem,Kadri,1990-10-06,C,L,2016-17,82,32,29,61,0.74,-7,236,13.56,95,81570.0,16:34,544,590,1134,47.97,124,31,58,59,-1,12,5,17,10751.0,2:11,0,0,0,169.0,0:2,4500000
8475175,Magnus,Paajarvi,1991-04-12,LW,L,2016-17,32,8,5,13,0.41,9,51,15.69,6,23339.0,12:9,1,2,3,33.33,29,16,11,0,11,1,0,1,500.0,0:15,0,0,0,1302.0,0:40,700000
8475176,Ryan,Ellis,1991-01-03,D,R,2016-17,71,16,22,38,0.54,17,140,11.43,29,102052.0,23:57,0,0,0,0.0,64,137,37,41,-4,4,7,11,9327.0,2:11,1,2,3,11078.0,2:36,2500000
8475177,Calvin,de Haan,1991-05-09,D,L,2016-17,82,5,20,25,0.3,15,116,4.31,36,97653.0,19:50,0,0,0,0.0,139,190,24,53,-29,1,1,2,3069.0,0:37,0,0,0,9351.0,1:54,1966667
8475178,Zack,Kassian,1991-01-24,RW,R,2016-17,79,7,17,24,0.3,4,110,6.36,101,58315.0,12:18,4,7,11,36.36,201,16,21,39,-18,0,0,0,443.0,0:5,0,0,0,5220.0,1:6,1500000
8475179,Dmitry,Kulikov,1990-10-29,D,L,2016-17,47,2,3,5,0.11,-26,42,4.76,26,61766.0,21:54,0,0,0,0.0,60,72,18,32,-14,1,2,3,2475.0,0:52,0,0,0,4528.0,1:36,4333333
8475180,Peter,Holland,1991-01-14,C,L,2016-17,48,5,7,12,0.25,-16,79,6.33,22,36720.0,12:45,228,274,502,45.42,37,9,21,16,5,1,0,1,3309.0,1:8,0,0,0,389.0,0:8,1300000
8475181,Nick,Leddy,1991-03-20,D,L,2016-17,81,11,35,46,0.57,-3,137,8.03,12,110410.0,22:43,0,0,0,0.0,77,109,26,48,-22,3,12,15,15300.0,3:8,0,0,0,3810.0,0:47,5500000
8475184,Chris,Kreider,1991-04-30,LW,L,2016-17,75,28,25,53,0.71,6,186,15.05,58,76522.0,17:0,5,4,9,55.56,132,30,17,33,-16,6,7,13,11685.0,2:35,0,0,0,117.0,0:1,4625000
8475185,Jacob,Josefson,1991-03-02,C,L,2016-17,38,1,9,10,0.26,-1,44,2.27,16,27924.0,12:14,162,151,313,51.76,31,12,7,9,-2,0,1,1,2106.0,0:55,0,0,0,1297.0,0:34,1100000
8475186,John,Moore,1990-11-19,D,L,2016-17,63,12,10,22,0.35,-7,102,11.76,39,71731.0,18:58,0,0,0,0.0,68,61,7,41,-34,1,2,3,4493.0,1:11,0,0,0,6897.0,1:49,1666667
8475188,Brayden,McNabb,1991-01-21,D,L,2016-17,49,2,2,4,0.08,1,47,4.26,54,44292.0,15:3,0,0,0,0.0,110,54,10,32,-22,0,0,0,259.0,0:5,0,0,0,1666.0,0:34,1700000
8475191,Reilly,Smith,1991-04-01,RW,L,2016-17,80,15,22,37,0.46,-13,160,9.38,17,88096.0,18:21,3,3,6,50.0,75,34,49,39,10,6,5,11,11584.0,2:24,1,0,1,8246.0,1:43,3425000
8475192,Taylor,Beck,1991-05-13,LW,R,2016-17,5,0,0,0,0.0,-3,5,0.0,4,2643.0,8:48,0,1,1,0.0,5,0,1,2,-1,0,0,0,87.0,0:17,0,0,0,0.0,0:0,650000
8475193,Tomas,Tatar,1990-12-01,LW,L,2016-17,82,25,21,46,0.56,-8,166,15.06,26,85004.0,17:16,8,5,13,61.54,92,24,34,38,-4,5,3,8,11670.0,2:22,0,0,0,231.0,0:2,2750000
8475197,Tyson,Barrie,1991-07-26,D,R,2016-17,74,7,31,38,0.51,-34,182,3.85,18,103486.0,23:18,0,0,0,0.0,32,75,22,51,-29,1,9,10,13632.0,3:4,0,0,0,2414.0,0:32,5500000
8475199,Eric,Gelinas,1991-05-08,D,L,2016-17,27,0,1,1,0.04,-4,29,0.0,12,18764.0,11:34,0,1,1,0.0,32,16,3,6,-3,0,0,0,134.0,0:4,0,0,0,215.0,0:7,1575000
8475200,Dmitry,Orlov,1991-07-23,D,L,2016-17,82,6,27,33,0.4,30,125,4.8,51,96107.0,19:32,0,0,0,0.0,122,94,34,50,-16,1,5,6,5605.0,1:8,0,0,0,1188.0,0:14,2570000
8475204,Brandon,Pirri,1991-04-10,RW,L,2016-17,60,8,10,18,0.3,-8,96,8.33,25,44198.0,12:16,140,103,243,57.61,41,20,22,26,-4,5,4,9,9216.0,2:33,0,0,0,32.0,0:0,1100000
8475208,Brian,Dumoulin,1991-09-06,D,L,2016-17,70,1,14,15,0.21,0,78,1.28,14,86294.0,20:32,0,0,0,0.0,113,99,25,37,-12,0,4,4,2172.0,0:31,0,0,0,7690.0,1:49,800000
8475209,Richard,Panik,1991-02-07,RW,L,2016-17,82,22,22,44,0.54,14,155,14.19,58,72490.0,14:44,2,5,7,28.57,147,45,30,23,7,4,5,9,8117.0,1:38,0,0,0,21.0,0:0,875000
8475210,Anton,Rodin,1990-11-21,RW,L,2016-17,3,0,1,1,0.33,1,2,0.0,0,1604.0,8:54,0,0,0,0.0,0,1,2,1,1,0,0,0,88.0,0:29,0,0,0,0.0,0:0,950000
8475213,Drew,Shore,1991-01-29,C,R,2016-17,14,0,2,2,0.14,-3,11,0.0,4,10051.0,11:57,38,33,71,53.52,22,3,4,5,-1,0,0,0,77.0,0:5,0,0,0,673.0,0:48,600000
8475218,Mattias,Ekholm,1990-05-24,D,L,2016-17,82,3,20,23,0.28,4,120,2.5,34,115415.0,23:27,0,0,0,0.0,61,108,38,66,-28,0,3,3,7020.0,1:25,0,1,1,11131.0,2:15,3750000
8475220,Marcus,Foligno,1991-08-10,LW,L,2016-17,80,13,10,23,0.29,-1,97,13.4,73,74264.0,15:28,1,4,5,20.0,279,57,33,35,-2,0,0,0,743.0,0:9,1,0,1,5565.0,1:9,2250000
8475222,Sami,Vatanen,1991-06-03,D,R,2016-17,71,3,21,24,0.34,3,117,2.56,30,92289.0,21:39,0,0,0,0.0,75,128,15,39,-24,2,12,14,12074.0,2:50,0,0,0,9202.0,2:9,4875000
8475223,Linden,Vey,1991-07-17,RW,R,2016-17,4,0,0,0,0.0,-2,1,0.0,0,2644.0,11:1,9,15,24,37.5,1,0,0,2,-2,0,0,0,447.0,1:51,0,0,0,0.0,0:0,700000
8475225,Craig,Smith,1989-09-05,RW,R,2016-17,78,12,17,29,0.37,7,155,7.74,30,64692.0,13:49,51,60,111,45.95,93,16,34,35,-1,2,1,3,5165.0,1:6,0,0,0,76.0,0:0,4250000
8475227,Chris,Wideman,1990-01-07,D,R,2016-17,76,5,12,17,0.22,7,123,4.07,46,63657.0,13:57,0,0,0,0.0,68,68,14,35,-21,1,4,5,6900.0,1:30,0,0,0,325.0,0:4,800000
8475231,Casey,Cizikas,1991-02-27,C,L,2016-17,59,8,17,25,0.42,9,82,9.76,30,49230.0,13:54,420,426,846,49.65,144,58,36,24,12,0,1,1,525.0,0:8,0,0,0,7613.0,2:9,3350000
8475233,David,Savard,1990-10-22,D,R,2016-17,74,6,17,23,0.31,33,135,4.44,44,96940.0,21:50,0,0,0,0.0,127,126,22,44,-22,0,0,0,926.0,0:12,0,2,2,10900.0,2:27,4250000
8475235,Nicolas,Deslauriers,1991-02-22,LW,L,2016-17,42,0,2,2,0.05,-6,26,0.0,38,18688.0,7:24,0,3,3,0.0,109,5,2,3,-1,0,0,0,80.0,0:1,0,0,0,78.0,0:1,775000
8475236,Cody,Eakin,1991-05-24,C,L,2016-17,60,3,9,12,0.2,-7,82,3.66,49,60535.0,16:48,524,477,1001,52.35,65,39,24,33,-9,0,2,2,4162.0,1:9,0,0,0,6158.0,1:42,3850000
8475246,Kevin,Connauton,1990-02-23,D,L,2016-17,24,0,1,1,0.04,-1,21,0.0,24,18910.0,13:7,0,0,0,0.0,48,22,4,5,-1,0,0,0,321.0,0:13,0,0,0,1185.0,0:49,1000000
8475250,Andrej,Nestrasil,1991-02-22,C,L,2016-17,19,1,4,5,0.26,-3,27,3.7,2,12430.0,10:54,3,7,10,30.0,10,6,11,8,3,0,0,0,592.0,0:31,0,0,0,0.0,0:0,912500
8475254,Gabriel,Dumont,1990-10-06,C,R,2016-17,39,2,2,4,0.1,1,34,5.88,29,22627.0,9:40,133,109,242,54.96,83,19,6,5,1,0,0,0,157.0,0:4,0,0,0,773.0,0:19,575000
8475263,Wade,Megan,1990-07-22,C,L,2016-17,3,1,0,1,0.33,1,6,16.67,0,1584.0,8:48,13,14,27,48.15,2,0,0,0,0,0,0,0,7.0,0:2,0,0,0,80.0,0:26,575000
8475268,Gabriel,Bourque,1990-09-23,LW,L,2016-17,6,0,0,0,0.0,0,4,0.0,0,4032.0,11:12,0,1,1,0.0,17,6,1,0,1,0,0,0,0.0,0:0,0,0,0,794.0,2:12,800000
8475274,Seth,Helgeson,1990-10-08,D,L,2016-17,9,1,0,1,0.11,2,3,33.33,15,7273.0,13:28,0,0,0,0.0,16,11,0,0,0,0,0,0,0.0,0:0,0,0,0,550.0,1:1,587500
8475278,Byron,Froese,1991-03-12,C,R,2016-17,6,0,0,0,0.0,-3,6,0.0,5,3798.0,10:33,26,30,56,46.43,3,4,3,2,1,0,0,0,214.0,0:35,0,0,0,77.0,0:12,575000
8475279,Ben,Chiarot,1991-05-09,D,L,2016-17,59,2,10,12,0.2,2,49,4.08,33,54237.0,15:19,0,0,0,0.0,78,94,13,46,-33,0,0,0,101.0,0:1,0,0,0,6985.0,1:58,850000
8475287,Erik,Haula,1991-03-23,LW,L,2016-17,72,15,11,26,0.36,5,134,11.19,28,59673.0,13:48,404,346,750,53.87,39,38,24,18,6,1,0,1,871.0,0:12,0,0,0,4630.0,1:4,1000000
8475291,Garrett,Mitchell,1991-09-02,RW,R,2016-17,1,0,0,0,0.0,0,0,,0,528.0,8:48,0,1,1,0.0,2,0,0,0,0,0,0,0,0.0,0:0,0,0,0,0.0,0:0,587500
8475296,Mitch,Callahan,1991-08-17,RW,R,2016-17,4,0,0,0,0.0,0,2,0.0,0,1635.0,6:48,0,0,0,0.0,3,2,1,0,1,0,0,0,0.0,0:0,0,0,0,0.0,0:0,600000
8475310,Curtis,McKenzie,1991-02-22,LW,L,2016-17,53,6,10,16,0.3,5,66,9.09,72,34509.0,10:51,3,3,6,50.0,103,31,12,10,2,0,0,0,211.0,0:3,0,0,0,3131.0,0:59,675000
8475314,Anders,Lee,1990-07-03,LW,L,2016-17,81,34,18,52,0.64,9,191,17.8,56,75759.0,15:35,7,11,18,38.89,172,34,22,26,-4,9,5,14,11955.0,2:27,0,0,0,109.0,0:1,3750000
8475321,Phil,Varone,1990-12-04,C,L,2016-17,7,0,0,0,0.0,-3,1,0.0,2,3351.0,7:58,15,12,27,55.56,3,1,3,4,-1,0,0,0,299.0,0:42,0,0,0,0.0,0:0,700000
8475323,Marcus,Kruger,1990-05-27,C,L,2016-17,70,5,12,17,0.24,7,83,6.02,34,58886.0,14:1,357,370,727,49.11,31,62,24,10,14,0,0,0,361.0,0:5,0,0,0,9340.0,2:13,3083333
8475324,Nick,Jensen,1990-09-21,D,R,2016-17,49,4,9,13,0.27,-7,59,6.78,12,52202.0,17:45,0,0,0,0.0,55,56,10,37,-27,0,0,0,196.0,0:4,0,1,1,4500.0,1:31,587500
8475325,Jordan,Nolan,1989-06-23,C,L,2016-17,46,4,4,8,0.17,-3,39,10.26,44,29962.0,10:51,2,4,6,33.33,62,7,5,10,-5,0,0,0,491.0,0:10,0,0,0,43.0,0:0,950000
8475343,Nic,Dowd,1990-05-27,C,R,2016-17,70,6,16,22,0.31,-15,78,7.69,25,52314.0,12:27,338,369,707,47.81,145,35,19,22,-3,1,7,8,6570.0,1:33,0,0,0,251.0,0:3,640000
8475413,Justin,Dowling,1990-10-01,C,L,2016-17,9,0,2,2,0.22,0,11,0.0,2,5654.0,10:28,38,31,69,55.07,1,0,3,1,2,0,1,1,53.0,0:5,0,0,0,61.0,0:6,625000
8475430,Brandon,Manning,1990-06-04,D,L,2016-17,65,3,9,12,0.18,-12,84,3.57,83,70419.0,18:3,0,1,1,0.0,121,79,9,38,-29,0,0,0,638.0,0:9,1,0,1,6361.0,1:37,975000
8475436,Mike,Liambas,1989-02-16,LW,L,2016-17,1,0,0,0,0.0,-1,0,,0,282.0,4:42,0,0,0,0.0,1,0,0,1,-1,0,0,0,0.0,0:0,0,0,0,0.0,0:0,575000
8475455,Brenden,Dillon,1990-11-13,D,L,2016-17,81,2,8,10,0.12,-2,86,2.33,60,80031.0,16:28,0,0,0,0.0,174,81,11,34,-23,0,0,0,474.0,0:5,0,0,0,3897.0,0:48,3270000
8475462,Radko,Gudas,1990-06-05,D,R,2016-17,67,6,17,23,0.34,8,113,5.31,93,77555.0,19:17,0,0,0,0.0,280,124,18,40,-22,0,1,1,274.0,0:4,0,0,0,7666.0,1:54,3350000
8475597,Shane,Harper,1989-02-01,RW,R,2016-17,14,2,1,3,0.21,-1,13,15.38,18,8652.0,10:18,0,0,0,0.0,19,0,4,3,1,0,0,0,17.0,0:1,0,0,0,12.0,0:0,650000
8475613,Nate,Prosser,1986-05-07,D,R,2016-17,39,2,5,7,0.18,0,20,10.0,12,29789.0,12:43,0,0,0,0.0,30,64,3,10,-7,0,1,1,24.0,0:0,0,0,0,1382.0,0:35,625000
8475625,Matt,Irwin,1987-11-29,D,L,2016-17,74,3,11,14,0.19,15,98,3.06,26,72228.0,16:16,0,0,0,0.0,115,121,18,39,-21,0,0,0,125.0,0:1,0,2,2,5453.0,1:13,575000
8475690,Christopher,Tanev,1989-12-20,D,R,2016-17,53,2,8,10,0.19,3,39,5.13,14,64697.0,20:20,0,0,0,0.0,19,91,15,25,-10,0,0,0,1442.0,0:27,0,0,0,9190.0,2:53,4450000
8475692,Mats,Zuccarello,1987-09-01,RW,L,2016-17,80,15,44,59,0.74,15,189,7.94,26,90378.0,18:49,6,7,13,46.15,85,52,70,54,16,5,9,14,13106.0,2:43,0,0,0,2162.0,0:27,4500000
8475714,Calle,Jarnkrok,1991-09-25,C,R,2016-17,81,15,16,31,0.38,-1,134,11.19,25,76428.0,15:43,452,463,915,49.4,49,29,23,22,1,2,2,4,3980.0,0:49,1,2,3,8624.0,1:46,2000000
8475715,Oscar,Lindberg,1991-10-29,C,L,2016-17,65,8,12,20,0.31,2,86,9.3,32,42235.0,10:49,299,276,575,52.0,94,36,10,12,-2,0,1,1,368.0,0:5,0,0,0,529.0,0:8,650000
8475716,Martin,Marincin,1992-02-18,D,L,2016-17,25,1,6,7,0.28,3,22,4.55,16,27071.0,18:2,0,0,0,0.0,25,27,7,15,-8,0,0,0,84.0,0:3,0,1,1,4230.0,2:49,1250000
8475722,Jason,Zucker,1992-01-16,LW,L,2016-17,79,22,25,47,0.59,34,172,12.79,30,72455.0,15:17,1,4,5,20.0,73,42,44,23,21,1,0,1,1182.0,0:14,0,0,0,2905.0,0:36,2000000
8475726,Tyler,Toffoli,1992-04-24,C,R,2016-17,63,16,18,34,0.54,6,165,9.7,22,62694.0,16:35,2,3,5,40.0,54,4,19,31,-12,4,3,7,8607.0,2:16,0,1,1,3981.0,1:3,3250000
8475727,Ryan,Spooner,1992-01-30,C,L,2016-17,78,11,28,39,0.5,-8,145,7.59,14,65964.0,14:5,79,124,203,38.92,24,17,36,50,-14,3,15,18,12294.0,2:37,0,1,1,1063.0,0:13,950000
8475728,Johan,Larsson,1992-07-25,C,L,2016-17,36,6,5,11,0.31,-7,49,12.24,20,36401.0,16:51,261,272,533,48.97,33,23,13,16,-3,1,0,1,1014.0,0:28,0,0,0,2653.0,1:13,950000
8475730,Stephen,Johns,1992-04-18,D,R,2016-17,61,4,6,10,0.16,-10,91,4.4,36,66815.0,18:15,0,0,0,0.0,159,130,20,45,-25,0,1,1,1001.0,0:16,0,0,0,7449.0,2:2,725000
8475735,Greg,McKegg,1992-06-17,C,L,2016-17,46,3,4,7,0.15,-3,36,8.33,22,27331.0,9:54,90,90,180,50.0,48,16,7,6,1,0,0,0,448.0,0:9,0,0,0,1274.0,0:27,700000
8475738,Jordan,Weal,1992-04-15,C,R,2016-17,23,8,4,12,0.52,5,49,16.33,10,19749.0,14:18,14,14,28,50.0,7,8,14,6,8,1,0,1,2167.0,1:34,0,0,0,19.0,0:0,650000
8475739,Michael,Bournival,1992-05-31,LW,L,2016-17,19,2,1,3,0.16,-3,25,8.0,2,11568.0,10:8,1,2,3,33.33,31,8,6,3,3,0,0,0,136.0,0:7,0,0,0,0.0,0:0,575000
8475744,Evgeny,Kuznetsov,1992-05-19,C,L,2016-17,82,19,40,59,0.72,18,170,11.18,46,83410.0,16:57,456,581,1037,43.97,57,18,43,59,-16,3,11,14,9855.0,2:0,0,0,0,128.0,0:1,3000000
8475745,Charlie,Coyle,1992-03-02,C,R,2016-17,82,18,38,56,0.68,13,159,11.32,36,82174.0,16:42,114,134,248,45.97,101,63,30,34,-4,4,5,9,10502.0,2:8,0,0,0,1766.0,0:21,3200000
8475747,Patrik,Nemeth,1992-02-08,D,L,2016-17,40,0,3,3,0.08,-4,46,0.0,14,37869.0,15:46,0,0,0,0.0,45,47,10,18,-8,0,0,0,98.0,0:2,0,0,0,2450.0,1:1,900000
8475750,Jon,Merrill,1992-02-03,D,L,2016-17,51,1,5,6,0.12,-9,48,2.08,24,56813.0,18:33,0,0,0,0.0,39,68,16,22,-6,0,0,0,921.0,0:18,0,0,0,4581.0,1:29,1137500
8475752,Tyler,Pitlick,1991-11-01,C,R,2016-17,31,8,3,11,0.35,0,54,14.81,6,18459.0,9:55,8,7,15,53.33,70,13,3,8,-5,0,0,0,160.0,0:5,0,0,0,262.0,0:8,725000
8475753,Justin,Faulk,1992-03-20,D,R,2016-17,75,17,20,37,0.49,-18,225,7.56,32,104133.0,23:8,0,0,0,0.0,117,84,53,45,8,4,9,13,12257.0,2:43,0,0,0,3180.0,0:42,4833333
8475754,Brock,Nelson,1991-10-15,C,L,2016-17,81,20,25,45,0.56,-6,173,11.56,36,76050.0,15:38,346,445,791,43.74,50,48,43,43,0,1,5,6,9090.0,1:52,0,1,1,2942.0,0:36,2500000
8475755,Alex,Petrovic,1992-03-03,D,R,2016-17,49,1,13,14,0.29,-1,55,1.82,79,53361.0,18:9,0,0,0,0.0,106,55,16,27,-11,0,0,0,326.0,0:6,0,0,0,3865.0,1:18,1050000
8475758,Devante,Smith-Pelly,1992-06-14,RW,R,2016-17,53,4,5,9,0.17,-19,76,5.26,12,42950.0,13:30,29,42,71,40.85,94,32,17,14,3,0,2,2,3576.0,1:7,0,0,0,3908.0,1:13,1300000
8475760,Nick,Bjugstad,1992-07-17,C,R,2016-17,54,7,7,14,0.26,-19,91,7.69,22,42615.0,13:9,186,205,391,47.57,72,9,21,17,4,1,2,3,4592.0,1:25,0,0,0,112.0,0:2,4100000
8475761,Beau,Bennett,1991-11-27,RW,R,2016-17,65,8,11,19,0.29,-3,101,7.92,20,52876.0,13:33,3,13,16,18.75,77,13,19,16,3,1,1,2,6567.0,1:41,0,0,0,69.0,0:1,725000
8475762,Derek,Forbort,1992-03-04,D,L,2016-17,82,2,16,18,0.22,8,100,2.0,54,98971.0,20:6,1,0,1,100.0,180,159,9,73,-64,0,0,0,745.0,0:9,0,1,1,10752.0,2:11,650000
8475763,Kevin,Hayes,1992-05-08,C,L,2016-17,76,17,32,49,0.64,10,143,11.89,18,75508.0,16:33,442,526,968,45.66,40,30,54,66,-12,1,6,7,6661.0,1:27,1,6,7,6511.0,1:25,2600000
8475764,Cam,Fowler,1991-12-05,D,L,2016-17,80,11,28,39,0.49,7,186,5.91,20,119271.0,24:50,0,0,0,0.0,29,134,30,68,-38,5,10,15,14888.0,3:6,1,1,2,13232.0,2:45,4000000
8475765,Vladimir,Tarasenko,1991-12-13,RW,L,2016-17,82,39,36,75,0.91,-1,286,13.64,12,90872.0,18:28,5,5,10,50.0,50,31,29,31,-2,9,13,22,14683.0,2:59,0,0,0,900.0,0:10,7500000
8475766,Austin,Watson,1992-01-13,LW,R,2016-17,77,5,12,17,0.22,14,90,5.56,99,57408.0,12:25,17,25,42,40.48,143,66,24,14,10,0,0,0,604.0,0:7,0,1,1,7954.0,1:43,575000
8475768,Jaden,Schwartz,1992-06-25,LW,L,2016-17,78,19,36,55,0.71,14,179,10.61,18,88482.0,18:54,67,73,140,47.86,71,43,59,29,30,3,6,9,12325.0,2:38,0,0,0,5107.0,1:5,5350000
8475769,Quinton,Howden,1992-01-21,C,L,2016-17,5,0,0,0,0.0,1,5,0.0,0,2597.0,8:39,0,2,2,0.0,4,0,1,0,1,0,0,0,57.0,0:11,0,0,0,0.0,0:0,650000
8475770,Emerson,Etem,1992-06-16,RW,L,2016-17,3,0,0,0,0.0,1,0,,2,1585.0,8:48,0,1,1,0.0,4,0,0,0,0,0,0,0,68.0,0:22,0,0,0,56.0,0:18,775000
8475772,Riley,Sheahan,1991-12-07,C,L,2016-17,80,2,11,13,0.16,-29,109,1.83,14,67064.0,13:58,236,230,466,50.64,81,38,20,22,-2,1,2,3,5378.0,1:7,0,0,0,4189.0,0:52,2075000
8475774,Petter,Granberg,1992-08-27,D,R,2016-17,10,0,0,0,0.0,0,4,0.0,10,5776.0,9:37,0,0,0,0.0,17,9,0,1,-1,0,0,0,0.0,0:0,0,0,0,206.0,0:20,612500
8475780,Chris,Wagner,1991-05-27,RW,R,2016-17,43,6,1,7,0.16,2,40,15.0,6,24142.0,9:21,62,86,148,41.89,112,24,4,13,-9,0,0,0,179.0,0:4,0,0,0,3610.0,1:23,637500
8475784,Jeff,Skinner,1992-05-16,LW,L,2016-17,79,37,26,63,0.8,-3,281,13.17,28,84081.0,17:44,10,17,27,37.04,33,28,65,65,0,7,8,15,10776.0,2:16,0,0,0,37.0,0:0,5725000
8475786,Zach,Hyman,1992-06-09,C,R,2016-17,82,10,18,28,0.34,2,156,6.41,30,82149.0,16:41,11,18,29,37.93,109,43,42,25,17,0,0,0,830.0,0:10,4,0,4,13722.0,2:47,900000
8475788,Alexander,Burmistrov,1991-10-21,C,L,2016-17,49,5,11,16,0.33,-7,45,11.11,12,39266.0,13:21,178,259,437,40.73,60,19,12,14,-2,4,1,5,3400.0,1:9,0,1,1,2598.0,0:53,1550000
8475790,Erik,Gudbranson,1992-01-07,D,R,2016-17,30,1,5,6,0.2,-14,40,2.5,18,36603.0,20:20,0,0,0,0.0,66,44,4,23,-19,0,0,0,389.0,0:12,0,0,0,4787.0,2:39,3500000
8475791,Taylor,Hall,1991-11-14,LW,L,2016-17,72,20,33,53,0.74,-9,238,8.4,32,83510.0,19:19,8,10,18,44.44,59,31,43,44,-1,7,8,15,11934.0,2:45,0,0,0,1215.0,0:16,6000000
8475792,Brett,Connolly,1992-05-02,RW,R,2016-17,66,15,8,23,0.35,20,81,18.52,40,42331.0,10:41,4,10,14,28.57,89,12,16,13,3,1,0,1,1781.0,0:26,0,0,0,63.0,0:0,850000
8475793,Ryan,Johansen,1992-07-31,C,R,2016-17,82,14,47,61,0.74,1,154,9.09,60,92671.0,18:50,803,669,1472,54.55,77,28,38,51,-13,4,19,23,14390.0,2:55,1,0,1,3879.0,0:47,4000000
8475794,Tyler,Seguin,1992-01-31,C,R,2016-17,82,26,46,72,0.88,-15,301,8.64,22,90826.0,18:27,401,385,786,51.02,60,26,37,39,-2,11,18,29,15592.0,3:10,0,0,0,129.0,0:1,5750000
8475795,Dylan,McIlrath,1992-04-20,D,R,2016-17,6,1,0,1,0.17,-2,3,33.33,14,3426.0,9:31,0,0,0,0.0,15,4,1,3,-2,0,0,0,0.0,0:0,0,0,0,66.0,0:11,800000
8475796,Mark,Pysyk,1992-01-11,D,R,2016-17,82,4,13,17,0.21,0,86,4.65,10,91319.0,18:33,0,1,1,0.0,72,99,31,36,-5,0,0,0,431.0,0:5,0,0,0,13946.0,2:50,1125000
8475798,Mikael,Granlund,1992-02-26,RW,L,2016-17,81,26,43,69,0.85,23,177,14.69,12,91487.0,18:49,16,17,33,48.48,50,50,43,33,10,7,13,20,10626.0,2:11,3,1,4,7300.0,1:30,3000000
8475799,Nino,Niederreiter,1992-09-08,RW,L,2016-17,82,25,32,57,0.7,17,186,13.44,53,74153.0,15:4,0,1,1,0.0,120,20,32,27,5,8,6,14,9868.0,2:0,0,0,0,9.0,0:0,2666667
8475800,Teemu,Pulkkinen,1992-01-02,LW,R,2016-17,13,2,0,2,0.15,-2,10,20.0,6,7411.0,9:30,0,1,1,0.0,4,3,2,6,-4,0,0,0,534.0,0:41,0,0,0,0.0,0:0,812500
8475807,Joakim,Nordstrom,1992-02-25,LW,L,2016-17,82,7,5,12,0.15,-12,104,6.73,17,62576.0,12:43,9,20,29,31.03,148,41,27,21,6,0,0,0,346.0,0:4,1,0,1,8032.0,1:37,1275000
8475808,Michael,Chaput,1992-04-09,C,L,2016-17,68,4,5,9,0.13,-12,64,6.25,29,44970.0,11:1,203,182,385,52.73,68,29,13,14,-1,0,0,0,357.0,0:5,0,0,0,1968.0,0:28,600000
8475810,Bryan,Rust,1992-05-11,RW,R,2016-17,57,15,13,28,0.49,4,110,13.64,8,46636.0,13:38,2,3,5,40.0,101,29,18,16,2,0,0,0,711.0,0:12,0,1,1,2497.0,0:43,640000
8475815,Julian,Melchiori,1991-12-06,D,L,2016-17,18,0,2,2,0.11,0,15,0.0,8,19837.0,18:22,0,0,0,0.0,30,31,4,18,-14,0,0,0,22.0,0:1,0,0,0,857.0,0:47,625000
8475820,Joonas,Donskoi,1992-04-13,RW,R,2016-17,61,6,11,17,0.28,-5,95,6.32,10,50548.0,13:48,8,8,16,50.0,27,27,31,35,-4,1,3,4,5142.0,1:24,0,0,0,49.0,0:0,925000
8475832,Tom,Kuhnhackl,1992-01-21,RW,L,2016-17,57,4,12,16,0.28,8,49,8.16,18,36425.0,10:39,2,2,4,50.0,112,42,6,5,1,0,0,0,131.0,0:2,1,1,2,6094.0,1:46,625000
8475834,Marcus,Sorensen,1992-04-07,LW,L,2016-17,19,1,3,4,0.21,-1,27,3.7,4,12328.0,10:48,3,1,4,75.0,15,6,9,11,-2,0,0,0,122.0,0:6,0,0,0,725.0,0:38,925000
8475841,Tim,Heed,1991-01-27,D,R,2016-17,1,0,0,0,0.0,0,1,0.0,0,989.0,16:29,0,0,0,0.0,0,2,1,0,1,0,0,0,51.0,0:51,0,0,0,0.0,0:0,775000
8475844,Kenny,Agostino,1992-04-30,LW,L,2016-17,7,1,2,3,0.43,0,17,5.88,2,5366.0,12:46,0,0,0,0.0,9,3,1,4,-3,0,1,1,536.0,1:16,0,0,0,0.0,0:0,625000
8475848,Brendan,Gallagher,1992-05-06,RW,R,2016-17,64,10,19,29,0.45,7,187,5.35,39,57965.0,15:5,30,44,74,40.54,69,15,33,25,8,1,2,3,7877.0,2:3,0,0,0,135.0,0:2,3750000
8475855,Jesper,Fast,1991-12-02,RW,R,2016-17,68,6,15,21,0.31,6,56,10.71,16,56290.0,13:47,17,27,44,38.64,99,44,29,21,8,0,0,0,408.0,0:6,0,0,0,6427.0,1:34,950000
8475857,Kevin,Gravel,1992-03-06,D,L,2016-17,49,1,6,7,0.14,3,52,1.92,6,41602.0,14:9,0,0,0,0.0,73,65,2,24,-22,1,1,2,2832.0,0:57,0,0,0,1512.0,0:30,667500
8475868,Anthony,Bitetto,1990-07-15,D,L,2016-17,29,0,7,7,0.24,-1,17,0.0,25,20538.0,11:48,0,0,0,0.0,43,24,1,8,-7,0,0,0,341.0,0:11,0,0,0,475.0,0:16,612500
8475869,Brandon,Davidson,1991-08-21,D,L,2016-17,38,0,3,3,0.08,-2,42,0.0,20,35841.0,15:43,0,0,0,0.0,42,61,7,20,-13,0,0,0,92.0,0:2,0,0,0,1984.0,0:52,1425000
8475878,Freddie,Hamilton,1992-01-01,C,R,2016-17,26,2,0,2,0.08,-3,30,6.67,8,15258.0,9:46,75,51,126,59.52,46,1,3,2,1,0,0,0,0.0,0:0,0,0,0,539.0,0:20,612500
8475906,John,Klingberg,1992-08-14,D,R,2016-17,80,13,36,49,0.61,2,124,10.48,34,112108.0,23:21,1,0,1,100.0,42,117,40,99,-59,4,13,17,15262.0,3:10,0,0,0,1057.0,0:13,4250000
8475907,Micheal,Ferland,1992-04-20,LW,L,2016-17,76,15,10,25,0.33,-1,106,14.15,50,52736.0,11:33,3,4,7,42.86,149,26,36,38,-2,2,2,4,2127.0,0:27,0,0,0,162.0,0:2,825000
8475913,Mark,Stone,1992-05-13,RW,R,2016-17,71,22,32,54,0.76,12,134,16.42,25,79072.0,18:33,10,15,25,40.0,43,53,96,47,49,6,8,14,13101.0,3:4,0,0,0,234.0,0:3,3500000
8475949,Marek,Hrivik,1991-08-28,LW,R,2016-17,16,0,2,2,0.12,-3,15,0.0,2,10003.0,10:25,32,48,80,40.0,19,5,5,2,3,0,1,1,61.0,0:3,0,0,0,290.0,0:18,600000
8475958,Michael,Sgarbossa,1992-07-25,C,L,2016-17,38,2,7,9,0.24,-5,33,6.06,9,25430.0,11:9,138,176,314,43.95,39,16,6,14,-8,1,1,2,1504.0,0:39,0,0,0,339.0,0:8,600000
8475982,Erik,Burgdoerfer,1988-12-11,D,R,2016-17,2,0,0,0,0.0,-1,2,0.0,0,1340.0,11:10,0,0,0,0.0,5,0,0,1,-1,0,0,0,0.0,0:0,0,0,0,0.0,0:0,575000
8476043,Ben,Street,1987-02-13,C,L,2016-17,6,0,1,1,0.17,1,8,0.0,0,2970.0,8:15,0,0,0,0.0,3,0,0,2,-2,0,0,0,0.0,0:0,0,0,0,0.0,0:0,600000
8476116,Ryan,Garbutt,1985-08-12,C,L,2016-17,27,2,1,3,0.11,-3,26,7.69,20,14837.0,9:9,7,4,11,63.64,53,12,3,3,0,0,0,0,113.0,0:4,0,1,1,1891.0,1:10,1800000
8476158,Harry,Zolnierczyk,1987-09-01,LW,L,2016-17,24,2,2,4,0.17,-2,19,10.53,10,12776.0,8:52,8,11,19,42.11,25,11,7,1,6,0,0,0,13.0,0:0,0,0,0,65.0,0:2,575000
8476162,Steve,Oleksy,1986-02-04,D,R,2016-17,11,0,1,1,0.09,2,11,0.0,24,9040.0,13:41,0,0,0,0.0,20,19,1,1,0,0,0,0,3.0,0:0,0,0,0,756.0,1:8,575000
8476166,Taylor,Fedun,1988-06-04,D,R,2016-17,27,0,7,7,0.26,3,24,0.0,16,21649.0,13:21,0,0,0,0.0,7,20,5,9,-4,0,3,3,1950.0,1:12,0,0,0,9.0,0:0,600000
8476177,Matt,Read,1986-06-14,RW,R,2016-17,63,10,9,19,0.3,3,92,10.87,8,52146.0,13:47,5,10,15,33.33,95,32,21,18,3,2,0,2,2474.0,0:39,1,0,1,3377.0,0:53,3625000
8476191,Kevan,Miller,1987-11-15,D,R,2016-17,58,3,10,13,0.22,1,49,6.12,50,61927.0,17:47,0,0,0,0.0,121,76,7,21,-14,0,0,0,194.0,0:3,0,1,1,7001.0,2:0,2500000
8476195,Cory,Conacher,1989-12-14,C,L,2016-17,11,1,3,4,0.36,0,16,6.25,4,7631.0,11:33,1,1,2,50.0,1,0,6,8,-2,1,0,1,1219.0,1:50,0,0,0,0.0,0:0,575000
8476200,Paul,Thompson,1988-11-30,RW,R,2016-17,21,0,3,3,0.14,-4,19,0.0,22,9954.0,7:54,0,1,1,0.0,48,16,4,2,2,0,0,0,11.0,0:0,0,0,0,10.0,0:0,575000
8476219,Patrick,Cannone,1986-08-09,C,R,2016-17,3,0,0,0,0.0,0,2,0.0,0,1419.0,7:53,11,10,21,52.38,2,1,1,2,-1,0,0,0,0.0,0:0,0,0,0,0.0,0:0,600000
8476279,Jyrki,Jokipakka,1991-08-20,D,L,2016-17,41,1,5,6,0.15,-4,29,3.45,12,35507.0,14:26,0,0,0,0.0,31,32,6,25,-19,0,0,0,231.0,0:5,0,0,0,440.0,0:10,900000
8476285,Matthew,Peca,1993-04-27,C,L,2016-17,10,1,1,2,0.2,-3,9,11.11,2,6867.0,11:26,32,40,72,44.44,9,2,0,2,-2,0,0,0,551.0,0:55,0,0,0,6.0,0:0,796250
8476288,Ryan,Dzingel,1992-03-09,LW,L,2016-17,81,14,18,32,0.4,7,123,11.38,30,69926.0,14:23,9,21,30,30.0,71,21,23,25,-2,1,2,3,6493.0,1:20,1,0,1,882.0,0:10,750000
8476289,Alexey,Marchenko,1992-01-02,D,R,2016-17,41,1,7,8,0.2,7,36,2.78,12,41700.0,16:57,0,0,0,0.0,22,59,5,22,-17,0,0,0,183.0,0:4,0,1,1,4340.0,1:45,1450000
8476292,Ondrej,Palat,1991-03-28,LW,L,2016-17,75,17,35,52,0.69,8,162,10.49,39,86028.0,19:7,9,25,34,26.47,141,66,60,46,14,5,10,15,12485.0,2:46,0,0,0,7691.0,1:42,3333333
8476293,Scott,Wilson,1992-04-24,C,L,2016-17,78,8,18,26,0.33,0,127,6.3,32,51220.0,10:56,3,0,3,100.0,167,31,20,11,9,0,0,0,1674.0,0:21,0,0,0,157.0,0:2,625000
8476300,Nikita,Nesterov,1993-03-28,D,L,2016-17,48,4,13,17,0.35,0,63,6.35,24,46901.0,16:17,0,0,0,0.0,84,21,6,24,-18,1,1,2,3307.0,1:8,0,0,0,127.0,0:2,725000
8476302,Frank,Corrado,1993-03-26,D,R,2016-17,4,0,0,0,0.0,-1,3,0.0,8,2585.0,10:46,0,0,0,0.0,4,2,0,2,-2,0,0,0,17.0,0:4,0,0,0,128.0,0:32,600000
8476303,Rob,O'Gara,1993-07-06,D,L,2016-17,3,0,0,0,0.0,1,2,0.0,0,2882.0,16:0,0,0,0,0.0,3,7,0,2,-2,0,0,0,0.0,0:0,0,0,0,395.0,2:11,925000
8476310,Lukas,Sedlak,1993-02-25,C,L,2016-17,62,7,6,13,0.21,10,57,12.28,25,36170.0,9:43,232,211,443,52.37,66,28,15,10,5,0,0,0,133.0,0:2,1,0,1,2136.0,0:34,600000
8476312,Josh,Manson,1991-10-07,D,R,2016-17,82,5,12,17,0.21,14,88,5.68,82,91639.0,18:37,0,0,0,0.0,227,79,23,57,-34,0,0,0,369.0,0:4,1,1,2,11527.0,2:20,825000
8476323,Max,McCormick,1992-05-01,LW,L,2016-17,7,0,0,0,0.0,-3,7,0.0,0,2839.0,6:45,15,9,24,62.5,13,1,2,0,2,0,0,0,5.0,0:0,0,0,0,0.0,0:0,650000
8476326,Josh,Archibald,1992-10-06,RW,R,2016-17,10,3,0,3,0.3,3,11,27.27,4,6519.0,10:51,0,1,1,0.0,28,2,0,2,-2,0,0,0,12.0,0:1,1,0,1,304.0,0:30,659167
8476331,Dylan,DeMelo,1993-05-01,D,R,2016-17,25,1,7,8,0.32,2,32,3.12,14,23839.0,15:53,0,0,0,0.0,36,32,4,12,-8,0,0,0,1985.0,1:19,0,0,0,505.0,0:20,650000
8476336,Iiro,Pakarinen,1991-08-25,RW,R,2016-17,14,2,2,4,0.29,2,15,13.33,2,7496.0,8:55,0,1,1,0.0,30,6,4,2,2,0,0,0,107.0,0:7,0,0,0,230.0,0:16,725000
8476344,Tyler,Graovac,1993-04-27,C,L,2016-17,52,7,2,9,0.17,7,48,14.58,10,30703.0,9:50,163,180,343,47.52,52,15,16,4,12,0,0,0,123.0,0:2,0,0,0,8.0,0:0,625000
8476346,Johnny,Gaudreau,1993-08-13,LW,L,2016-17,72,18,43,61,0.85,-7,182,9.89,4,79882.0,18:29,0,0,0,0.0,9,14,44,86,-42,4,12,16,13865.0,3:12,0,0,0,85.0,0:1,6750000
8476356,Tobias,Rieder,1993-01-10,C,L,2016-17,80,16,18,34,0.42,-8,155,10.32,6,83103.0,17:18,4,9,13,30.77,24,38,34,15,19,2,4,6,5733.0,1:11,1,1,2,11324.0,2:21,2225000
8476368,Fredrik,Claesson,1992-11-24,D,L,2016-17,33,3,8,11,0.33,5,25,12.0,4,26016.0,13:8,0,0,0,0.0,55,24,4,15,-11,0,0,0,464.0,0:14,0,1,1,843.0,0:25,700000
8476370,Blake,Pietila,1993-02-20,LW,L,2016-17,10,0,1,1,0.1,-5,9,0.0,4,7822.0,13:2,23,22,45,51.11,16,5,4,1,3,0,0,0,16.0,0:1,0,0,0,741.0,1:14,662500
8476374,Sean,Kuraly,1993-01-20,C,L,2016-17,8,0,1,1,0.12,-1,11,0.0,2,4416.0,9:12,1,2,3,33.33,9,1,2,0,2,0,0,0,10.0,0:1,0,0,0,59.0,0:7,808750
8476381,Andrew,Shaw,1991-07-20,RW,R,2016-17,68,12,17,29,0.43,4,127,9.45,110,62023.0,15:12,239,199,438,54.57,147,38,28,29,-1,1,6,7,8547.0,2:5,0,0,0,496.0,0:7,3900000
8476386,Shane,Prince,1992-11-16,LW,L,2016-17,50,5,13,18,0.36,-9,71,7.04,18,38912.0,12:58,4,3,7,57.14,36,12,23,19,4,1,2,3,3652.0,1:13,0,0,0,93.0,0:1,850000
8476389,Vincent,Trocheck,1993-07-11,C,R,2016-17,82,23,31,54,0.66,-13,230,10.0,43,102473.0,20:49,835,829,1664,50.18,164,51,63,69,-6,2,10,12,13447.0,2:43,0,1,1,9440.0,1:55,4750000
8476390,Joseph,Cramarossa,1992-10-26,C,L,2016-17,59,4,6,10,0.17,0,36,11.11,60,35208.0,9:56,6,1,7,85.71,133,23,8,15,-7,0,0,0,252.0,0:4,0,2,2,2368.0,0:40,724500
8476391,TJ,Tynan,1992-02-25,C,R,2016-17,3,0,0,0,0.0,-1,3,0.0,0,1347.0,7:29,0,0,0,0.0,1,1,0,0,0,0,0,0,0.0,0:0,0,0,0,0.0,0:0,600000
8476392,Adam,Lowry,1993-03-29,C,L,2016-17,82,15,14,29,0.35,1,122,12.3,52,78962.0,16:2,658,637,1295,50.81,217,56,29,24,5,5,4,9,8519.0,1:43,0,1,1,11024.0,2:14,1125000
8476393,Nick,Cousins,1993-07-20,C,L,2016-17,60,6,10,16,0.27,-6,99,6.06,31,43204.0,12:0,89,128,217,41.01,61,24,15,14,1,1,1,2,4244.0,1:10,0,0,0,89.0,0:1,840000
8476399,Blake,Coleman,1991-11-28,C,L,2016-17,23,1,1,2,0.09,-7,29,3.45,27,17728.0,12:50,96,130,226,42.48,51,15,12,12,0,0,0,0,87.0,0:3,0,0,0,1443.0,1:2,680000
8476400,Logan,Shaw,1992-10-05,RW,R,2016-17,55,3,7,10,0.18,3,59,5.08,10,32040.0,9:42,55,90,145,37.93,62,18,10,7,3,0,0,0,147.0,0:2,1,1,2,4835.0,1:27,660000
8476403,Klas,Dahlbeck,1991-07-06,D,L,2016-17,43,2,4,6,0.14,-12,37,5.41,30,35832.0,13:53,0,0,0,0.0,77,38,11,15,-4,0,0,0,51.0,0:1,0,0,0,1034.0,0:24,750000
8476404,Andy,Andreoff,1991-05-17,LW,L,2016-17,36,0,2,2,0.06,-2,38,0.0,70,22888.0,10:35,41,28,69,59.42,70,7,5,10,-5,0,0,0,166.0,0:4,0,0,0,364.0,0:10,587500
8476406,Nick,Shore,1992-09-26,C,R,2016-17,70,6,11,17,0.24,-2,79,7.59,20,53712.0,12:47,362,359,721,50.21,58,22,11,19,-8,0,0,0,1261.0,0:18,1,0,1,5457.0,1:17,600000
8476409,Alan,Quine,1993-02-25,C,L,2016-17,61,5,13,18,0.3,-2,82,6.1,8,45826.0,12:31,264,286,550,48.0,77,29,17,18,-1,2,1,3,4053.0,1:6,0,0,0,1326.0,0:21,612500
8476410,Josh,Leivo,1993-05-26,LW,R,2016-17,13,2,8,10,0.77,2,27,7.41,4,9808.0,12:34,1,1,2,50.0,5,4,11,2,9,1,2,3,1496.0,1:55,0,0,0,0.0,0:0,612500
8476414,Alexandre,Grenier,1991-09-05,RW,R,2016-17,3,0,0,0,0.0,-1,1,0.0,0,1167.0,6:29,2,0,2,100.0,3,0,0,0,0,0,0,0,0.0,0:0,0,0,0,0.0,0:0,600000
8476415,Kyle,Rau,1992-10-24,C,L,2016-17,24,2,1,3,0.12,-3,21,9.52,4,13824.0,9:36,2,1,3,66.67,24,3,7,2,5,0,0,0,305.0,0:12,0,0,0,0.0,0:0,858750
8476416,Dillon,Simpson,1993-02-10,D,L,2016-17,3,0,0,0,0.0,0,2,0.0,2,1959.0,10:53,0,0,0,0.0,3,2,0,1,-1,0,0,0,0.0,0:0,0,0,0,0.0,0:0,836667
8476418,Robbie,Russo,1993-02-15,D,R,2016-17,19,0,0,0,0.0,2,18,0.0,2,18319.0,16:4,0,0,0,0.0,24,13,0,13,-13,0,0,0,151.0,0:7,0,0,0,1290.0,1:7,680000
8476419,Jean-Gabriel,Pageau,1992-11-11,C,R,2016-17,82,12,21,33,0.4,13,169,7.1,24,79363.0,16:7,558,460,1018,54.81,161,79,25,27,-2,0,0,0,1718.0,0:20,0,2,2,10712.0,2:10,900000
8476422,Mike,Reilly,1993-07-13,D,L,2016-17,17,1,0,1,0.06,1,19,5.26,2,12629.0,12:22,0,0,0,0.0,2,8,0,6,-6,0,0,0,1228.0,1:12,0,0,0,23.0,0:1,925000
8476423,Reid,Boucher,1993-09-08,C,L,2016-17,39,6,4,10,0.26,-6,70,8.57,8,27909.0,11:55,0,1,1,0.0,20,14,18,8,10,1,0,1,3589.0,1:32,0,0,0,111.0,0:2,715000
8476425,Joseph,LaBate,1993-04-16,C,L,2016-17,13,0,0,0,0.0,-2,5,0.0,21,5276.0,6:45,1,0,1,100.0,23,2,3,1,2,0,0,0,12.0,0:0,0,0,0,0.0,0:0,680000
8476427,Ty,Rattie,1993-02-05,RW,R,2016-17,9,0,2,2,0.22,-2,10,0.0,0,5799.0,10:44,0,0,0,0.0,10,4,4,0,4,0,0,0,55.0,0:6,0,0,0,4.0,0:0,650000
8476428,Rocco,Grimaldi,1993-02-08,C,R,2016-17,4,0,1,1,0.25,-3,11,0.0,2,2640.0,11:0,0,0,0,0.0,1,4,3,0,3,0,0,0,0.0,0:0,0,0,0,0.0,0:0,925000
8476429,Scott,Mayfield,1992-10-14,D,R,2016-17,25,2,7,9,0.36,-1,39,5.13,35,21210.0,14:8,0,0,0,0.0,37,36,8,11,-3,0,0,0,19.0,0:0,0,0,0,31.0,0:1,625000
8476430,Tomas,Jurco,1992-12-28,LW,L,2016-17,29,1,0,1,0.03,-12,35,2.86,4,18504.0,10:38,0,1,1,0.0,21,9,3,7,-4,0,0,0,542.0,0:18,0,0,0,113.0,0:3,900000
8476431,Adam,Clendening,1992-10-26,D,R,2016-17,31,2,9,11,0.35,3,38,5.26,17,29406.0,15:48,0,0,0,0.0,22,27,7,20,-13,1,1,2,2743.0,1:28,0,0,0,107.0,0:3,600000
8476432,Boone,Jenner,1993-06-15,C,L,2016-17,82,18,16,34,0.41,14,211,8.53,52,79022.0,16:3,92,92,184,50.0,216,80,42,20,22,0,1,1,5580.0,1:8,2,0,2,4195.0,0:51,2900000
8476436,Dmitrij,Jaskin,1993-03-23,RW,L,2016-17,51,1,10,11,0.22,5,55,1.82,18,35352.0,11:33,5,5,10,50.0,98,19,13,7,6,0,0,0,1184.0,0:23,0,0,0,20.0,0:0,1000000
8476437,Victor,Rask,1993-03-01,C,L,2016-17,82,16,29,45,0.55,-10,186,8.6,16,85088.0,17:17,457,461,918,49.78,43,33,41,46,-5,4,6,10,10463.0,2:7,0,1,1,1854.0,0:22,4000000
8476438,Brandon,Saad,1992-10-27,LW,L,2016-17,82,24,29,53,0.65,23,210,11.43,8,83786.0,17:1,4,5,9,44.44,24,26,43,29,14,1,2,3,7743.0,1:34,0,0,0,2442.0,0:29,6000000
8476439,Brett,Ritchie,1993-07-01,RW,R,2016-17,78,16,8,24,0.31,11,167,9.58,38,60355.0,12:53,1,1,2,50.0,153,23,15,26,-11,1,1,2,7384.0,1:34,0,0,0,32.0,0:0,875000
8476440,Markus,Granlund,1993-04-16,C,L,2016-17,69,19,13,32,0.46,-19,122,15.57,14,71657.0,17:18,40,61,101,39.6,32,11,33,18,15,3,4,7,8015.0,1:56,0,0,0,5021.0,1:12,900000
8476441,Joel,Edmundson,1993-06-28,D,L,2016-17,69,3,12,15,0.22,11,81,3.7,60,73562.0,17:46,0,0,0,0.0,122,95,7,26,-19,0,0,0,148.0,0:2,0,0,0,7806.0,1:53,1050000
8476442,Matt,Nieto,1992-11-05,LW,L,2016-17,59,7,6,13,0.22,-12,85,8.24,8,52834.0,14:55,2,4,6,33.33,41,34,28,18,10,0,0,0,1975.0,0:33,0,1,1,5904.0,1:40,735000
8476443,Xavier,Ouellet,1993-07-29,D,L,2016-17,66,3,9,12,0.18,2,89,3.37,51,71173.0,17:58,0,2,2,0.0,73,87,9,21,-12,0,0,0,367.0,0:5,0,0,0,7597.0,1:55,715000
8476447,Miikka,Salomaki,1993-03-09,RW,L,2016-17,5,0,0,0,0.0,-1,3,0.0,2,3664.0,12:12,0,0,0,0.0,14,9,1,0,1,0,0,0,11.0,0:2,0,0,0,337.0,1:7,612500
8476448,William,Karlsson,1993-01-08,C,L,2016-17,81,6,19,25,0.31,10,96,6.25,10,65063.0,13:23,435,525,960,45.31,35,24,33,20,13,1,0,1,991.0,0:12,0,2,2,7914.0,1:37,1000000
8476449,Scott,Harrington,1993-03-10,D,L,2016-17,22,1,2,3,0.14,3,16,6.25,10,17169.0,13:0,0,0,0,0.0,21,24,4,5,-1,0,0,0,0.0,0:0,0,0,0,403.0,0:18,632500
8476450,Ryan,Sproul,1993-01-13,D,R,2016-17,27,1,6,7,0.26,-8,46,2.17,6,24539.0,15:8,0,0,0,0.0,12,14,5,7,-2,1,2,3,3450.0,2:7,0,0,0,100.0,0:3,625000
8476452,Tyler,Wotherspoon,1993-03-12,D,L,2016-17,4,0,0,0,0.0,-2,4,0.0,0,2616.0,10:54,0,0,0,0.0,3,2,1,4,-3,0,0,0,0.0,0:0,0,0,0,0.0,0:0,625000
8476453,Nikita,Kucherov,1993-06-17,RW,L,2016-17,74,40,45,85,1.15,13,246,16.26,38,86320.0,19:26,0,0,0,0.0,30,20,54,64,-10,17,15,32,14911.0,3:21,0,0,0,110.0,0:1,4766667
8476454,Ryan,Nugent-Hopkins,1993-04-12,C,L,2016-17,82,18,25,43,0.52,-10,200,9.0,29,87045.0,17:41,556,712,1268,43.85,47,35,48,30,18,5,6,11,9303.0,1:53,0,0,0,8505.0,1:43,6000000
8476455,Gabriel,Landeskog,1992-11-23,LW,L,2016-17,72,18,15,33,0.46,-25,169,10.65,62,81136.0,18:46,62,63,125,49.6,143,41,65,36,29,5,1,6,10179.0,2:21,1,0,1,7737.0,1:47,5571429
8476456,Jonathan,Huberdeau,1993-06-04,LW,L,2016-17,31,10,16,26,0.84,-2,86,11.63,13,33330.0,17:55,4,5,9,44.44,18,7,15,24,-9,3,4,7,4725.0,2:32,0,0,0,173.0,0:5,3250000
8476457,Adam,Larsson,1992-11-12,D,R,2016-17,79,4,15,19,0.24,21,85,4.71,55,95509.0,20:8,0,0,0,0.0,253,160,28,71,-43,0,0,0,879.0,0:11,0,0,0,7563.0,1:35,4166666
8476458,Ryan,Strome,1993-07-11,C,R,2016-17,69,13,17,30,0.43,-8,114,11.4,40,60476.0,14:36,147,197,344,42.73,59,21,33,32,1,2,6,8,10983.0,2:39,0,0,0,149.0,0:2,2500000
8476459,Mika,Zibanejad,1993-04-18,C,R,2016-17,56,14,23,37,0.66,9,119,11.76,16,57362.0,17:4,494,456,950,52.0,23,27,36,31,5,4,7,11,8035.0,2:23,0,0,0,2386.0,0:42,2625000
8476460,Mark,Scheifele,1993-03-15,C,R,2016-17,79,32,50,82,1.04,18,160,20.0,38,97447.0,20:33,635,826,1461,43.46,49,34,67,42,25,7,8,15,14672.0,3:5,0,2,2,3337.0,0:42,6125000
8476461,Sean,Couturier,1992-12-07,C,L,2016-17,66,14,20,34,0.52,12,120,11.67,33,73045.0,18:26,587,479,1066,55.07,41,35,46,33,13,0,2,2,7207.0,1:49,0,1,1,7279.0,1:50,4333333
8476462,Dougie,Hamilton,1993-06-17,D,R,2016-17,81,13,37,50,0.62,12,222,5.86,64,95665.0,19:41,0,0,0,0.0,68,94,17,52,-35,2,12,14,11011.0,2:15,0,1,1,4298.0,0:53,5750000
8476463,Jonas,Brodin,1993-07-12,D,L,2016-17,68,3,22,25,0.37,5,85,3.53,20,79838.0,19:34,0,0,0,0.0,20,89,16,29,-13,2,5,7,6241.0,1:31,0,0,0,7530.0,1:50,4166667
8476464,Duncan,Siemens,1993-09-07,D,L,2016-17,3,0,0,0,0.0,-2,2,0.0,2,2216.0,12:18,0,0,0,0.0,10,1,0,2,-2,0,0,0,0.0,0:0,0,0,0,193.0,1:4,874125
8476465,Ryan,Murphy,1993-03-31,D,R,2016-17,27,0,2,2,0.07,-11,17,0.0,8,21339.0,13:10,0,0,0,0.0,2,31,11,8,3,0,0,0,639.0,0:23,0,0,0,2.0,0:0,787500
8476466,Sven,Baertschi,1992-10-05,LW,L,2016-17,68,18,17,35,0.51,-6,114,15.79,8,64773.0,15:52,1,0,1,100.0,52,29,39,23,16,2,4,6,7751.0,1:53,0,0,0,1114.0,0:16,1850000
8476467,Jamie,Oleksiak,1992-12-21,D,L,2016-17,41,5,2,7,0.17,-4,33,15.15,37,39878.0,16:12,0,0,0,0.0,51,53,13,27,-14,0,0,0,302.0,0:7,0,1,1,3022.0,1:13,918750
8476468,J.T.,Miller,1993-03-14,C,L,2016-17,82,22,34,56,0.68,17,132,16.67,21,80523.0,16:21,157,200,357,43.98,101,56,49,51,-2,2,5,7,7142.0,1:27,3,1,4,6189.0,1:15,2750000
8476469,Joel,Armia,1993-05-31,RW,R,2016-17,57,10,9,19,0.33,-8,111,9.01,20,51769.0,15:8,3,4,7,42.86,68,30,42,19,23,0,2,2,3006.0,0:52,4,0,4,6297.0,1:50,925000
8476470,Nathan,Beaulieu,1992-12-05,D,L,2016-17,74,4,24,28,0.38,8,118,3.39,44,86490.0,19:28,0,0,0,0.0,65,102,16,71,-55,2,10,12,7349.0,1:39,0,0,0,4317.0,0:58,1000000
8476471,Mark,McNeill,1993-02-22,C,R,2016-17,1,0,0,0,0.0,-1,1,0.0,0,829.0,13:49,0,2,2,0.0,0,1,0,1,-1,0,0,0,0.0,0:0,0,0,0,0.0,0:0,600000
8476472,Oscar,Klefbom,1993-07-20,D,L,2016-17,82,12,26,38,0.46,7,201,5.97,6,110061.0,22:22,0,0,0,0.0,43,146,29,67,-38,3,13,16,12422.0,2:31,0,1,1,8250.0,1:40,4167000
8476473,Connor,Murphy,1993-03-26,D,R,2016-17,77,2,15,17,0.22,-13,81,2.47,45,88604.0,19:10,0,0,0,0.0,201,119,13,31,-18,0,0,0,1238.0,0:16,1,0,1,8526.0,1:50,3850000
8476474,Stefan,Noesen,1993-02-12,RW,R,2016-17,44,8,2,10,0.23,6,63,12.7,24,29371.0,11:7,26,41,67,38.81,50,10,11,11,0,0,0,0,418.0,0:9,0,0,0,1000.0,0:22,600000
8476476,Joe,Morrow,1992-12-09,D,L,2016-17,17,0,1,1,0.06,-4,19,0.0,8,15836.0,15:31,0,0,0,0.0,29,19,1,7,-6,0,0,0,42.0,0:2,0,0,0,827.0,0:48,800000
8476477,Matt,Puempel,1993-01-24,LW,L,2016-17,40,6,3,9,0.22,-11,44,13.64,11,23145.0,9:38,0,1,1,0.0,28,12,8,6,2,3,0,3,1640.0,0:41,0,0,0,0.0,0:0,900000
8476479,Phillip,Danault,1993-02-24,C,L,2016-17,82,13,27,40,0.49,5,133,9.77,35,76662.0,15:34,533,498,1031,51.7,76,52,49,36,13,0,2,2,3056.0,0:37,0,1,1,5491.0,1:6,912500
8476480,Vladislav,Namestnikov,1992-11-22,C,L,2016-17,74,10,18,28,0.38,-4,114,8.77,31,65645.0,14:47,209,271,480,43.54,72,31,14,26,-12,3,3,6,9284.0,2:5,0,1,1,1322.0,0:17,1937500
8476482,Nicklas,Jensen,1993-03-06,RW,L,2016-17,7,0,0,0,0.0,-2,8,0.0,0,3874.0,9:13,0,0,0,0.0,7,2,2,1,1,0,0,0,425.0,1:0,0,0,0,0.0,0:0,600000
8476483,Rickard,Rakell,1993-05-05,C,R,2016-17,71,33,18,51,0.72,10,177,18.64,12,74065.0,17:23,62,85,147,42.18,81,32,23,37,-14,5,7,12,9652.0,2:15,0,0,0,37.0,0:0,3853672
8476495,Seth,Griffith,1993-01-04,C,R,2016-17,24,0,5,5,0.21,6,21,0.0,8,18337.0,12:44,2,6,8,25.0,30,5,5,6,-1,0,1,1,1927.0,1:20,0,0,0,1.0,0:0,625000
8476511,Samuel,Henley,1993-07-25,C,L,2016-17,1,1,0,1,1.0,1,1,100.0,2,318.0,5:18,0,1,1,0.0,2,0,0,0,0,0,0,0,0.0,0:0,0,0,0,12.0,0:12,586666
8476525,Colin,Miller,1992-10-29,D,R,2016-17,61,6,7,13,0.21,0,85,7.06,55,57886.0,15:48,0,0,0,0.0,85,36,19,30,-11,1,1,2,5974.0,1:37,0,0,0,961.0,0:15,1000000
8476526,Ben,Thomson,1993-01-16,LW,L,2016-17,3,0,0,0,0.0,-4,7,0.0,4,1960.0,10:53,0,1,1,0.0,7,1,0,1,-1,0,0,0,2.0,0:0,0,0,0,0.0,0:0,626667
8476539,Jonathan,Marchessault,1990-12-27,C,R,2016-17,75,30,21,51,0.68,-21,193,15.54,38,76099.0,16:54,122,148,270,45.19,105,17,64,46,18,8,10,18,12143.0,2:41,0,0,0,213.0,0:2,750000
8476545,Kurtis,Gabriel,1993-04-20,RW,R,2016-17,13,0,1,1,0.08,0,3,0.0,29,4539.0,5:49,0,0,0,0.0,26,1,0,3,-3,0,0,0,0.0,0:0,0,0,0,0.0,0:0,666667
8476619,Zack,Mitchell,1993-01-07,RW,R,2016-17,11,0,0,0,0.0,-1,10,0.0,0,5561.0,8:25,11,8,19,57.89,14,3,2,1,1,0,0,0,37.0,0:3,0,0,0,0.0,0:0,615000
8476624,Barclay,Goodrow,1993-02-26,RW,L,2016-17,3,0,1,1,0.33,0,3,0.0,0,2035.0,11:18,0,0,0,0.0,3,1,1,1,0,0,0,0,5.0,0:1,0,0,0,73.0,0:24,626667
8476766,Cole,Schneider,1990-08-26,LW,L,2016-17,4,0,1,1,0.25,2,6,0.0,0,1714.0,7:8,0,0,0,0.0,3,2,0,0,0,0,0,0,0.0,0:0,0,0,0,0.0,0:0,600000
8476769,Bobby,Farnham,1989-01-21,RW,L,2016-17,3,0,0,0,0.0,0,4,0.0,17,1489.0,8:16,1,0,1,100.0,8,2,0,0,0,0,0,0,0.0,0:0,0,0,0,0.0,0:0,575000
8476779,Brad,Hunt,1988-08-24,D,L,2016-17,12,1,5,6,0.5,-1,14,7.14,2,10441.0,14:30,0,0,0,0.0,0,3,4,3,1,1,1,2,442.0,0:36,0,0,0,178.0,0:14,600000
8476792,Torey,Krug,1991-04-12,D,L,2016-17,81,8,43,51,0.63,-10,208,3.85,37,104979.0,21:36,0,1,1,0.0,59,82,22,60,-38,6,19,25,15877.0,3:16,0,0,0,1842.0,0:22,5250000
8476798,Karl,Stollery,1987-11-21,D,L,2016-17,11,0,3,3,0.27,-5,11,0.0,13,11166.0,16:55,0,0,0,0.0,26,16,3,6,-3,0,3,3,1653.0,2:30,0,0,0,50.0,0:4,575000
8476805,Spencer,Abbott,1988-04-30,LW,R,2016-17,1,0,0,0,0.0,0,1,0.0,0,514.0,8:34,0,0,0,0.0,0,0,1,0,1,0,0,0,0.0,0:0,0,0,0,0.0,0:0,575000
8476806,J.T.,Brown,1990-07-02,RW,R,2016-17,64,3,3,6,0.09,-7,67,4.48,73,39824.0,10:22,12,26,38,31.58,103,25,8,11,-3,0,0,0,396.0,0:6,1,0,1,3992.0,1:2,1250000
8476807,Matt,Tennyson,1990-04-23,D,R,2016-17,45,0,6,6,0.13,-13,36,0.0,6,35874.0,13:17,0,0,0,0.0,65,48,11,11,0,0,0,0,121.0,0:2,0,0,0,829.0,0:18,675000
8476808,Brian,Flynn,1988-07-26,C,R,2016-17,51,6,4,10,0.2,2,47,12.77,4,36921.0,12:3,69,80,149,46.31,20,29,13,15,-2,0,0,0,145.0,0:2,0,0,0,4596.0,1:30,950000
8476822,Luke,Glendening,1989-04-28,RW,R,2016-17,74,3,11,14,0.19,-10,76,3.95,26,57343.0,12:54,307,261,568,54.05,150,62,19,12,7,0,1,1,391.0,0:5,0,0,0,10077.0,2:16,628333
8476826,Yanni,Gourde,1991-12-15,C,L,2016-17,20,6,2,8,0.4,-1,30,20.0,8,18441.0,15:22,60,103,163,36.81,11,3,12,4,8,0,0,0,1005.0,0:50,1,0,1,1671.0,1:23,575000
8476850,Ryan,Murray,1993-09-27,D,L,2016-17,60,2,9,11,0.18,3,52,3.85,24,65999.0,18:19,0,0,0,0.0,23,96,8,18,-10,0,1,1,1602.0,0:26,0,1,1,6747.0,1:52,2825000
8476851,Alex,Galchenyuk,1994-02-12,LW,L,2016-17,61,17,27,44,0.72,-5,104,16.35,24,58303.0,15:55,274,368,642,42.68,36,32,17,34,-17,6,9,15,8337.0,2:16,0,0,0,132.0,0:2,2800000
8476853,Morgan,Rielly,1994-03-09,D,L,2016-17,76,6,21,27,0.36,-20,171,3.51,21,101089.0,22:10,0,0,0,0.0,46,120,34,76,-42,1,4,5,4418.0,0:58,0,0,0,10811.0,2:22,5000000
8476854,Hampus,Lindholm,1994-01-20,D,L,2016-17,66,6,14,20,0.3,13,94,6.38,36,88900.0,22:26,2,0,2,100.0,98,94,18,63,-45,1,4,5,7405.0,1:52,0,0,0,9616.0,2:25,5713415
8476855,Nail,Yakupov,1993-10-06,RW,L,2016-17,40,3,6,9,0.22,-3,35,8.57,14,25553.0,10:38,0,0,0,0.0,32,8,11,3,8,0,0,0,675.0,0:16,0,0,0,10.0,0:0,2500000
8476856,Matt,Dumba,1994-07-25,D,R,2016-17,76,11,23,34,0.45,15,131,8.4,59,92686.0,20:19,0,0,0,0.0,96,71,18,43,-25,6,6,12,10377.0,2:16,0,1,1,2785.0,0:36,2550000
8476857,Pontus,Aberg,1993-09-23,LW,R,2016-17,15,1,1,2,0.13,-2,12,8.33,4,11102.0,12:20,1,0,1,100.0,9,2,5,2,3,0,0,0,233.0,0:15,0,0,0,6.0,0:0,780833
8476858,Phillip,Di Giuseppe,1993-10-09,LW,L,2016-17,36,1,6,7,0.19,-12,68,1.47,15,26559.0,12:17,0,2,2,0.0,91,10,12,13,-1,0,1,1,1044.0,0:29,0,0,0,53.0,0:1,817500
8476866,Nicolas,Kerdiles,1994-01-11,LW,L,2016-17,1,0,0,0,0.0,1,0,,0,668.0,11:8,1,0,1,100.0,0,2,0,2,-2,0,0,0,0.0,0:0,0,0,0,0.0,0:0,925000
8476867,Brendan,Gaunce,1994-03-25,C,L,2016-17,57,0,5,5,0.09,-2,51,0.0,33,32460.0,9:29,84,80,164,51.22,94,12,11,6,5,0,0,0,228.0,0:4,0,0,0,1640.0,0:28,863333
8476869,Brady,Skjei,1994-03-26,D,L,2016-17,80,5,34,39,0.49,11,127,3.94,42,83821.0,17:27,0,1,1,0.0,147,69,17,51,-34,0,7,7,6652.0,1:23,0,0,0,1411.0,0:17,925000
8476871,Tanner,Pearson,1992-08-10,LW,L,2016-17,80,24,20,44,0.55,5,187,12.83,13,78336.0,16:19,10,14,24,41.67,124,31,25,20,5,3,5,8,11557.0,2:24,1,1,2,5229.0,1:5,1400000
8476872,Scott,Laughton,1994-05-30,C,L,2016-17,2,0,0,0,0.0,0,4,0.0,0,1229.0,10:14,11,9,20,55.0,3,0,1,0,1,0,0,0,0.0,0:0,0,0,0,0.0,0:0,863333
8476873,Mark,Jankowski,1994-09-13,C,L,2016-17,1,0,0,0,0.0,0,0,,0,618.0,10:18,5,3,8,62.5,1,0,1,0,1,0,0,0,0.0,0:0,0,0,0,0.0,0:0,925000
8476874,Olli,Maatta,1994-08-22,D,L,2016-17,55,1,6,7,0.13,17,66,1.52,12,59611.0,18:3,0,0,0,0.0,72,102,11,30,-19,0,0,0,421.0,0:7,0,0,0,7634.0,2:18,4083333
8476875,Mike,Matheson,1994-02-27,D,L,2016-17,81,7,10,17,0.21,-5,179,3.91,36,102317.0,21:3,1,0,1,100.0,69,118,48,65,-17,0,1,1,2465.0,0:30,0,1,1,12621.0,2:35,925000
8476877,Jordan,Schmaltz,1993-10-08,D,R,2016-17,9,0,2,2,0.22,0,5,0.0,4,7744.0,14:20,0,0,0,0.0,4,10,1,2,-1,0,1,1,648.0,1:12,0,0,0,60.0,0:6,925000
8476878,Zemgus,Girgensons,1994-01-05,C,L,2016-17,75,7,9,16,0.21,-7,112,6.25,18,59218.0,13:9,273,306,579,47.15,120,26,17,16,1,0,0,0,315.0,0:4,0,0,0,5188.0,1:9,1150000
8476879,Cody,Ceci,1993-12-21,D,R,2016-17,79,2,15,17,0.22,-11,143,1.4,20,109992.0,23:12,1,0,1,100.0,111,159,22,74,-52,0,1,1,4463.0,0:56,0,2,2,14312.0,3:1,2800000
8476880,Tom,Wilson,1994-03-29,RW,R,2016-17,82,7,12,19,0.23,9,95,7.37,133,63592.0,12:55,3,7,10,30.0,239,44,36,21,15,0,0,0,230.0,0:2,0,0,0,10173.0,2:4,2000000
8476881,Tomas,Hertl,1993-11-12,C,L,2016-17,49,10,12,22,0.45,-8,100,10.0,14,50638.0,17:13,245,229,474,51.69,76,42,30,18,12,1,1,2,5475.0,1:51,0,0,0,3574.0,1:12,3000000
8476882,Teuvo,Teravainen,1994-09-11,LW,L,2016-17,81,15,27,42,0.52,-6,169,8.88,16,78927.0,16:14,193,220,413,46.73,27,33,51,67,-16,5,10,15,10866.0,2:14,0,0,0,77.0,0:0,894167
8476884,Derrick,Pouliot,1994-01-16,D,L,2016-17,11,0,0,0,0.0,-4,11,0.0,4,9824.0,14:53,0,0,0,0.0,14,8,3,6,-3,0,0,0,647.0,0:58,0,0,0,731.0,1:6,863333
8476885,Jacob,Trouba,1994-02-26,D,R,2016-17,60,8,25,33,0.55,4,154,5.19,54,89868.0,24:57,0,0,0,0.0,107,118,36,62,-26,2,2,4,6024.0,1:40,0,1,1,10784.0,2:59,3308824
8476886,Slater,Koekkoek,1994-02-18,D,L,2016-17,29,0,4,4,0.14,-4,27,0.0,8,22592.0,12:59,0,0,0,0.0,25,27,1,7,-6,0,0,0,180.0,0:6,0,0,0,658.0,0:22,894167
8476887,Filip,Forsberg,1994-08-13,LW,R,2016-17,82,31,27,58,0.71,-4,234,13.25,32,91109.0,18:31,5,13,18,27.78,97,26,76,62,14,3,6,9,12882.0,2:37,3,0,3,7143.0,1:27,6000000
8476888,Mikhail,Grigorenko,1994-05-16,C,L,2016-17,75,10,13,23,0.31,-14,85,11.76,18,63401.0,14:5,111,81,192,57.81,27,26,35,26,9,0,4,4,7973.0,1:46,0,0,0,4942.0,1:5,1300000
8476889,Radek,Faksa,1994-01-09,C,L,2016-17,80,12,21,33,0.41,-6,132,9.09,67,77628.0,16:10,590,632,1222,48.28,101,62,43,36,7,0,2,2,2592.0,0:32,0,0,0,9414.0,1:57,863333
8476891,Matt,Grzelcyk,1994-01-05,D,L,2016-17,2,0,0,0,0.0,0,4,0.0,2,1498.0,12:29,0,0,0,0.0,0,1,0,0,0,0,0,0,200.0,1:40,0,0,0,0.0,0:0,858750
8476892,Colton,Parayko,1993-05-12,D,R,2016-17,81,4,31,35,0.43,7,188,2.13,32,103018.0,21:11,0,0,0,0.0,80,117,38,39,-1,4,6,10,8508.0,1:45,0,1,1,10262.0,2:6,858750
8476897,Oskar,Sundqvist,1994-03-23,C,R,2016-17,10,0,0,0,0.0,-4,9,0.0,2,5504.0,9:10,16,28,44,36.36,13,2,1,2,-1,0,0,0,5.0,0:0,0,0,0,297.0,0:29,700833
8476902,Esa,Lindell,1994-05-23,D,L,2016-17,73,6,12,18,0.25,8,99,6.06,22,95795.0,21:52,0,1,1,0.0,93,119,34,47,-13,0,2,2,4563.0,1:2,0,0,0,8879.0,2:1,745833
8476905,Chandler,Stephenson,1994-04-22,C,L,2016-17,4,0,0,0,0.0,0,3,0.0,0,2131.0,8:52,12,13,25,48.0,0,0,1,0,1,0,0,0,6.0,0:1,0,0,0,57.0,0:14,725833
8476906,Shayne,Gostisbehere,1993-04-20,D,L,2016-17,76,7,32,39,0.51,-21,198,3.54,32,89350.0,19:35,0,0,0,0.0,43,94,18,70,-52,2,21,23,17458.0,3:49,0,0,0,328.0,0:4,925000
8476911,Tanner,Richard,1993-04-06,C,L,2016-17,3,0,0,0,0.0,-2,1,0.0,2,2287.0,12:42,13,17,30,43.33,6,2,2,1,1,0,0,0,303.0,1:41,0,0,0,0.0,0:0,575000
8476913,Devin,Shore,1994-07-19,C,L,2016-17,82,13,20,33,0.4,-4,115,11.3,14,69547.0,14:8,221,249,470,47.02,44,71,26,25,1,1,5,6,9061.0,1:50,0,0,0,741.0,0:9,870000
8476915,Jujhar,Khaira,1994-08-13,LW,L,2016-17,10,1,0,1,0.1,1,10,10.0,2,5554.0,9:15,7,12,19,36.84,20,5,1,2,-1,0,0,0,59.0,0:5,0,0,0,14.0,0:1,875000
8476917,Adam,Pelech,1994-08-16,D,L,2016-17,44,3,7,10,0.23,-5,40,7.5,6,44442.0,16:50,0,0,0,0.0,73,68,17,28,-11,0,0,0,89.0,0:2,0,0,0,2580.0,0:58,854333
8476918,Jimmy,Vesey,1993-05-26,LW,L,2016-17,80,16,11,27,0.34,-13,116,13.79,26,65442.0,13:38,2,5,7,28.57,64,37,44,34,10,5,3,8,7428.0,1:32,0,0,0,48.0,0:0,925000
8476919,Chris,Tierney,1994-07-01,C,L,2016-17,80,11,12,23,0.29,0,90,12.22,6,70098.0,14:36,401,425,826,48.55,50,44,41,59,-18,1,0,1,1313.0,0:16,1,1,2,8592.0,1:47,711667
8476921,Jordan,Martinook,1992-07-25,LW,L,2016-17,77,11,14,25,0.32,-8,109,10.09,40,72438.0,15:40,460,577,1037,44.36,50,68,40,21,19,1,1,2,1748.0,0:22,1,2,3,10319.0,2:14,612500
8476922,Boo,Nieves,1994-01-23,C,L,2016-17,1,0,0,0,0.0,-1,0,,0,704.0,11:44,3,7,10,30.0,0,1,0,0,0,0,0,0,5.0,0:5,0,0,0,0.0,0:0,-111
8476923,Damon,Severson,1994-08-07,D,R,2016-17,80,3,28,31,0.39,-31,125,2.4,58,97691.0,20:21,0,0,0,0.0,79,73,24,54,-30,0,13,13,10887.0,2:16,0,0,0,1514.0,0:18,605833
8476924,Martin,Frk,1993-10-05,RW,R,2016-17,2,0,0,0,0.0,-3,1,0.0,0,1000.0,8:20,0,0,0,0.0,3,1,0,1,-1,0,0,0,0.0,0:0,0,0,0,0.0,0:0,639167
8476925,Colton,Sissons,1993-11-05,C,R,2016-17,58,8,2,10,0.17,11,42,19.05,12,38708.0,11:7,192,192,384,50.0,104,24,12,11,1,0,0,0,242.0,0:4,1,0,1,3189.0,0:54,625000
8476931,Jake,McCabe,1993-10-12,D,L,2016-17,76,3,17,20,0.26,-7,79,3.8,26,94415.0,20:42,0,0,0,0.0,73,114,29,46,-17,1,3,4,4794.0,1:3,0,0,0,7470.0,1:38,1600000
8476934,Brock,McGinn,1994-02-02,LW,L,2016-17,57,7,9,16,0.28,-11,74,9.46,6,41031.0,11:59,1,3,4,25.0,91,22,29,14,15,0,0,0,232.0,0:4,0,1,1,2691.0,0:47,811667
8476941,Connor,Carrick,1994-04-13,D,R,2016-17,67,2,6,8,0.12,8,89,2.25,51,65671.0,16:20,0,0,0,0.0,66,79,14,46,-32,1,0,1,2240.0,0:33,0,0,0,1120.0,0:16,750000
8476948,Charles,Hudon,1994-06-23,LW,L,2016-17,3,0,2,2,0.67,1,3,0.0,2,2147.0,11:55,0,0,0,0.0,11,0,3,2,1,0,0,0,73.0,0:24,0,0,0,0.0,0:0,625000
8476955,Taylor,Leier,1994-02-15,LW,L,2016-17,10,1,1,2,0.2,-1,7,14.29,4,5436.0,9:3,0,1,1,0.0,7,0,2,0,2,0,0,0,10.0,0:1,0,0,0,194.0,0:19,779617
8476958,Jaccob,Slavin,1994-05-01,D,L,2016-17,82,5,29,34,0.41,23,99,5.05,12,115316.0,23:26,0,0,0,0.0,35,161,83,54,29,0,4,4,4557.0,0:55,1,3,4,15349.0,3:7,742500
8476960,Andreas,Athanasiou,1994-08-06,LW,L,2016-17,64,18,11,29,0.45,-7,120,15.0,28,51703.0,13:27,37,46,83,44.58,30,21,17,19,-2,1,3,4,4654.0,1:12,0,0,0,1989.0,0:31,628333
8476966,Gemel,Smith,1994-04-16,C,L,2016-17,17,3,3,6,0.35,-1,19,15.79,21,13857.0,13:35,25,34,59,42.37,6,6,4,6,-2,0,0,0,69.0,0:4,1,0,1,1305.0,1:16,645000
8476967,Brett,Kulak,1994-01-06,D,L,2016-17,21,0,3,3,0.14,-3,19,0.0,12,17945.0,14:14,0,0,0,0.0,14,13,4,10,-6,0,0,0,362.0,0:17,0,0,0,133.0,0:6,656667
8476975,Cedric,Paquette,1993-08-13,C,L,2016-17,58,4,6,10,0.17,-6,68,5.88,80,40102.0,11:31,200,234,434,46.08,144,46,17,8,9,0,0,0,263.0,0:4,0,0,0,5087.0,1:27,812500
8476981,Josh,Anderson,1994-05-07,RW,R,2016-17,78,17,12,29,0.37,12,119,14.29,89,56253.0,12:1,8,21,29,27.59,147,40,25,16,9,0,0,0,366.0,0:4,0,0,0,883.0,0:11,678333
8476982,Danny,O'Regan,1994-01-30,C,R,2016-17,3,1,0,1,0.33,-2,5,20.0,0,2079.0,11:33,15,17,32,46.88,1,2,2,0,2,1,0,1,69.0,0:23,0,0,0,37.0,0:12,858750
8476983,Paul,LaDue,1992-09-06,D,R,2016-17,22,0,8,8,0.36,-5,27,0.0,4,20335.0,15:24,0,0,0,0.0,17,13,3,12,-9,0,4,4,1985.0,1:30,0,0,0,200.0,0:9,925000
8476988,Matt,Benning,1994-05-25,D,R,2016-17,62,3,12,15,0.24,8,69,4.35,29,61791.0,16:36,0,0,0,0.0,111,64,7,49,-42,1,2,3,1556.0,0:25,0,0,0,2586.0,0:41,925000
8476989,Petteri,Lindbohm,1993-09-23,D,L,2016-17,7,0,0,0,0.0,-4,10,0.0,4,5453.0,12:59,0,0,0,0.0,10,5,1,1,0,0,0,0,2.0,0:0,0,0,0,73.0,0:10,636667
8476994,Vinnie,Hinostroza,1994-04-03,LW,R,2016-17,49,6,8,14,0.29,-1,76,7.89,17,35216.0,11:58,68,103,171,39.77,31,19,27,15,12,0,0,0,939.0,0:19,0,0,0,0.0,0:0,717500
8477003,Riley,Barber,1994-02-07,RW,R,2016-17,3,0,0,0,0.0,0,2,0.0,0,1544.0,8:34,0,0,0,0.0,1,0,0,0,0,0,0,0,0.0,0:0,0,0,0,0.0,0:0,692500
8477006,Christoph,Bertschy,1994-04-05,C,R,2016-17,5,0,1,1,0.2,0,5,0.0,4,2440.0,8:8,0,0,0,0.0,7,3,0,0,0,0,0,0,0.0,0:0,0,0,0,0.0,0:0,775833
8477009,Jake,Dotchin,1994-03-24,D,R,2016-17,35,0,11,11,0.31,10,50,0.0,35,38701.0,18:25,0,0,0,0.0,85,19,4,23,-19,0,0,0,1950.0,0:55,0,0,0,306.0,0:8,616667
8477010,Joseph,Blandisi,1994-07-18,LW,L,2016-17,27,3,6,9,0.33,-10,24,12.5,26,21643.0,13:21,76,93,169,44.97,37,6,7,4,3,1,4,5,2709.0,1:40,0,0,0,33.0,0:1,648333
8477015,Connor,Brown,1994-01-14,RW,R,2016-17,82,20,16,36,0.44,3,139,14.39,10,79733.0,16:12,2,6,8,25.0,50,46,40,25,15,2,4,6,6060.0,1:13,1,0,1,9819.0,1:59,686667
8477018,Ben,Hutton,1993-04-20,D,L,2016-17,71,5,14,19,0.27,-22,130,3.85,31,87317.0,20:29,0,0,0,0.0,46,106,31,50,-19,2,9,11,8766.0,2:3,0,0,0,2297.0,0:32,896250
8477034,Jaycob,Megna,1992-12-10,D,L,2016-17,1,0,0,0,0.0,1,0,,0,920.0,15:20,0,0,0,0.0,0,0,0,0,0,0,0,0,0.0,0:0,0,0,0,59.0,0:59,786667
8477041,Brady,Austin,1993-06-16,D,L,2016-17,5,0,0,0,0.0,0,8,0.0,4,4827.0,16:5,0,0,0,0.0,6,0,1,2,-1,0,0,0,0.0,0:0,0,0,0,182.0,0:36,626666
8477070,Liam,O'Brien,1994-07-29,C,L,2016-17,1,0,0,0,0.0,0,0,,0,368.0,6:8,0,0,0,0.0,1,0,0,1,-1,0,0,0,0.0,0:0,0,0,0,0.0,0:0,621667
8477091,Evan,McEneny,1994-05-22,D,L,2016-17,1,0,0,0,0.0,-1,1,0.0,0,908.0,15:8,0,0,0,0.0,0,0,0,0,0,0,0,0,0.0,0:0,0,0,0,0.0,0:0,585000
8477126,Jayson,Megna,1990-02-01,C,R,2016-17,58,4,4,8,0.14,-4,72,5.56,6,43271.0,12:26,2,14,16,12.5,87,23,20,8,12,0,1,1,3219.0,0:55,0,0,0,157.0,0:2,600000
8477205,Andrej,Sustr,1990-11-29,D,R,2016-17,80,3,11,14,0.18,-10,93,3.23,43,84427.0,17:35,0,1,1,0.0,45,102,18,49,-31,0,0,0,431.0,0:5,0,0,0,10012.0,2:5,1450000
8477210,Buddy,Robinson,1991-09-30,RW,R,2016-17,4,0,0,0,0.0,0,4,0.0,2,1667.0,6:56,0,0,0,0.0,9,0,1,1,0,0,0,0,0.0,0:0,0,0,0,0.0,0:0,750000
8477213,Tim,Schaller,1990-11-16,C,L,2016-17,59,7,7,14,0.24,-6,89,7.87,23,43436.0,12:16,28,29,57,49.12,73,38,19,18,1,0,0,0,1565.0,0:26,0,0,0,3986.0,1:7,600000
8477215,Danny,DeKeyser,1990-03-07,D,L,2016-17,82,4,8,12,0.15,-22,85,4.71,33,107976.0,21:56,0,0,0,0.0,100,170,16,45,-29,0,0,0,2770.0,0:33,0,0,0,13122.0,2:40,5000000
8477220,Nate,Schmidt,1991-07-16,D,L,2016-17,60,3,14,17,0.28,22,60,5.0,16,55723.0,15:28,0,0,0,0.0,51,37,36,44,-8,0,0,0,572.0,0:9,0,1,1,2561.0,0:42,812500
8477240,Carter,Rowney,1989-05-10,RW,R,2016-17,27,3,4,7,0.26,2,24,12.5,4,17773.0,10:58,95,103,198,47.98,64,15,11,5,6,0,0,0,4.0,0:0,0,0,0,1703.0,1:3,612500
8477244,Chad,Ruhwedel,1990-05-07,D,R,2016-17,34,2,8,10,0.29,9,45,4.44,8,35366.0,17:20,0,0,0,0.0,36,26,9,12,-3,0,3,3,1927.0,0:56,0,0,0,2308.0,1:7,575000
8477290,Michael,Raffl,1988-12-01,LW,L,2016-17,52,8,3,11,0.21,-7,63,12.7,20,41378.0,13:15,3,7,10,30.0,91,22,13,17,-4,0,0,0,332.0,0:6,0,0,0,83.0,0:1,2350000
8477320,Anton,Blidh,1995-03-14,LW,L,2016-17,19,1,1,2,0.11,-2,26,3.85,7,10006.0,8:46,0,0,0,0.0,41,4,4,4,0,0,0,0,30.0,0:1,0,0,0,299.0,0:15,784167
8477326,Joel,Vermin,1992-02-05,RW,L,2016-17,18,0,3,3,0.17,2,12,0.0,4,11801.0,10:55,2,1,3,66.67,17,7,5,2,3,0,0,0,122.0,0:6,0,0,0,897.0,0:49,575000
8477346,MacKenzie,Weegar,1994-01-07,D,R,2016-17,3,0,0,0,0.0,0,3,0.0,4,3140.0,17:26,0,0,0,0.0,4,1,1,0,1,0,0,0,345.0,1:55,0,0,0,0.0,0:0,680000
8477353,Tyler,Motte,1995-03-10,C,L,2016-17,33,4,3,7,0.21,2,46,8.7,14,22546.0,11:23,4,6,10,40.0,27,24,13,4,9,0,0,0,179.0,0:5,0,0,0,2206.0,1:6,925000
8477380,Jonny,Brodzinski,1993-06-19,C,L,2016-17,6,0,2,2,0.33,2,17,0.0,2,4423.0,12:17,0,0,0,0.0,10,4,2,1,1,0,0,0,112.0,0:18,0,0,0,3.0,0:0,808750
8477391,Sean,Malone,1995-04-30,C,L,2016-17,1,0,0,0,0.0,0,1,0.0,0,732.0,12:12,5,3,8,62.5,0,1,0,1,-1,0,0,0,50.0,0:50,0,0,0,0.0,0:0,883750
8477392,Hudson,Fasching,1995-07-28,RW,R,2016-17,10,0,1,1,0.1,-1,6,0.0,2,6245.0,10:24,0,0,0,0.0,17,2,1,1,0,0,0,0,130.0,0:13,0,0,0,323.0,0:32,925000
8477401,John,Hayden,1995-02-14,RW,R,2016-17,12,1,3,4,0.33,3,22,4.55,4,8413.0,11:41,0,0,0,0.0,44,2,5,2,3,0,0,0,188.0,0:15,0,0,0,0.0,0:0,925000
8477402,Pavel,Buchnevich,1995-04-17,RW,L,2016-17,41,8,12,20,0.49,6,55,14.55,13,32616.0,13:15,1,6,7,14.29,17,8,11,22,-11,1,2,3,4612.0,1:52,0,0,0,17.0,0:0,925000
8477404,Jake,Guentzel,1994-10-06,C,L,2016-17,40,16,17,33,0.82,7,81,19.75,10,38126.0,15:53,8,9,17,47.06,61,18,16,9,7,1,2,3,3293.0,1:22,0,0,0,15.0,0:0,734167
8477407,Anthony,Duclair,1995-08-26,LW,L,2016-17,58,5,10,15,0.26,-7,76,6.58,14,46282.0,13:17,4,4,8,50.0,22,17,30,22,8,0,2,2,4355.0,1:15,0,0,0,16.0,0:0,772500
8477413,Sven,Andrighetto,1993-03-21,RW,L,2016-17,46,7,17,24,0.52,1,68,10.29,12,38550.0,13:58,7,3,10,70.0,40,22,19,9,10,2,2,4,3070.0,1:6,0,0,0,43.0,0:0,650000
8477415,Anton,Slepyshev,1994-05-13,LW,R,2016-17,41,4,6,10,0.24,5,55,7.27,4,27342.0,11:6,2,3,5,40.0,64,15,19,14,5,0,0,0,262.0,0:6,0,0,0,29.0,0:0,925000
8477416,Oliver,Bjorkstrand,1995-04-10,RW,R,2016-17,26,6,7,13,0.5,4,55,10.91,6,21980.0,14:5,1,0,1,100.0,14,9,8,8,0,0,0,0,2646.0,1:41,0,0,0,4.0,0:0,655833
8477417,Peter,Cehlarik,1995-08-02,LW,L,2016-17,11,0,2,2,0.18,0,8,0.0,0,9183.0,13:54,2,1,3,66.67,7,4,8,10,-2,0,1,1,916.0,1:23,0,0,0,0.0,0:0,742500
8477425,Miles,Wood,1995-09-13,LW,L,2016-17,60,8,9,17,0.28,-21,105,7.62,86,46269.0,12:51,1,1,2,50.0,68,26,16,14,2,2,2,4,5191.0,1:26,0,0,0,65.0,0:1,925000
8477426,Nick,Paul,1995-03-20,LW,L,2016-17,1,0,0,0,0.0,-2,4,0.0,0,989.0,16:29,5,8,13,38.46,3,0,1,0,1,0,0,0,46.0,0:46,0,0,0,0.0,0:0,670000
8477429,Andrew,Copp,1994-07-08,C,L,2016-17,64,9,8,17,0.27,8,77,11.69,18,47398.0,12:20,95,97,192,49.48,87,28,20,16,4,0,0,0,552.0,0:8,1,0,1,5577.0,1:27,925000
8477433,Ben,Harpur,1995-01-12,D,L,2016-17,6,0,0,0,0.0,-1,3,0.0,0,6409.0,17:48,0,0,0,0.0,5,3,2,5,-3,0,0,0,155.0,0:25,0,0,0,101.0,0:16,653333
8477444,Andre,Burakovsky,1995-02-09,LW,L,2016-17,64,12,23,35,0.55,13,111,10.81,14,50931.0,13:15,2,5,7,28.57,31,25,33,33,0,2,3,5,5602.0,1:27,0,0,0,14.0,0:0,894167
8477445,Hunter,Shinkaruk,1994-10-13,C,L,2016-17,7,0,1,1,0.14,-3,5,0.0,2,4445.0,10:35,0,0,0,0.0,3,3,2,1,1,0,0,0,23.0,0:3,0,0,0,0.0,0:0,863333
8477446,Michael,McCarron,1995-03-07,RW,R,2016-17,31,1,4,5,0.16,-4,31,3.23,41,18393.0,9:53,76,99,175,43.43,75,11,7,6,1,0,0,0,809.0,0:26,0,0,0,18.0,0:0,863333
8477447,Shea,Theodore,1995-08-03,D,L,2016-17,34,2,7,9,0.26,-6,60,3.33,28,35319.0,17:18,0,0,0,0.0,14,30,4,30,-26,1,1,2,4437.0,2:10,0,1,1,1591.0,0:46,863333
8477448,Marko,Dano,1994-11-30,C,L,2016-17,38,4,7,11,0.29,0,44,9.09,10,24361.0,10:41,1,3,4,25.0,83,14,18,10,8,2,0,2,3099.0,1:21,0,0,0,76.0,0:2,925000
8477450,Jason,Dickinson,1995-07-04,C,L,2016-17,10,2,0,2,0.2,-3,9,22.22,0,7074.0,11:47,4,9,13,30.77,8,4,3,0,3,0,0,0,3.0,0:0,0,0,0,46.0,0:4,894167
8477451,Ryan,Hartman,1994-09-20,RW,R,2016-17,76,19,12,31,0.41,13,170,11.18,70,58218.0,12:46,25,37,62,40.32,121,30,36,31,5,1,0,1,2372.0,0:31,0,0,0,413.0,0:5,863333
8477452,Ian,McCoshen,1995-08-05,D,L,2016-17,3,0,1,1,0.33,0,0,,0,2386.0,13:15,0,0,0,0.0,3,2,0,0,0,0,0,0,0.0,0:0,0,0,0,0.0,0:0,925000
8477454,Adam,Erne,1995-04-20,LW,L,2016-17,26,3,0,3,0.12,-9,40,7.5,11,18419.0,11:48,0,2,2,0.0,71,13,2,5,-3,0,0,0,1598.0,1:1,0,0,0,0.0,0:0,874167
8477455,Jacob,de la Rose,1995-05-20,LW,L,2016-17,9,0,0,0,0.0,-3,4,0.0,4,5890.0,10:54,17,17,34,50.0,23,5,4,0,4,0,0,0,7.0,0:0,0,0,0,1141.0,2:6,925000
8477456,J.T.,Compher,1995-04-08,LW,R,2016-17,21,3,2,5,0.24,0,30,10.0,4,18811.0,14:55,78,86,164,47.56,11,21,6,8,-2,1,0,1,2340.0,1:51,0,0,0,1062.0,0:50,925000
8477458,Valentin,Zykov,1995-05-15,LW,R,2016-17,2,1,0,1,0.5,1,3,33.33,0,750.0,6:15,0,0,0,0.0,0,0,0,1,-1,0,0,0,132.0,1:6,0,0,0,0.0,0:0,705000
8477460,Laurent,Dauphin,1995-03-27,C,L,2016-17,24,2,1,3,0.12,-2,32,6.25,12,15710.0,10:54,37,45,82,45.12,32,11,9,3,6,0,0,0,40.0,0:1,1,0,1,2450.0,1:42,745000
8477461,Remi,Elie,1995-04-16,LW,L,2016-17,18,1,6,7,0.39,5,15,6.67,8,16875.0,15:37,1,0,1,100.0,30,11,12,13,-1,0,0,0,54.0,0:3,0,0,0,1137.0,1:3,728333
8477462,Robert,Hagg,1995-02-08,D,L,2016-17,1,0,0,0,0.0,0,5,0.0,0,1279.0,21:19,0,0,0,0.0,4,3,0,0,0,0,0,0,0.0,0:0,0,0,0,94.0,1:34,894167
8477463,Steven,Santini,1995-03-07,D,R,2016-17,38,2,5,7,0.18,-6,46,4.35,14,36670.0,16:5,0,0,0,0.0,83,35,1,11,-10,0,0,0,94.0,0:2,0,0,0,3136.0,1:22,925000
8477464,Nic,Petan,1995-03-22,LW,L,2016-17,54,1,12,13,0.24,-13,57,1.75,12,35316.0,10:54,145,170,315,46.03,12,10,16,18,-2,0,8,8,6896.0,2:7,0,0,0,236.0,0:4,758333
8477466,Nick,Sorensen,1994-10-23,RW,R,2016-17,5,0,1,1,0.2,-1,7,0.0,2,3267.0,10:53,1,0,1,100.0,2,3,0,0,0,0,0,0,291.0,0:58,0,0,0,23.0,0:4,803333
8477467,Gustav,Olofsson,1994-12-01,D,L,2016-17,13,0,3,3,0.23,-1,7,0.0,2,10516.0,13:28,0,0,0,0.0,10,16,3,1,2,0,1,1,504.0,0:38,0,0,0,47.0,0:3,795000
8477473,Justin,Bailey,1995-07-01,RW,R,2016-17,32,2,2,4,0.12,0,36,5.56,4,20414.0,10:37,0,1,1,0.0,27,14,8,10,-2,0,0,0,8.0,0:0,0,0,0,0.0,0:0,670000
8477476,Artturi,Lehkonen,1995-07-04,LW,L,2016-17,73,18,10,28,0.38,-1,158,11.39,8,60702.0,13:51,2,2,4,50.0,72,25,25,20,5,2,2,4,4042.0,0:55,1,0,1,1972.0,0:27,839166
8477478,William,Carrier,1994-12-20,LW,L,2016-17,41,5,3,8,0.2,-1,50,10.0,21,22142.0,9:0,1,1,2,50.0,112,10,8,10,-2,0,0,0,11.0,0:0,0,0,0,144.0,0:3,689167
8477479,Tyler,Bertuzzi,1995-02-24,LW,L,2016-17,7,0,0,0,0.0,-1,3,0.0,0,3825.0,9:6,1,1,2,50.0,12,0,1,3,-2,0,0,0,22.0,0:3,0,0,0,0.0,0:0,661667
8477482,Zach,Sanford,1994-11-09,LW,L,2016-17,39,4,4,8,0.21,2,36,11.11,10,25370.0,10:50,17,22,39,43.59,22,20,14,14,0,0,0,0,1220.0,0:31,0,0,0,593.0,0:15,875000
8477488,Brett,Pesce,1994-11-15,D,R,2016-17,82,2,18,20,0.24,23,109,1.83,20,104325.0,21:12,0,0,0,0.0,57,148,55,34,21,0,2,2,3044.0,0:37,0,0,0,10647.0,2:9,809167
8477491,Nicholas,Baptiste,1995-08-04,RW,R,2016-17,14,3,1,4,0.29,1,16,18.75,6,7761.0,9:14,1,2,3,33.33,12,1,1,1,0,0,0,0,482.0,0:34,0,0,0,14.0,0:1,718333
8477492,Nathan,MacKinnon,1995-09-01,C,R,2016-17,82,16,37,53,0.65,-14,251,6.37,16,98124.0,19:56,769,752,1521,50.56,56,30,47,45,2,2,12,14,13672.0,2:46,2,0,2,8589.0,1:44,6300000
8477493,Aleksander,Barkov,1995-09-02,C,L,2016-17,61,21,31,52,0.85,13,142,14.79,10,71010.0,19:24,476,547,1023,46.53,39,30,49,30,19,3,11,14,10649.0,2:54,0,0,0,4684.0,1:16,5900000
8477494,Jonathan,Drouin,1995-03-28,LW,L,2016-17,73,21,32,53,0.73,-13,183,11.48,16,77555.0,17:42,96,124,220,43.64,50,16,45,65,-20,9,17,26,13508.0,3:5,0,0,0,24.0,0:0,894167
8477495,Seth,Jones,1994-10-03,D,R,2016-17,75,12,30,42,0.56,6,152,7.89,24,105315.0,23:24,0,0,0,0.0,61,118,32,44,-12,1,6,7,7491.0,1:39,0,0,0,9544.0,2:7,5400000
8477496,Elias,Lindholm,1994-12-02,C,R,2016-17,72,11,34,45,0.62,-2,151,7.28,16,78543.0,18:10,353,282,635,55.59,99,43,57,37,20,2,9,11,9527.0,2:12,1,4,5,5339.0,1:14,2700000
8477497,Sean,Monahan,1994-10-12,C,L,2016-17,82,27,31,58,0.71,-1,199,13.57,20,86478.0,17:34,743,701,1444,51.45,34,25,50,44,6,8,9,17,14879.0,3:1,1,0,1,2447.0,0:29,6375000
8477498,Darnell,Nurse,1995-02-04,D,L,2016-17,44,5,6,11,0.25,0,85,5.88,33,44927.0,17:1,0,0,0,0.0,107,53,11,36,-25,0,0,0,299.0,0:6,0,0,0,3134.0,1:11,863333
8477499,Rasmus,Ristolainen,1994-10-27,D,R,2016-17,79,6,39,45,0.57,-9,186,3.23,58,125458.0,26:28,0,0,0,0.0,195,161,25,59,-34,1,24,25,15150.0,3:11,0,1,1,14145.0,2:59,5400000
8477500,Bo,Horvat,1995-04-05,C,L,2016-17,81,20,32,52,0.64,-7,158,12.66,27,87636.0,18:1,756,742,1498,50.47,65,41,37,27,10,3,7,10,9382.0,1:55,2,0,2,8901.0,1:49,894167
8477502,Samuel,Morin,1995-07-12,D,L,2016-17,1,0,0,0,0.0,0,2,0.0,0,1067.0,17:47,0,0,0,0.0,7,0,1,0,1,0,0,0,0.0,0:0,0,0,0,189.0,3:9,863333
8477503,Max,Domi,1995-03-02,LW,L,2016-17,59,9,29,38,0.64,-9,108,8.33,40,60112.0,16:58,5,5,10,50.0,28,21,27,36,-9,1,7,8,9073.0,2:33,0,0,0,393.0,0:6,863333
8477504,Josh,Morrissey,1995-03-28,D,L,2016-17,82,6,14,20,0.24,6,99,6.06,38,95896.0,19:29,0,0,0,0.0,145,139,15,39,-24,1,0,1,3055.0,0:37,0,0,0,4292.0,0:52,863333
8477505,Alexander,Wennberg,1994-09-22,C,L,2016-17,80,13,46,59,0.74,9,109,11.93,21,88212.0,18:22,609,676,1285,47.39,58,56,44,31,13,2,21,23,12685.0,2:38,0,0,0,3039.0,0:37,925000
8477506,Ryan,Pulock,1994-10-06,D,R,2016-17,1,0,0,0,0.0,1,0,,0,237.0,3:57,0,0,0,0.0,1,1,0,0,0,0,0,0,62.0,1:2,0,0,0,0.0,0:0,863333
8477507,Nikita,Zadorov,1995-04-16,D,L,2016-17,56,0,10,10,0.18,-20,61,0.0,73,63960.0,19:2,0,0,0,0.0,153,69,12,25,-13,0,2,2,2140.0,0:38,0,0,0,7186.0,2:8,894167
8477508,Curtis,Lazar,1995-02-02,C,R,2016-17,37,1,3,4,0.11,-8,26,3.85,4,20277.0,9:8,39,60,99,39.39,66,17,7,6,1,0,0,0,234.0,0:6,0,0,0,656.0,0:17,894167
8477509,Mirco,Mueller,1995-03-21,D,L,2016-17,4,1,1,2,0.5,2,3,33.33,0,2302.0,9:35,0,0,0,0.0,2,3,2,2,0,0,0,0,0.0,0:0,0,0,0,56.0,0:14,894167
8477511,Anthony,Mantha,1994-09-16,RW,L,2016-17,60,17,19,36,0.6,10,133,12.78,53,57246.0,15:54,5,6,11,45.45,46,33,26,39,-13,1,2,3,6820.0,1:53,0,0,0,149.0,0:2,863333
8477512,Frederik,Gauthier,1995-04-26,C,L,2016-17,21,2,1,3,0.14,2,15,13.33,23,12213.0,9:41,120,115,235,51.06,17,17,5,3,2,0,0,0,117.0,0:5,0,0,0,1313.0,1:2,863333
8477520,Jean-Sebastien,Dea,1994-02-08,C,R,2016-17,1,0,0,0,0.0,0,1,0.0,2,678.0,11:18,1,1,2,50.0,3,0,0,0,0,0,0,0,0.0,0:0,0,0,0,0.0,0:0,-111
8477566,Sergey,Tolchinsky,1995-02-03,LW,L,2016-17,2,0,1,1,0.5,0,2,0.0,0,1377.0,11:28,0,0,0,0.0,0,0,0,0,0,0,0,0,7.0,0:3,0,0,0,0.0,0:0,616667
8477591,Josh,Jooris,1990-07-14,RW,R,2016-17,54,4,8,12,0.22,-2,75,5.33,16,39514.0,12:11,222,228,450,49.33,49,30,10,5,5,0,0,0,88.0,0:1,0,1,1,4775.0,1:28,600000
8477715,Tyler,Gaudet,1993-04-04,C,L,2016-17,4,0,1,1,0.25,0,3,0.0,0,3117.0,12:59,14,21,35,40.0,3,1,0,0,0,0,0,0,0.0,0:0,0,0,0,544.0,2:16,874125
8477810,Joel,Hanley,1991-06-08,D,L,2016-17,7,0,0,0,0.0,-3,5,0.0,4,4266.0,10:9,0,0,0,0.0,8,4,1,3,-2,0,0,0,0.0,0:0,0,0,0,0.0,0:0,600000
8477816,Michael,Zalewski,1992-08-18,LW,L,2016-17,1,0,0,0,0.0,-1,0,,0,483.0,8:3,0,0,0,0.0,0,1,0,0,0,0,0,0,0.0,0:0,0,0,0,0.0,0:0,632500
8477839,Conor,Sheary,1992-06-08,LW,L,2016-17,61,23,30,53,0.87,24,154,14.94,22,58332.0,15:56,0,0,0,0.0,29,23,26,25,1,2,3,5,6534.0,1:47,0,0,0,40.0,0:0,667500
8477845,Trevor,van Riemsdyk,1991-07-24,D,R,2016-17,58,5,11,16,0.28,17,73,6.85,29,64062.0,18:24,0,0,0,0.0,22,100,22,35,-13,0,0,0,1906.0,0:32,0,0,0,2993.0,0:51,825000
8477846,Ryan,Carpenter,1991-01-18,C,R,2016-17,11,2,2,4,0.36,5,20,10.0,4,6853.0,10:23,34,41,75,45.33,15,2,1,3,-2,0,0,0,42.0,0:3,0,0,0,533.0,0:48,600000
8477850,Christian,Folin,1991-02-09,D,R,2016-17,51,2,6,8,0.16,10,39,5.13,26,45700.0,14:56,0,0,0,0.0,69,59,9,15,-6,0,0,0,116.0,0:2,0,0,0,2933.0,0:57,725000
8477851,Jordan,Oesterle,1992-06-25,D,L,2016-17,2,0,0,0,0.0,-1,2,0.0,0,2074.0,17:17,0,0,0,0.0,2,3,2,2,0,0,0,0,36.0,0:18,0,0,0,0.0,0:0,585000
8477881,Connor,Jones,1990-08-16,C,L,2016-17,4,0,0,0,0.0,1,2,0.0,2,2843.0,11:50,8,5,13,61.54,13,3,2,1,1,0,0,0,0.0,0:0,0,0,0,107.0,0:26,575000
8477887,Patrick,Brown,1992-05-29,C,R,2016-17,14,0,0,0,0.0,-6,12,0.0,0,8160.0,9:42,9,6,15,60.0,30,5,2,3,-1,0,0,0,19.0,0:1,0,0,0,78.0,0:5,650000
8477901,Daniel,Carr,1991-11-01,LW,L,2016-17,33,2,7,9,0.27,4,44,4.55,6,20306.0,10:15,2,1,3,66.67,19,12,7,6,1,0,0,0,427.0,0:12,0,0,0,77.0,0:2,725000
8477903,Garnet,Hathaway,1991-11-23,RW,R,2016-17,26,1,4,5,0.19,0,22,4.55,44,14257.0,9:8,10,9,19,52.63,56,14,8,3,5,0,0,0,76.0,0:2,0,0,0,116.0,0:4,690000
8477916,Borna,Rendulic,1992-03-25,RW,R,2016-17,1,0,0,0,0.0,0,1,0.0,0,291.0,4:51,0,0,0,0.0,0,0,0,0,0,0,0,0,0.0,0:0,0,0,0,0.0,0:0,575000
8477919,Frederick,Gaudreau,1993-05-01,C,R,2016-17,9,0,1,1,0.11,1,8,0.0,0,4678.0,8:39,4,8,12,33.33,1,5,2,1,1,0,0,0,25.0,0:2,0,0,0,68.0,0:7,595000
8477922,Melker,Karlsson,1990-07-18,C,R,2016-17,67,11,11,22,0.33,7,73,15.07,22,51459.0,12:48,1,5,6,16.67,67,59,17,23,-6,0,0,0,437.0,0:6,2,0,2,6358.0,1:34,1650000
8477929,Dennis,Rasmussen,1990-07-03,C,L,2016-17,68,4,4,8,0.12,-4,77,5.19,12,48254.0,11:49,165,205,370,44.59,61,49,25,19,6,0,0,0,167.0,0:2,0,0,0,7195.0,1:45,575000
8477930,Pierre-Edouard,Bellemare,1985-03-06,LW,L,2016-17,82,4,4,8,0.1,-1,90,4.44,20,63814.0,12:58,402,429,831,48.38,73,70,24,14,10,0,0,0,248.0,0:3,0,1,1,13616.0,2:46,712500
8477931,Tomas,Nosek,1992-09-01,LW,L,2016-17,11,1,0,1,0.09,-1,19,5.26,2,6682.0,10:7,37,31,68,54.41,10,5,5,3,2,0,0,0,29.0,0:2,0,0,0,140.0,0:12,612500
8477932,Aaron,Ekblad,1996-02-07,D,R,2016-17,68,10,11,21,0.31,-23,225,4.44,58,87557.0,21:27,0,0,0,0.0,88,62,25,58,-33,4,4,8,11369.0,2:47,1,0,1,3310.0,0:48,925000
8477933,Sam,Reinhart,1995-11-06,C,R,2016-17,79,17,30,47,0.59,-11,178,9.55,8,81609.0,17:13,86,124,210,40.95,21,40,25,27,-2,9,8,17,13903.0,2:55,0,0,0,239.0,0:3,894167
8477934,Leon,Draisaitl,1995-10-27,C,L,2016-17,82,29,48,77,0.94,7,172,16.86,20,92909.0,18:53,476,496,972,48.97,41,36,75,75,0,10,17,27,14309.0,2:54,0,0,0,2076.0,0:25,925000
8477935,Sam,Bennett,1996-06-20,C,L,2016-17,81,13,13,26,0.32,-16,122,10.66,75,72839.0,14:59,374,437,811,46.12,127,46,43,25,18,4,0,4,5999.0,1:14,0,1,1,5474.0,1:7,925000
8477937,Jake,Virtanen,1996-08-17,RW,R,2016-17,10,0,1,1,0.1,1,13,0.0,2,6087.0,10:8,3,0,3,100.0,17,4,4,0,4,0,0,0,93.0,0:9,0,0,0,0.0,0:0,894167
8477939,William,Nylander,1996-05-01,C,R,2016-17,81,22,39,61,0.75,-3,205,10.73,32,77820.0,16:0,49,73,122,40.16,25,16,59,30,29,9,17,26,11446.0,2:21,0,0,0,37.0,0:0,894167
8477940,Nikolaj,Ehlers,1996-02-14,LW,L,2016-17,82,25,39,64,0.78,1,204,12.25,38,86032.0,17:29,0,4,4,0.0,43,28,36,51,-15,5,7,12,12834.0,2:36,0,0,0,89.0,0:1,894167
8477941,Nick,Ritchie,1995-12-05,LW,L,2016-17,77,14,14,28,0.36,4,149,9.4,62,59992.0,12:59,4,4,8,50.0,247,24,16,23,-7,1,1,2,2611.0,0:33,0,0,0,266.0,0:3,894167
8477942,Kevin,Fiala,1996-07-22,LW,L,2016-17,54,11,5,16,0.3,1,114,9.65,18,43780.0,13:30,0,0,0,0.0,44,14,39,27,12,0,0,0,2663.0,0:49,0,0,0,419.0,0:7,863333
8477943,Brendan,Perlini,1996-04-27,LW,L,2016-17,57,14,7,21,0.37,-4,92,15.22,20,50747.0,14:50,1,1,2,50.0,42,15,8,13,-5,3,2,5,5947.0,1:44,0,0,0,147.0,0:2,863333
8477944,Jakub,Vrana,1996-02-28,LW,L,2016-17,21,3,3,6,0.29,2,32,9.38,2,13997.0,11:6,0,3,3,0.0,6,7,4,9,-5,3,1,4,2276.0,1:48,0,0,0,0.0,0:0,863333
8477945,Julius,Honka,1995-12-03,D,R,2016-17,16,1,4,5,0.31,-4,34,2.94,4,16194.0,16:52,0,0,0,0.0,9,15,6,9,-3,0,1,1,1333.0,1:23,0,0,0,6.0,0:0,863333
8477946,Dylan,Larkin,1996-07-30,C,L,2016-17,80,17,15,32,0.4,-28,178,9.55,37,77534.0,16:9,196,236,432,45.37,67,22,49,51,-2,5,2,7,8996.0,1:52,1,0,1,1630.0,0:20,925000
8477947,Sonny,Milano,1996-05-12,LW,L,2016-17,4,0,0,0,0.0,-3,2,0.0,0,2804.0,11:41,0,0,0,0.0,3,2,1,3,-2,0,0,0,386.0,1:36,0,0,0,0.0,0:0,863333
8477949,Alex,Tuch,1996-05-10,RW,R,2016-17,6,0,0,0,0.0,-3,8,0.0,0,3853.0,10:42,0,0,0,0.0,5,7,2,0,2,0,0,0,0.0,0:0,0,0,0,0.0,0:0,925000
8477950,Tony,DeAngelo,1995-10-24,D,R,2016-17,39,5,9,14,0.36,-13,60,8.33,37,40000.0,17:5,0,0,0,0.0,31,48,4,22,-18,2,6,8,5728.0,2:26,0,0,0,128.0,0:3,-111
8477951,Nick,Schmaltz,1996-02-23,C,R,2016-17,61,6,22,28,0.46,10,66,9.09,6,48536.0,13:15,84,188,272,30.88,20,27,46,22,24,0,2,2,3822.0,1:2,0,0,0,64.0,0:1,925000
8477952,Robby,Fabbri,1996-01-22,C,L,2016-17,51,11,18,29,0.57,-16,91,12.09,27,47764.0,15:36,13,11,24,54.17,64,14,20,8,12,4,5,9,6949.0,2:16,0,0,0,124.0,0:2,894167
8477953,Kasperi,Kapanen,1996-07-23,RW,R,2016-17,8,1,0,1,0.12,-2,11,9.09,0,5134.0,10:41,0,0,0,0.0,6,2,2,4,-2,0,0,0,27.0,0:3,0,0,0,670.0,1:23,863333
8477955,Jared,McCann,1996-05-31,C,L,2016-17,29,1,6,7,0.24,-1,44,2.27,4,20245.0,11:38,41,64,105,39.05,28,6,8,8,0,0,1,1,1718.0,0:59,0,0,0,34.0,0:1,894167
8477956,David,Pastrnak,1996-05-25,RW,R,2016-17,75,34,36,70,0.93,11,262,12.98,34,80921.0,17:58,2,1,3,66.67,72,32,50,65,-15,10,14,24,11825.0,2:37,0,0,0,71.0,0:0,925000
8477957,Nikita,Scherbak,1995-12-30,RW,L,2016-17,3,1,0,1,0.33,1,3,33.33,0,2048.0,11:22,0,0,0,0.0,0,1,0,0,0,1,0,1,287.0,1:35,0,0,0,0.0,0:0,863333
8477958,Nikolay,Goldobin,1995-10-07,RW,L,2016-17,14,3,0,3,0.21,0,14,21.43,0,9551.0,11:22,0,0,0,0.0,1,4,3,8,-5,0,0,0,434.0,0:31,0,0,0,0.0,0:0,863333
8477959,Joshua,Ho-Sang,1996-01-22,RW,R,2016-17,21,4,6,10,0.48,1,22,18.18,12,20735.0,16:27,0,2,2,0.0,4,2,9,20,-11,1,1,2,3040.0,2:24,0,0,0,0.0,0:0,863333
8477960,Adrian,Kempe,1996-09-13,LW,L,2016-17,25,2,4,6,0.24,-3,32,6.25,6,18346.0,12:13,67,86,153,43.79,23,7,5,10,-5,0,2,2,1205.0,0:48,0,1,1,938.0,0:37,894167
8477961,John,Quenneville,1996-04-16,C,L,2016-17,12,1,3,4,0.33,1,21,4.76,2,9863.0,13:41,0,0,0,0.0,15,7,4,4,0,1,1,2,1365.0,1:53,0,0,0,22.0,0:1,811667
8477964,Ivan,Barbashev,1995-12-14,C,L,2016-17,30,5,7,12,0.4,5,20,25.0,2,21224.0,11:47,83,124,207,40.1,34,14,9,3,6,0,0,0,1620.0,0:54,0,0,0,32.0,0:1,741667
8477971,Andreas,Englund,1996-01-21,D,L,2016-17,5,0,0,0,0.0,-3,3,0.0,2,3189.0,10:37,0,0,0,0.0,18,0,0,2,-2,0,0,0,6.0,0:1,0,0,0,53.0,0:10,775833
8477973,Vladislav,Kamenev,1996-08-12,C,L,2016-17,2,0,0,0,0.0,-1,1,0.0,2,1207.0,10:3,6,7,13,46.15,1,1,0,0,0,0,0,0,109.0,0:54,0,0,0,0.0,0:0,833333
8477986,Brandon,Montour,1994-04-11,D,R,2016-17,27,2,4,6,0.22,11,50,4.0,14,28157.0,17:22,0,0,0,0.0,21,24,3,17,-14,0,1,1,3065.0,1:53,0,0,0,450.0,0:16,925000
8477989,Christian,Dvorak,1996-02-02,C,L,2016-17,78,15,18,33,0.42,7,88,17.05,22,73086.0,15:37,471,535,1006,46.82,72,56,14,15,-1,2,3,5,6676.0,1:25,0,0,0,3964.0,0:50,839167
8477997,Nikita,Tryamkin,1994-08-30,D,L,2016-17,66,2,7,9,0.14,-7,65,3.08,64,66291.0,16:44,0,0,0,0.0,145,87,12,33,-21,0,0,0,129.0,0:1,0,0,0,5786.0,1:27,925000
8478004,Brett,Lernout,1995-09-24,D,R,2016-17,2,0,0,0,0.0,-1,3,0.0,0,2279.0,18:59,0,0,0,0.0,8,3,0,0,0,0,0,0,0.0,0:0,0,0,0,14.0,0:7,653333
8478010,Brayden,Point,1996-03-13,C,R,2016-17,68,18,22,40,0.59,4,122,14.75,14,69898.0,17:7,238,294,532,44.74,39,31,30,19,11,5,7,12,10273.0,2:31,0,0,0,1124.0,0:16,686667
8478027,Lucas,Wallmark,1995-09-05,C,L,2016-17,8,0,2,2,0.25,1,11,0.0,2,5216.0,10:52,31,27,58,53.45,14,3,3,1,2,0,0,0,68.0,0:8,0,0,0,0.0,0:0,683333
8478031,Nelson,Nogier,1996-05-27,D,R,2016-17,10,0,0,0,0.0,-1,8,0.0,5,7028.0,11:42,0,0,0,0.0,12,5,0,6,-6,0,0,0,12.0,0:1,0,0,0,0.0,0:0,713333
8478042,Viktor,Arvidsson,1993-04-08,LW,R,2016-17,80,31,30,61,0.76,16,246,12.6,28,82343.0,17:9,4,12,16,25.0,23,45,37,26,11,4,5,9,9562.0,1:59,5,2,7,5110.0,1:3,631667
8478046,Danton,Heinen,1995-07-05,C,L,2016-17,8,0,0,0,0.0,-3,7,0.0,2,6352.0,13:14,0,0,0,0.0,6,2,5,2,3,0,0,0,850.0,1:46,0,0,0,40.0,0:5,872500
8478055,Gustav,Forsling,1996-06-12,D,L,2016-17,38,2,3,5,0.13,3,48,4.17,4,33787.0,14:49,0,0,0,0.0,16,17,5,27,-22,0,1,1,2133.0,0:56,0,0,0,188.0,0:4,872500
8478073,Anton,Lindholm,1994-11-29,D,L,2016-17,12,0,0,0,0.0,-8,7,0.0,2,10621.0,14:45,0,0,0,0.0,38,12,2,4,-2,0,0,0,0.0,0:0,0,0,0,846.0,1:10,717500
8478099,Kevin,Labanc,1995-12-12,RW,R,2016-17,55,8,12,20,0.36,9,70,11.43,22,45139.0,13:40,2,2,4,50.0,19,14,16,27,-11,0,2,2,3759.0,1:8,0,0,0,631.0,0:11,717500
8478131,Ondrej,Kase,1995-11-08,RW,R,2016-17,53,5,10,15,0.28,-1,77,6.49,18,37473.0,11:47,1,6,7,14.29,42,14,23,33,-10,0,0,0,722.0,0:13,0,0,0,26.0,0:0,670000
8478366,Frank,Vatrano,1994-03-14,C,L,2016-17,44,10,8,18,0.41,-3,116,8.62,14,35581.0,13:28,2,5,7,28.57,51,16,9,8,1,4,1,5,4649.0,1:45,0,0,0,132.0,0:3,792500
8478371,Matt,Lorito,1990-07-03,LW,L,2016-17,2,0,1,1,0.5,0,6,0.0,0,1732.0,14:26,0,0,0,0.0,0,0,1,0,1,0,0,0,109.0,0:54,0,0,0,0.0,0:0,637500
8478373,Nikita,Soshnikov,1993-10-14,RW,L,2016-17,56,5,4,9,0.16,1,70,7.14,16,36450.0,10:50,2,15,17,11.76,101,28,20,15,5,0,1,1,2059.0,0:36,0,0,0,3835.0,1:8,736666
8478376,Casey,Bailey,1991-10-27,RW,R,2016-17,7,0,0,0,0.0,-1,10,0.0,0,3358.0,7:59,0,1,1,0.0,4,4,1,0,1,0,0,0,0.0,0:0,0,0,0,0.0,0:0,874125
8478396,Noah,Hanifin,1997-01-25,D,L,2016-17,81,4,25,29,0.36,-19,108,3.7,26,87092.0,17:55,0,0,0,0.0,57,73,42,53,-11,2,9,11,9875.0,2:1,0,0,0,185.0,0:2,925000
8478397,Rasmus,Andersson,1996-10-27,D,R,2016-17,1,0,0,0,0.0,-1,0,,0,1113.0,18:33,0,0,0,0.0,4,2,0,0,0,0,0,0,112.0,1:52,0,0,0,1.0,0:1,786667
8478398,Kyle,Connor,1996-12-09,LW,L,2016-17,20,2,3,5,0.25,-7,24,8.33,4,14665.0,12:13,1,1,2,50.0,1,8,11,5,6,0,2,2,1679.0,1:23,0,0,0,0.0,0:0,925000
8478400,Colin,White,1997-01-30,C,R,2016-17,2,0,0,0,0.0,0,1,0.0,0,1645.0,13:42,7,14,21,33.33,0,1,1,0,1,0,0,0,201.0,1:40,0,0,0,0.0,0:0,925000
8478401,Pavel,Zacha,1997-04-06,C,L,2016-17,70,8,16,24,0.34,-17,83,9.64,19,60093.0,14:18,184,273,457,40.26,54,24,16,26,-10,5,8,13,7726.0,1:50,0,0,0,2941.0,0:42,894167
8478402,Connor,McDavid,1997-01-13,C,L,2016-17,82,30,70,100,1.22,27,251,11.95,26,103967.0,21:7,348,458,806,43.18,34,29,76,54,22,3,24,27,14933.0,3:2,1,1,2,3949.0,0:48,925000
8478403,Jack,Eichel,1996-10-28,C,R,2016-17,61,24,33,57,0.93,-13,249,9.64,22,72908.0,19:55,310,486,796,38.94,26,35,38,46,-8,10,14,24,10917.0,2:58,0,0,0,881.0,0:14,925000
8478414,Timo,Meier,1996-10-08,RW,L,2016-17,34,3,3,6,0.18,1,85,3.53,10,25446.0,12:28,1,4,5,20.0,64,5,24,28,-4,0,0,0,379.0,0:11,0,0,0,827.0,0:24,894167
8478417,Jakob,Forsbacka Karlsson,1996-10-31,C,R,2016-17,1,0,0,0,0.0,0,0,,0,505.0,8:25,1,1,2,50.0,0,1,0,0,0,0,0,0,0.0,0:0,0,0,0,0.0,0:0,916667
8478420,Mikko,Rantanen,1996-10-29,RW,L,2016-17,75,20,18,38,0.51,-25,133,15.04,22,81262.0,18:3,29,21,50,58.0,29,33,49,32,17,4,6,10,12260.0,2:43,0,0,0,346.0,0:4,894167
8478421,A.J.,Greer,1996-12-14,LW,L,2016-17,5,0,1,1,0.2,-2,8,0.0,4,4097.0,13:39,0,0,0,0.0,4,3,1,2,-1,0,0,0,172.0,0:34,0,0,0,118.0,0:23,741666
8478425,Brendan,Guhle,1997-07-29,D,L,2016-17,3,0,0,0,0.0,1,4,0.0,0,2943.0,16:21,0,0,0,0.0,3,8,0,0,0,0,0,0,5.0,0:1,0,0,0,0.0,0:0,703333
8478427,Sebastian,Aho,1997-07-26,RW,L,2016-17,82,24,25,49,0.6,-1,214,11.21,26,82591.0,16:47,17,18,35,48.57,51,14,40,57,-17,6,11,17,10911.0,2:13,1,1,2,1074.0,0:13,925000
8478431,Evgeny,Svechnikov,1996-10-31,RW,L,2016-17,2,0,0,0,0.0,0,4,0.0,0,1577.0,13:8,0,0,0,0.0,2,1,0,1,-1,0,0,0,0.0,0:0,0,0,0,0.0,0:0,894167
8478432,Christian,Fischer,1997-04-15,RW,R,2016-17,7,3,0,3,0.43,0,10,30.0,0,5177.0,12:19,0,0,0,0.0,9,0,0,3,-3,0,0,0,0.0,0:0,0,0,0,93.0,0:13,852500
8478439,Travis,Konecny,1997-03-11,C,R,2016-17,70,11,17,28,0.4,-2,133,8.27,49,59180.0,14:5,0,5,5,0.0,92,26,26,28,-2,3,1,4,7085.0,1:41,0,0,0,76.0,0:1,894167
8478440,Dylan,Strome,1997-03-07,C,L,2016-17,7,0,1,1,0.14,-5,6,0.0,0,5747.0,13:41,31,46,77,40.26,3,2,3,0,3,0,0,0,862.0,2:3,0,0,0,10.0,0:1,894167
8478443,Brandon,Carlo,1996-11-26,D,R,2016-17,82,6,10,16,0.2,9,88,6.82,59,102414.0,20:48,0,0,0,0.0,87,115,21,42,-21,0,0,0,434.0,0:5,1,0,1,12871.0,2:36,789167
8478444,Brock,Boeser,1997-02-25,RW,R,2016-17,9,4,1,5,0.56,0,25,16.0,0,8755.0,16:12,0,0,0,0.0,5,0,1,4,-3,2,0,2,954.0,1:46,0,0,0,0.0,0:0,925000
8478445,Mathew,Barzal,1997-05-26,C,R,2016-17,2,0,0,0,0.0,-2,0,,6,1170.0,9:45,6,7,13,46.15,1,0,0,0,0,0,0,0,62.0,0:31,0,0,0,0.0,0:0,894167
8478458,Jack,Roslovic,1997-01-29,C,R,2016-17,1,0,0,0,0.0,-1,1,0.0,0,504.0,8:24,1,5,6,16.67,0,1,0,0,0,0,0,0,0.0,0:0,0,0,0,0.0,0:0,925000
8478460,Zach,Werenski,1997-07-19,D,L,2016-17,78,11,36,47,0.6,17,188,5.85,14,97864.0,20:54,0,0,0,0.0,41,90,27,40,-13,4,17,21,13055.0,2:47,0,0,0,3541.0,0:45,925000
8478463,Anthony,Beauvillier,1997-06-08,C,L,2016-17,66,9,15,24,0.36,1,101,8.91,10,51563.0,13:1,123,174,297,41.41,81,26,17,30,-13,0,1,1,1986.0,0:30,0,0,0,244.0,0:3,894167
8478469,Thomas,Chabot,1997-01-30,D,L,2016-17,1,0,0,0,0.0,-2,1,0.0,0,429.0,7:9,0,0,0,0.0,1,0,0,1,-1,0,0,0,0.0,0:0,0,0,0,0.0,0:0,894167
8478474,Lawson,Crouse,1997-06-23,LW,L,2016-17,72,5,7,12,0.17,-20,84,5.95,48,51358.0,11:53,1,1,2,50.0,160,29,14,5,9,0,0,0,111.0,0:1,1,0,1,6398.0,1:28,894167
8478480,Blake,Speers,1997-01-02,C,R,2016-17,3,0,0,0,0.0,0,3,0.0,0,1707.0,9:29,0,2,2,0.0,1,1,1,0,1,0,0,0,12.0,0:4,0,0,0,201.0,1:7,717500
8478483,Mitchell,Marner,1997-05-05,C,R,2016-17,77,19,42,61,0.79,0,176,10.8,38,77663.0,16:48,14,23,37,37.84,41,39,67,62,5,4,17,21,10995.0,2:22,0,0,0,613.0,0:7,894167
8478491,Jacob,Larsson,1997-04-29,D,L,2016-17,4,0,0,0,0.0,-1,2,0.0,2,3943.0,16:25,0,0,0,0.0,1,1,0,1,-1,0,0,0,259.0,1:4,0,0,0,492.0,2:3,925000
8478493,Joel,Eriksson Ek,1997-01-29,C,L,2016-17,15,3,4,7,0.47,1,15,20.0,4,9551.0,10:36,45,64,109,41.28,23,8,3,3,0,0,0,0,88.0,0:5,0,0,0,148.0,0:9,894166
8478495,Denis,Gurianov,1997-06-07,RW,L,2016-17,1,0,0,0,0.0,-1,0,,0,786.0,13:6,0,0,0,0.0,1,3,0,0,0,0,0,0,0.0,0:0,0,0,0,0.0,0:0,925000
8478500,Ivan,Provorov,1997-01-13,D,L,2016-17,82,6,24,30,0.37,-7,161,3.73,34,108132.0,21:58,0,0,0,0.0,111,166,23,81,-58,0,5,5,8344.0,1:41,0,0,0,13939.0,2:49,894167
8478506,Gabriel,Carlsson,1997-01-02,D,L,2016-17,2,0,1,1,0.5,-2,3,0.0,0,2055.0,17:7,0,0,0,0.0,5,2,0,0,0,0,0,0,0.0,0:0,0,0,0,44.0,0:22,925000
8478512,Austin,Czarnik,1992-12-12,C,R,2016-17,49,5,8,13,0.27,-10,66,7.58,12,38267.0,13:0,57,76,133,42.86,19,25,19,11,8,0,3,3,5145.0,1:45,0,0,0,3320.0,1:7,817500
8478528,Tanner,Kero,1992-07-24,C,L,2016-17,47,6,10,16,0.34,15,60,10.0,8,38030.0,13:29,209,262,471,44.37,41,51,14,11,3,0,0,0,284.0,0:6,0,0,0,4036.0,1:25,667500
8478541,Markus,Hannikainen,1993-03-26,LW,L,2016-17,10,1,1,2,0.2,0,8,12.5,6,5476.0,9:7,0,0,0,0.0,16,5,0,0,0,0,0,0,11.0,0:1,0,0,0,410.0,0:41,717500
8478542,Evan,Rodrigues,1993-07-28,LW,R,2016-17,30,4,2,6,0.2,-7,51,7.84,4,23265.0,12:55,104,146,250,41.6,12,12,12,9,3,1,0,1,334.0,0:11,0,0,0,1928.0,1:4,842500
8478550,Artemi,Panarin,1991-10-30,LW,R,2016-17,82,31,43,74,0.9,18,211,14.69,21,95798.0,19:28,2,8,10,20.0,23,14,57,55,2,9,8,17,15464.0,3:8,0,0,0,150.0,0:1,812500
8478561,Andreas,Martinsen,1990-06-13,LW,L,2016-17,64,3,4,7,0.11,-14,73,4.11,32,38220.0,9:57,3,1,4,75.0,173,28,25,11,14,0,0,0,292.0,0:4,0,1,1,3487.0,0:54,640000
8478562,Jakub,Nakladal,1987-12-30,D,R,2016-17,3,0,0,0,0.0,-4,3,0.0,0,2610.0,14:30,0,0,0,0.0,2,4,1,0,1,0,0,0,0.0,0:0,0,0,0,14.0,0:4,600000
8478566,Sergey,Kalinin,1991-03-17,C,L,2016-17,43,2,2,4,0.09,-14,38,5.26,15,33008.0,12:47,72,102,174,41.38,53,20,7,10,-3,0,0,0,1171.0,0:27,0,0,0,5093.0,1:58,800000
8478569,Noel,Acciari,1991-12-01,C,R,2016-17,29,2,3,5,0.17,3,24,8.33,16,18047.0,10:22,11,18,29,37.93,80,5,10,4,6,0,0,0,49.0,0:1,0,0,0,350.0,0:12,792500
8478585,Derek,Ryan,1986-12-29,C,R,2016-17,67,11,18,29,0.43,-8,73,15.07,22,59864.0,14:53,391,316,707,55.3,33,37,33,36,-3,4,4,8,8534.0,2:7,1,0,1,1768.0,0:26,600000
8478843,Denis,Malgin,1997-01-18,C,R,2016-17,47,6,4,10,0.21,-5,67,8.96,8,31692.0,11:14,67,117,184,36.41,34,15,17,11,6,2,0,2,3140.0,1:6,0,0,0,15.0,0:0,690000
8478851,Alexandre,Carrier,1996-10-08,D,R,2016-17,2,0,0,0,0.0,1,1,0.0,0,1247.0,10:23,0,0,0,0.0,0,1,0,0,0,0,0,0,0.0,0:0,0,0,0,1.0,0:0,668333
8478866,Dominik,Simon,1994-08-08,C,L,2016-17,2,0,1,1,0.5,-1,2,0.0,0,1565.0,13:2,0,0,0,0.0,2,0,1,1,0,0,0,0,57.0,0:28,0,0,0,0.0,0:0,692500
8478906,Markus,Nutivaara,1994-06-06,D,L,2016-17,66,2,5,7,0.11,7,66,3.03,6,52322.0,13:12,0,0,0,0.0,36,38,9,20,-11,0,0,0,678.0,0:10,0,0,0,102.0,0:1,817500
8478963,Ryan,Johnston,1992-02-14,D,R,2016-17,7,0,0,0,0.0,-3,3,0.0,4,4145.0,9:52,0,0,0,0.0,1,2,1,3,-2,0,0,0,0.0,0:0,0,0,0,0.0,0:0,680000
8479249,Andrew,Poturalski,1994-01-14,C,R,2016-17,2,0,0,0,0.0,-3,1,0.0,0,1472.0,12:16,12,12,24,50.0,1,1,1,0,1,0,0,0,22.0,0:11,0,0,0,0.0,0:0,858750
8479250,Nick,Lappin,1992-11-01,RW,R,2016-17,43,4,3,7,0.16,-17,57,7.02,17,30240.0,11:43,2,5,7,28.57,36,11,13,6,7,0,0,0,1145.0,0:26,0,0,0,697.0,0:16,842500
8479252,Dan,Renouf,1994-06-01,D,L,2016-17,1,0,0,0,0.0,0,1,0.0,0,815.0,13:35,0,0,0,0.0,3,0,0,0,0,0,0,0,0.0,0:0,0,0,0,0.0,0:0,767500
8479268,Casey,Nelson,1992-07-18,D,R,2016-17,11,0,0,0,0.0,-3,10,0.0,4,8319.0,12:36,0,0,0,0.0,15,5,0,1,-1,0,0,0,157.0,0:14,0,0,0,39.0,0:3,650000
8479290,Kalle,Kossila,1993-04-14,C,L,2016-17,1,0,0,0,0.0,0,1,0.0,0,414.0,6:54,3,4,7,42.86,1,0,0,0,0,0,0,0,0.0,0:0,0,0,0,0.0,0:0,925000
8479291,Kevin,Rooney,1993-05-21,C,L,2016-17,4,0,0,0,0.0,-3,2,0.0,4,2445.0,10:11,10,17,27,37.04,4,1,0,1,-1,0,0,0,15.0,0:3,0,0,0,36.0,0:9,796429
8479293,Brandon,Tanev,1991-12-31,LW,L,2016-17,51,2,2,4,0.08,-6,54,3.7,26,32672.0,10:40,1,0,1,100.0,128,31,19,9,10,0,0,0,37.0,0:0,0,0,0,5120.0,1:40,874125
8479314,Matthew,Tkachuk,1997-12-11,LW,L,2016-17,76,13,35,48,0.63,14,142,9.15,105,66854.0,14:39,8,15,23,34.78,65,22,40,27,13,3,10,13,9221.0,2:1,0,0,0,96.0,0:1,925000
8479318,Auston,Matthews,1997-09-17,C,L,2016-17,82,40,29,69,0.84,2,279,14.34,14,86745.0,17:37,530,602,1132,46.82,21,61,76,44,32,8,13,21,12088.0,2:27,0,0,0,88.0,0:1,925000
8479339,Patrik,Laine,1998-04-19,RW,R,2016-17,73,36,28,64,0.88,7,204,17.65,26,78457.0,17:54,0,3,3,0.0,80,33,43,55,-12,9,5,14,11958.0,2:43,0,0,0,85.0,0:1,925000
8479343,Clayton,Keller,1998-07-29,C,L,2016-17,3,0,2,2,0.67,-3,0,,0,2280.0,12:40,0,0,0,0.0,0,0,1,0,1,0,1,1,309.0,1:43,0,0,0,0.0,0:0,916667
8479344,Jesse,Puljujarvi,1998-05-07,RW,R,2016-17,28,1,7,8,0.29,5,41,2.44,10,18907.0,11:15,0,1,1,0.0,11,10,12,10,2,1,0,1,1373.0,0:49,0,0,0,16.0,0:0,925000
8479345,Jakob,Chychrun,1998-03-31,D,L,2016-17,68,7,13,20,0.29,-14,86,8.14,47,68000.0,16:40,0,0,0,0.0,109,99,12,45,-33,1,1,2,2108.0,0:31,0,0,0,4655.0,1:8,925000
8479370,Tyson,Jost,1998-03-14,C,L,2016-17,6,1,0,1,0.17,-5,9,11.11,0,5643.0,15:40,28,42,70,40.0,3,3,3,1,2,0,0,0,636.0,1:46,0,0,0,338.0,0:56,916667
8479410,Mikhail,Sergachev,1998-06-25,D,L,2016-17,4,0,0,0,0.0,1,2,0.0,0,2910.0,12:7,0,0,0,0.0,10,3,1,3,-2,0,0,0,83.0,0:20,0,0,0,0.0,0:0,925000
8479423,Alexander,Nylander,1998-03-02,RW,R,2016-17,4,0,1,1,0.25,-2,4,0.0,0,2959.0,12:19,0,2,2,0.0,1,2,3,3,0,0,0,0,186.0,0:46,0,0,0,0.0,0:0,925000
8479442,Troy,Stecher,1994-04-07,D,R,2016-17,71,3,21,24,0.34,-16,125,2.4,25,85110.0,19:58,0,0,0,0.0,51,66,26,33,-7,1,7,8,11571.0,2:42,0,0,0,257.0,0:3,925000
8479458,Nikita,Zaitsev,1991-10-29,D,R,2016-17,82,4,32,36,0.44,-22,106,3.77,38,108332.0,22:1,0,0,0,0.0,176,136,33,58,-25,1,11,12,9854.0,2:0,0,1,1,8460.0,1:43,925000
8479465,Drake,Caggiula,1994-06-20,LW,L,2016-17,60,7,11,18,0.3,3,93,7.53,16,47647.0,13:14,117,167,284,41.2,97,19,22,25,-3,2,3,5,5944.0,1:39,0,1,1,2462.0,0:41,925000
8479482,Michal,Kempny,1990-09-08,D,L,2016-17,50,2,6,8,0.16,1,67,2.99,22,44898.0,14:57,0,0,0,0.0,76,59,6,26,-20,0,0,0,340.0,0:6,0,0,0,2029.0,0:40,700000
8479483,Yohann,Auvitu,1989-07-27,D,L,2016-17,25,2,2,4,0.16,1,54,3.7,2,23405.0,15:36,0,0,0,0.0,20,9,7,13,-6,0,1,1,3141.0,2:5,0,0,0,0.0,0:0,792500
8479648,Roman,Lyubimov,1992-01-06,LW,R,2016-17,47,4,2,6,0.13,-2,41,9.76,8,27011.0,9:34,1,6,7,14.29,28,16,12,5,7,0,0,0,149.0,0:3,0,0,0,1404.0,0:29,925000
8479969,Griffen,Molino,1994-01-21,C,L,2016-17,5,0,0,0,0.0,-2,3,0.0,0,3176.0,10:35,0,0,0,0.0,1,1,0,1,-1,0,0,0,0.0,0:0,0,0,0,0.0,0:0,925000
8480081,Michael,Kapla,1994-09-19,D,L,2016-17,5,0,0,0,0.0,-1,4,0.0,0,5232.0,17:26,0,0,0,0.0,5,5,2,3,-1,0,0,0,280.0,0:56,0,0,0,109.0,0:21,925000
8480083,C.J.,Smith,1994-12-01,LW,L,2016-17,2,0,1,1,0.5,-1,2,0.0,0,1384.0,11:32,0,0,0,0.0,0,0,2,2,0,0,0,0,37.0,0:18,0,0,0,0.0,0:0,925000
8480087,Mike,Vecchione,1993-02-25,C,R,2016-17,2,0,0,0,0.0,-1,1,0.0,0,1020.0,8:30,8,4,12,66.67,1,1,0,1,-1,0,0,0,16.0,0:8,0,0,0,0.0,0:0,2553000
