player_id,firstName,lastName,birthDate,primaryPosition,shootsCatches,season,gamesPlayed,goals,assists,points,pointsPerGame,plusMinus,shots,shootingPercentage,penaltyMinutes,timeOnIce,avgTimeOnIce,faceOffWins,faceOffLosses,faceOffTaken,faceOffPercentage,hits,blocks,takeaways,giveaways,turnoverDifferential,powerPlayGoals,powerPlayAssists,powerPlayPoints,powerPlayTimeOnIce,avgPowerPlayTimeOnIce,shortHandedGoals,shortHandedAssists,shortHandedPoints,shortHandedTimeOnIce,avgShortHandedTimeOnIce,salary
8448208,Jaromir,Jagr,1972-02-15,RW,L,2017-18,22,1,6,7,0.32,6,32,3.12,10,17220.0,13:2,0,0,0,0.0,1,8,11,12,-1,0,1,1,2091.0,1:35,0,0,0,0.0,0:0,1000000
8464989,Matt,Cullen,1976-11-02,C,L,2017-18,79,11,11,22,0.28,-1,104,10.58,20,56369.0,11:53,355,350,705,50.35,14,42,14,17,-3,0,1,1,519.0,0:6,0,0,0,4125.0,0:52,1000000
8465009,Zdeno,Chara,1977-03-18,D,L,2017-18,73,7,17,24,0.33,22,144,4.86,60,100317.0,22:54,0,0,0,0.0,141,118,42,74,-32,0,0,0,1697.0,0:23,0,1,1,15991.0,3:39,4000000
8466138,Joe,Thornton,1979-07-02,C,L,2017-18,47,13,23,36,0.77,-9,75,17.33,38,51733.0,18:20,229,211,440,52.05,32,18,33,55,-22,7,11,18,10108.0,3:35,0,0,0,55.0,0:1,8000000
8466139,Patrick,Marleau,1979-09-15,C,L,2017-18,82,27,20,47,0.57,1,203,13.3,16,83580.0,16:59,157,144,301,52.16,85,26,28,33,-5,5,4,9,9795.0,1:59,0,0,0,1959.0,0:23,6250000
8466251,Jason,Chimera,1979-05-02,LW,L,2017-18,74,3,10,13,0.18,-12,79,3.8,37,45730.0,10:17,11,17,28,39.29,132,17,12,25,-13,0,0,0,241.0,0:3,0,0,0,2335.0,0:31,2250000
8467370,Mike,Fisher,1980-06-05,C,R,2017-18,16,2,2,4,0.25,0,14,14.29,8,11851.0,12:20,107,77,184,58.15,25,14,8,5,3,0,0,0,26.0,0:1,0,0,0,1590.0,1:39,1000000
8467400,Francois,Beauchemin,1980-06-04,D,L,2017-18,67,3,14,17,0.25,12,93,3.23,26,69593.0,17:18,0,0,0,0.0,102,121,11,47,-36,0,2,2,2086.0,0:31,0,1,1,6754.0,1:40,4500000
8467407,Brian,Gionta,1979-01-18,RW,R,2017-18,20,2,5,7,0.35,-1,42,4.76,2,15681.0,13:4,6,7,13,46.15,17,6,5,1,4,1,2,3,2278.0,1:53,0,0,0,403.0,0:20,700000
8467875,Daniel,Sedin,1980-09-26,LW,L,2017-18,81,23,32,55,0.68,-21,189,12.17,40,74214.0,15:16,18,22,40,45.0,38,2,17,37,-20,9,14,23,14046.0,2:53,0,0,0,58.0,0:0,7000000
8467876,Henrik,Sedin,1980-09-26,C,L,2017-18,82,3,47,50,0.61,-22,67,4.48,30,76498.0,15:32,438,504,942,46.5,18,19,10,28,-18,0,17,17,14259.0,2:53,0,0,0,55.0,0:0,7000000
8467967,Chris,Kelly,1980-11-11,C,L,2017-18,12,0,2,2,0.17,1,5,0.0,2,5516.0,7:39,2,7,9,22.22,7,6,0,1,-1,0,0,0,0.0,0:0,0,0,0,458.0,0:38,1250000
8468001,Derek,MacKenzie,1981-06-11,C,L,2017-18,75,3,11,14,0.19,-9,86,3.49,31,50886.0,11:18,315,290,605,52.07,124,45,24,14,10,0,0,0,180.0,0:2,1,3,4,10355.0,2:18,1375000
8468083,Henrik,Zetterberg,1980-10-09,C,L,2017-18,82,11,45,56,0.68,1,180,6.11,14,95924.0,19:29,666,709,1375,48.44,49,34,51,57,-6,1,17,18,12923.0,2:37,0,0,0,66.0,0:0,6083333
8468085,Radim,Vrbata,1981-06-13,RW,R,2017-18,42,5,9,14,0.33,-7,88,5.68,16,32521.0,12:54,7,14,21,33.33,15,16,22,18,4,2,2,4,3312.0,1:18,0,0,0,4.0,0:0,2500000
8468208,Joel,Ward,1980-12-02,RW,R,2017-18,52,5,7,12,0.23,-2,40,12.5,20,37047.0,11:52,107,124,231,46.32,35,27,21,13,8,0,0,0,744.0,0:14,0,0,0,3351.0,1:4,3275000
8468309,Mark,Streit,1977-12-11,D,L,2017-18,2,0,0,0,0.0,-2,3,0.0,0,1706.0,14:13,0,0,0,0.0,2,0,0,0,0,0,0,0,250.0,2:5,0,0,0,0.0,0:0,700000
8468483,Marian,Gaborik,1982-02-14,RW,L,2017-18,46,11,10,21,0.46,2,80,13.75,24,38566.0,13:58,0,0,0,0.0,12,9,13,20,-7,3,3,6,5136.0,1:51,0,0,0,124.0,0:2,4875000
8468486,Scott,Hartnell,1982-04-18,LW,L,2017-18,62,13,11,24,0.39,-3,82,15.85,82,44707.0,12:1,3,12,15,20.0,82,25,14,25,-11,2,3,5,4545.0,1:13,0,0,0,34.0,0:0,4750000
8468493,Ron,Hainsey,1981-03-24,D,L,2017-18,80,4,19,23,0.29,12,73,5.48,20,104951.0,21:51,0,0,0,0.0,91,169,18,85,-67,1,0,1,659.0,0:8,0,2,2,19109.0,3:58,3000000
8468498,Brooks,Orpik,1980-09-26,D,L,2017-18,81,0,10,10,0.12,-9,54,0.0,68,94113.0,19:21,0,0,0,0.0,218,168,17,44,-27,0,0,0,111.0,0:1,0,0,0,15133.0,3:6,5500000
8468508,Justin,Williams,1981-10-04,RW,R,2017-18,82,16,35,51,0.62,-9,198,8.08,56,81613.0,16:35,52,64,116,44.83,79,42,46,85,-39,2,10,12,10505.0,2:8,0,0,0,59.0,0:0,4500000
8468509,Niklas,Kronwall,1981-01-12,D,L,2017-18,79,4,23,27,0.34,-14,76,5.26,36,87794.0,18:31,0,0,0,0.0,82,107,14,52,-38,2,13,15,10995.0,2:19,0,0,0,2019.0,0:25,4750000
8468535,Antoine,Vermette,1982-07-20,C,L,2017-18,64,8,8,16,0.25,-5,91,8.79,34,52799.0,13:44,609,406,1015,60.0,38,40,14,17,-3,2,0,2,4643.0,1:12,0,1,1,2978.0,0:46,1750000
8468542,Paul,Martin,1981-03-05,D,L,2017-18,14,0,2,2,0.14,3,6,0.0,2,12399.0,14:45,0,0,0,0.0,8,17,9,7,2,0,0,0,18.0,0:1,0,0,0,105.0,0:7,4850000
8468575,Dominic,Moore,1980-08-03,C,L,2017-18,50,6,6,12,0.24,3,46,13.04,16,30892.0,10:17,196,165,361,54.29,41,19,19,19,0,0,0,0,155.0,0:3,0,1,1,3673.0,1:13,1000000
8468611,Matt,Hendricks,1981-06-17,C,L,2017-18,60,5,8,13,0.22,-1,56,8.93,39,33927.0,9:25,226,232,458,49.34,123,42,16,12,4,0,0,0,223.0,0:3,0,0,0,7161.0,1:59,700000
8468674,Deryk,Engelland,1982-04-03,D,R,2017-18,79,5,18,23,0.29,6,108,4.63,24,96128.0,20:16,0,0,0,0.0,126,150,25,53,-28,0,0,0,384.0,0:4,0,0,0,14023.0,2:57,1000000
8469455,Jason,Spezza,1983-06-13,C,R,2017-18,78,8,18,26,0.33,-14,138,5.8,12,60868.0,13:0,417,330,747,55.82,16,26,12,36,-24,4,7,11,9331.0,1:59,0,0,0,153.0,0:1,7500000
8469459,Mikko,Koivu,1983-03-12,C,L,2017-18,82,14,31,45,0.55,9,170,8.24,46,90957.0,18:29,809,766,1575,51.37,51,53,44,23,21,3,11,14,12239.0,2:29,0,1,1,10086.0,2:3,6750000
8469465,Dan,Hamhuis,1982-12-13,D,L,2017-18,80,3,21,24,0.3,-7,66,4.55,33,96903.0,20:11,0,1,1,0.0,82,113,13,30,-17,0,2,2,1643.0,0:20,0,0,0,12780.0,2:39,3750000
8469466,Ales,Hemsky,1983-08-13,RW,R,2017-18,7,0,0,0,0.0,-1,5,0.0,10,4167.0,9:55,0,1,1,0.0,0,2,1,3,-2,0,0,0,1082.0,2:34,0,0,0,7.0,0:1,1000000
8469500,Michael,Cammalleri,1982-06-08,LW,L,2017-18,66,7,22,29,0.44,-3,128,5.47,18,54536.0,13:46,77,67,144,53.47,43,32,22,36,-14,3,1,4,5492.0,1:23,0,0,0,1067.0,0:16,5000000
8469501,Chris,Thorburn,1983-06-03,RW,R,2017-18,50,1,6,7,0.14,-4,35,2.86,60,21115.0,7:2,7,5,12,58.33,99,16,5,6,-1,0,0,0,68.0,0:1,0,0,0,16.0,0:0,900000
8469506,Jason,Pominville,1982-11-30,RW,R,2017-18,82,16,18,34,0.41,-17,168,9.52,8,73323.0,14:54,33,24,57,57.89,39,35,22,20,2,5,2,7,9412.0,1:54,0,0,0,117.0,0:1,5600000
8469521,Tomas,Plekanec,1982-10-31,C,L,2017-18,77,6,20,26,0.34,1,144,4.17,45,69929.0,15:8,659,577,1236,53.32,61,41,29,51,-22,0,0,0,722.0,0:9,0,0,0,9148.0,1:58,6000000
8469544,Patrick,Sharp,1981-12-27,LW,R,2017-18,70,10,11,21,0.3,-16,143,6.99,14,54111.0,12:53,53,43,96,55.21,46,25,16,13,3,0,4,4,6566.0,1:33,0,0,0,159.0,0:2,800000
8469598,Kevin,Bieksa,1981-06-16,D,R,2017-18,59,0,8,8,0.14,-13,66,0.0,83,63786.0,18:1,0,0,0,0.0,116,81,12,41,-29,0,2,2,1715.0,0:29,0,0,0,6818.0,1:55,4000000
8469619,Dennis,Seidenberg,1981-07-18,D,L,2017-18,28,0,5,5,0.18,-9,31,0.0,17,30043.0,17:52,0,0,0,0.0,65,43,2,18,-16,0,0,0,73.0,0:2,0,0,0,4047.0,2:24,4000000
8469638,Jussi,Jokinen,1983-04-01,LW,L,2017-18,60,5,12,17,0.28,2,73,6.85,12,41672.0,11:34,101,86,187,54.01,21,22,18,16,2,0,5,5,2849.0,0:47,0,0,0,2537.0,0:42,4000000
8469639,Brooks,Laich,1983-06-23,C,L,2017-18,12,0,1,1,0.08,-5,10,0.0,6,8059.0,11:11,53,56,109,48.62,22,5,4,2,2,0,0,0,27.0,0:2,0,0,0,1028.0,1:25,650000
8469665,Johnny,Oduya,1981-10-01,D,L,2017-18,52,4,4,8,0.15,1,59,6.78,32,53383.0,17:6,0,0,0,0.0,50,76,16,34,-18,0,0,0,105.0,0:2,0,0,0,6129.0,1:57,1000000
8470041,Rick,Nash,1984-06-16,LW,L,2017-18,71,21,13,34,0.48,-12,230,9.13,28,72654.0,17:3,4,15,19,21.05,51,42,58,38,20,5,2,7,10056.0,2:21,0,0,0,6938.0,1:37,7800000
8470047,Valtteri,Filppula,1984-03-20,C,L,2017-18,81,11,22,33,0.41,-7,70,15.71,20,80077.0,16:28,487,463,950,51.26,25,55,36,37,-1,3,1,4,7479.0,1:32,0,2,2,6279.0,1:17,5000000
8470105,Scottie,Upshall,1983-10-07,RW,L,2017-18,63,7,12,19,0.3,-1,71,9.86,46,41027.0,10:51,8,7,15,53.33,119,24,18,9,9,0,0,0,201.0,0:3,0,0,0,5159.0,1:21,800000
8470110,Trevor,Daley,1983-10-09,D,L,2017-18,77,9,7,16,0.21,-5,103,8.74,36,95616.0,20:41,0,0,0,0.0,24,125,11,50,-39,0,0,0,2815.0,0:36,1,2,3,12920.0,2:47,3166666
8470144,Frans,Nielsen,1984-04-24,C,L,2017-18,79,16,17,33,0.42,1,134,11.94,14,75023.0,15:49,483,558,1041,46.4,49,62,29,25,4,4,3,7,4155.0,0:52,2,1,3,10144.0,2:8,5250000
8470151,Jay,Bouwmeester,1983-09-27,D,L,2017-18,35,2,5,7,0.2,5,45,4.44,16,42287.0,20:8,0,0,0,0.0,29,58,5,14,-9,0,0,0,86.0,0:2,0,0,0,4540.0,2:9,5400000
8470162,Matt,Stajan,1983-12-19,C,L,2017-18,68,4,8,12,0.18,4,65,6.15,28,44614.0,10:56,248,234,482,51.45,74,31,20,16,4,0,0,0,244.0,0:3,0,0,0,6282.0,1:32,3125000
8470187,Johnny,Boychuk,1984-01-19,D,R,2017-18,58,6,12,18,0.31,-8,141,4.26,30,70268.0,20:11,0,0,0,0.0,114,112,15,46,-31,2,0,2,1900.0,0:32,0,0,0,9011.0,2:35,6000000
8470257,Alexander,Steen,1984-03-01,LW,L,2017-18,76,15,31,46,0.61,-11,168,8.93,20,85244.0,18:41,24,35,59,40.68,53,58,34,19,15,4,10,14,13339.0,2:55,1,0,1,5611.0,1:13,5750000
8470281,Duncan,Keith,1983-07-16,D,L,2017-18,82,2,30,32,0.39,-29,187,1.07,28,117229.0,23:49,0,0,0,0.0,41,165,34,73,-39,2,8,10,12771.0,2:35,0,0,0,11943.0,2:25,5538462
8470318,Jonathan,Ericsson,1984-03-02,D,L,2017-18,81,3,10,13,0.16,-7,86,3.49,47,93839.0,19:18,1,0,1,100.0,133,84,13,70,-57,0,0,0,433.0,0:5,0,1,1,12716.0,2:36,4250000
8470324,Josh,Gorges,1984-08-14,D,L,2017-18,34,0,2,2,0.06,-4,15,0.0,17,30478.0,14:56,0,0,0,0.0,69,54,3,7,-4,0,0,0,59.0,0:1,0,0,0,3902.0,1:54,3900000
8470358,Alexandre,Burrows,1981-04-11,RW,L,2017-18,71,6,8,14,0.2,-8,90,6.67,59,49798.0,11:41,8,22,30,26.67,65,32,7,14,-7,2,1,3,5905.0,1:23,0,0,0,3373.0,0:47,2500000
8470543,Chris,Kunitz,1979-09-26,LW,L,2017-18,82,13,16,29,0.35,8,81,16.05,35,58776.0,11:56,7,12,19,36.84,131,30,38,29,9,0,1,1,1168.0,0:14,1,0,1,3199.0,0:39,2000000
8470595,Eric,Staal,1984-10-29,C,L,2017-18,82,42,34,76,0.93,8,241,17.43,42,87635.0,17:48,571,544,1115,51.21,42,49,48,26,22,11,6,17,10741.0,2:10,2,1,3,5327.0,1:4,3500000
8470598,Thomas,Vanek,1984-01-19,LW,R,2017-18,80,24,32,56,0.7,-3,168,14.29,36,67621.0,14:5,6,18,24,25.0,36,18,28,35,-7,4,11,15,9558.0,1:59,0,0,0,36.0,0:0,2000000
8470600,Ryan,Suter,1985-01-21,D,L,2017-18,78,6,45,51,0.65,-1,149,4.03,34,125318.0,26:46,0,0,0,0.0,78,138,14,37,-23,1,22,23,14453.0,3:5,0,1,1,14045.0,3:0,7538462
8470601,Braydon,Coburn,1985-02-27,D,L,2017-18,72,1,14,15,0.21,3,73,1.37,40,69223.0,16:1,0,0,0,0.0,77,75,11,23,-12,0,0,0,122.0,0:1,0,0,0,9068.0,2:5,3700000
8470602,Dion,Phaneuf,1985-04-10,D,L,2017-18,79,6,20,26,0.33,-15,134,4.48,49,94786.0,19:59,0,0,0,0.0,161,154,20,52,-32,4,7,11,9315.0,1:57,0,0,0,7117.0,1:30,7000000
8470604,Jeff,Carter,1985-01-01,C,R,2017-18,27,13,9,22,0.81,4,85,15.29,2,28905.0,17:50,222,176,398,55.78,27,11,7,9,-2,6,3,9,5121.0,3:9,1,0,1,2155.0,1:19,5272727
8470606,Dustin,Brown,1984-11-04,RW,R,2017-18,81,28,33,61,0.75,31,222,12.61,58,96405.0,19:50,17,29,46,36.96,189,33,40,55,-15,9,6,15,13209.0,2:43,1,0,1,8968.0,1:50,5875000
8470607,Brent,Seabrook,1985-04-20,D,R,2017-18,81,7,19,26,0.32,-3,136,5.15,38,98159.0,20:11,0,2,2,0.0,85,170,25,71,-46,2,6,8,10270.0,2:6,0,0,0,10357.0,2:7,6875000
8470609,Steve,Bernier,1985-03-31,RW,R,2017-18,4,0,0,0,0.0,-2,4,0.0,0,2413.0,10:3,2,2,4,50.0,11,1,0,0,0,0,0,0,312.0,1:18,0,0,0,0.0,0:0,650000
8470610,Zach,Parise,1984-07-28,LW,L,2017-18,42,15,9,24,0.57,0,119,12.61,14,43049.0,17:4,5,7,12,41.67,26,37,15,14,1,2,1,3,6064.0,2:24,0,0,0,1731.0,0:41,7538462
8470611,Eric,Fehr,1985-09-07,C,R,2017-18,18,3,1,4,0.22,6,27,11.11,2,12724.0,11:46,66,73,139,47.48,24,14,6,4,2,0,0,0,35.0,0:1,0,0,0,1663.0,1:32,2000000
8470612,Ryan,Getzlaf,1985-05-10,C,R,2017-18,56,11,50,61,1.09,20,117,9.4,42,71990.0,21:25,406,443,849,47.82,96,57,45,64,-19,0,13,13,9474.0,2:49,1,1,2,3563.0,1:3,8250000
8470613,Brent,Burns,1985-03-09,D,R,2017-18,82,12,55,67,0.82,-16,332,3.61,46,124194.0,25:14,0,0,0,0.0,79,136,75,124,-49,5,22,27,18084.0,3:40,0,1,1,7422.0,1:30,8000000
8470616,Ryan,Kesler,1984-08-31,C,R,2017-18,44,8,6,14,0.32,-4,78,10.26,46,47612.0,18:2,400,350,750,53.33,71,38,13,21,-8,2,0,2,3911.0,1:28,0,0,0,5856.0,2:13,6875000
8470619,Brian,Boyle,1984-12-18,C,L,2017-18,69,13,10,23,0.33,-9,120,10.83,45,55026.0,13:17,420,412,832,50.48,126,26,19,18,1,5,2,7,8502.0,2:3,0,0,0,1103.0,0:15,2550000
8470621,Corey,Perry,1985-05-16,RW,R,2017-18,71,17,32,49,0.69,-4,168,10.12,71,75730.0,17:46,2,14,16,12.5,59,36,18,42,-24,4,7,11,11350.0,2:39,0,0,0,125.0,0:1,8625000
8470622,Patrick,Eaves,1984-05-01,RW,R,2017-18,2,1,0,1,0.5,0,3,33.33,0,1975.0,16:27,0,1,1,0.0,5,1,0,0,0,0,0,0,406.0,3:23,0,0,0,0.0,0:0,3150000
8470626,Loui,Eriksson,1985-07-17,LW,L,2017-18,50,10,13,23,0.46,0,101,9.9,4,48808.0,16:16,6,8,14,42.86,7,30,25,9,16,0,3,3,4202.0,1:24,1,1,2,6886.0,2:17,6000000
8470638,Patrice,Bergeron,1985-07-24,C,R,2017-18,64,30,33,63,0.98,21,224,13.39,26,74640.0,19:26,784,584,1368,57.31,48,42,55,42,13,10,11,21,11373.0,2:57,2,1,3,6977.0,1:49,6875000
8470642,Shea,Weber,1985-08-14,D,R,2017-18,26,6,10,16,0.62,-8,75,8.0,14,39543.0,25:20,0,0,0,0.0,66,59,7,31,-24,2,3,5,5628.0,3:36,0,1,1,4776.0,3:3,7857143
8470655,David,Backes,1984-05-01,RW,R,2017-18,57,14,19,33,0.58,2,160,8.75,53,52652.0,15:23,125,117,242,51.65,137,25,31,21,10,2,4,6,6715.0,1:57,0,1,1,692.0,0:12,6000000
8470724,Kyle,Quincey,1985-08-12,D,L,2017-18,18,0,3,3,0.17,-4,11,0.0,28,15418.0,14:16,0,0,0,0.0,21,18,6,16,-10,0,0,0,19.0,0:1,0,0,0,2733.0,2:31,1250000
8470740,Lee,Stempniak,1983-02-04,RW,R,2017-18,37,3,6,9,0.24,-8,41,7.32,4,27688.0,12:28,3,11,14,21.43,40,11,17,23,-6,1,0,1,236.0,0:6,0,0,0,886.0,0:23,2500000
8470755,Brad,Richardson,1985-02-04,C,L,2017-18,76,3,12,15,0.2,-23,105,2.86,45,67373.0,14:46,543,500,1043,52.06,72,52,24,15,9,0,0,0,422.0,0:5,0,0,0,9480.0,2:4,2083333
8470760,Marc,Methot,1985-06-21,D,L,2017-18,36,1,2,3,0.08,11,25,4.0,31,38628.0,17:53,0,0,0,0.0,77,52,1,11,-10,0,0,0,131.0,0:3,0,0,0,4615.0,2:8,4900000
8470775,Nate,Thompson,1984-10-05,C,L,2017-18,69,5,12,17,0.25,-1,53,9.43,20,52858.0,12:46,360,278,638,56.43,122,39,21,15,6,0,0,0,188.0,0:2,1,0,1,8479.0,2:2,1650000
8470794,Joe,Pavelski,1984-07-11,C,R,2017-18,82,22,44,66,0.8,0,224,9.82,41,94737.0,19:15,500,411,911,54.88,93,70,44,55,-11,7,16,23,15709.0,3:11,0,0,0,1429.0,0:17,6000000
8470803,Kyle,Brodziak,1984-05-25,C,R,2017-18,81,10,23,33,0.41,13,113,8.85,33,65429.0,13:27,504,463,967,52.12,83,55,52,18,34,0,0,0,359.0,0:4,1,2,3,8517.0,1:45,950000
8470828,Toby,Enstrom,1984-11-05,D,L,2017-18,43,1,5,6,0.14,8,31,3.23,20,43941.0,17:1,0,0,0,0.0,20,51,3,31,-28,0,0,0,246.0,0:5,0,0,0,1587.0,0:36,5750000
8470834,Dustin,Byfuglien,1985-03-27,D,R,2017-18,69,8,37,45,0.65,15,193,4.15,112,100763.0,24:20,0,0,0,0.0,147,100,34,79,-45,4,18,22,12687.0,3:3,0,1,1,5276.0,1:16,7600000
8470852,Matt,Moulson,1983-11-01,LW,L,2017-18,14,0,0,0,0.0,-9,13,0.0,2,8641.0,10:17,0,0,0,0.0,8,8,1,1,0,0,0,0,1272.0,1:30,0,0,0,22.0,0:1,5000000
8470854,Tanner,Glass,1983-11-29,LW,L,2017-18,16,0,0,0,0.0,-4,14,0.0,19,9005.0,9:22,2,4,6,33.33,35,7,2,0,2,0,0,0,28.0,0:1,0,0,0,852.0,0:53,650000
8470966,Mark,Giordano,1983-10-03,D,L,2017-18,82,13,25,38,0.46,0,214,6.07,63,121955.0,24:47,0,0,0,0.0,93,161,50,46,4,1,9,10,15427.0,3:8,1,0,1,15255.0,3:6,6750000
8471214,Alex,Ovechkin,1985-09-17,LW,R,2017-18,82,49,38,87,1.06,3,355,13.8,32,99110.0,20:8,3,5,8,37.5,139,21,25,71,-46,17,14,31,20691.0,4:12,0,0,0,148.0,0:1,9538462
8471215,Evgeni,Malkin,1986-07-31,C,L,2017-18,78,42,56,98,1.26,16,239,17.57,87,88873.0,18:59,460,592,1052,43.73,48,32,75,73,2,14,24,38,17182.0,3:40,0,0,0,327.0,0:4,9500000
8471217,Andrew,Ladd,1985-12-12,LW,L,2017-18,73,12,17,29,0.4,11,112,10.71,24,69612.0,15:53,1,9,10,10.0,76,40,29,40,-11,0,1,1,7620.0,1:44,1,1,2,5449.0,1:14,5500000
8471218,Blake,Wheeler,1986-08-31,RW,R,2017-18,81,23,68,91,1.12,13,246,9.35,52,98447.0,20:15,166,196,362,45.86,94,66,34,55,-21,6,34,40,15287.0,3:8,0,2,2,6193.0,1:16,5600000
8471226,Drew,Stafford,1985-10-30,RW,R,2017-18,59,8,7,15,0.25,-20,102,7.84,10,49062.0,13:51,41,40,81,50.62,77,15,16,14,2,4,1,5,6742.0,1:54,0,0,0,85.0,0:1,800000
8471228,Alexander,Radulov,1986-07-05,RW,L,2017-18,82,27,45,72,0.88,5,217,12.44,72,99029.0,20:7,6,4,10,60.0,77,64,46,50,-4,7,16,23,16326.0,3:19,0,0,0,100.0,0:1,6250000
8471233,Travis,Zajac,1985-05-13,C,R,2017-18,63,12,14,26,0.41,-8,91,13.19,25,67692.0,17:54,557,537,1094,50.91,64,38,42,15,27,2,4,6,6978.0,1:50,1,1,2,8815.0,2:19,5750000
8471242,Mike,Green,1985-10-12,D,R,2017-18,66,8,25,33,0.5,-14,132,6.06,38,87445.0,22:4,0,0,0,0.0,78,74,29,68,-39,1,12,13,9322.0,2:21,0,0,0,573.0,0:8,6000000
8471260,Blake,Comeau,1986-02-18,LW,R,2017-18,79,13,21,34,0.43,5,123,10.57,50,75235.0,15:52,104,167,271,38.38,145,38,47,29,18,0,0,0,373.0,0:4,3,0,3,11954.0,2:31,2400000
8471262,Carl,Soderberg,1985-10-12,C,L,2017-18,77,16,21,37,0.48,0,150,10.67,26,80171.0,17:21,425,514,939,45.26,71,64,41,14,27,3,2,5,8810.0,1:54,0,1,1,11176.0,2:25,4750000
8471266,David,Booth,1984-11-24,LW,L,2017-18,28,4,1,5,0.18,-5,33,12.12,10,11711.0,6:58,4,6,10,40.0,23,7,0,9,-9,0,1,1,197.0,0:7,0,0,0,76.0,0:2,700000
8471273,Brandon,Dubinsky,1986-04-29,C,L,2017-18,62,6,10,16,0.26,-2,89,6.74,33,57072.0,15:20,521,431,952,54.73,145,47,25,12,13,0,1,1,1177.0,0:18,1,1,2,5934.0,1:35,5850000
8471274,Alex,Goligoski,1985-07-30,D,L,2017-18,78,12,23,35,0.45,-31,119,10.08,26,108938.0,23:16,0,0,0,0.0,114,154,16,66,-50,3,8,11,9048.0,1:56,0,0,0,8984.0,1:55,5475000
8471276,David,Krejci,1986-04-28,C,R,2017-18,64,17,27,44,0.69,10,119,14.29,18,64803.0,16:52,502,465,967,51.91,31,35,25,30,-5,7,6,13,8518.0,2:13,0,0,0,1009.0,0:15,7250000
8471284,Andrej,Sekera,1986-06-08,D,L,2017-18,36,0,8,8,0.22,-15,36,0.0,6,35274.0,16:19,0,0,0,0.0,27,42,11,18,-7,0,2,2,2101.0,0:58,0,0,0,2755.0,1:16,5500000
8471296,Alexei,Emelin,1986-04-25,D,L,2017-18,76,1,8,9,0.12,9,59,1.69,40,76979.0,16:52,1,0,1,100.0,181,109,20,39,-19,0,0,0,168.0,0:2,0,0,0,7447.0,1:37,4100000
8471303,Alexander,Edler,1986-04-21,D,L,2017-18,70,6,28,34,0.49,-18,172,3.49,68,101965.0,24:16,1,1,2,50.0,157,203,31,56,-25,1,14,15,11824.0,2:48,0,0,0,11243.0,2:40,5000000
8471338,Torrey,Mitchell,1985-01-30,C,R,2017-18,60,6,5,11,0.18,-5,55,10.91,30,41049.0,11:24,194,197,391,49.62,53,29,7,18,-11,0,0,0,108.0,0:1,0,1,1,5500.0,1:31,1200000
8471339,Ryan,Callahan,1985-03-21,RW,R,2017-18,67,5,13,18,0.27,-4,104,4.81,29,53551.0,13:19,27,39,66,40.91,138,40,26,16,10,1,1,2,3580.0,0:53,1,1,2,5834.0,1:27,5800000
8471346,Kris,Versteeg,1986-05-13,RW,R,2017-18,24,3,5,8,0.33,-8,49,6.12,6,18983.0,13:10,46,32,78,58.97,6,6,14,20,-6,1,4,5,4470.0,3:6,0,0,0,0.0,0:0,1750000
8471392,Roman,Polak,1986-04-28,D,R,2017-18,54,2,10,12,0.22,5,47,4.26,46,57163.0,17:38,0,0,0,0.0,131,84,5,32,-27,0,0,0,30.0,0:0,0,0,0,8116.0,2:30,1100000
8471426,Troy,Brouwer,1985-08-17,RW,R,2017-18,76,6,16,22,0.29,-7,79,7.59,53,63527.0,13:55,101,116,217,46.54,125,42,28,31,-3,0,5,5,5632.0,1:14,0,1,1,9426.0,2:4,4500000
8471436,Matt,Hunwick,1985-05-21,D,L,2017-18,42,4,6,10,0.24,-4,52,7.69,21,44127.0,17:30,0,0,0,0.0,51,53,14,20,-6,0,0,0,191.0,0:4,1,0,1,5188.0,2:3,2250000
8471476,Daniel,Winnik,1985-03-06,LW,L,2017-18,81,6,17,23,0.28,5,82,7.32,27,65940.0,13:34,89,110,199,44.72,27,53,23,10,13,0,1,1,266.0,0:3,0,0,0,8809.0,1:48,660000
8471490,Adam,Cracknell,1985-07-15,RW,R,2017-18,5,0,0,0,0.0,-1,6,0.0,0,2313.0,7:42,3,3,6,50.0,12,1,3,2,1,0,0,0,0.0,0:0,0,0,0,283.0,0:56,675000
8471498,Jannik,Hansen,1986-03-15,RW,R,2017-18,46,2,13,15,0.33,2,54,3.7,15,33233.0,12:2,8,4,12,66.67,38,19,25,27,-2,0,0,0,216.0,0:4,0,1,1,2097.0,0:45,2500000
8471657,Cody,McLeod,1984-06-26,LW,L,2017-18,48,1,3,4,0.08,-11,36,2.78,111,21264.0,7:23,0,0,0,0.0,131,19,2,6,-4,0,0,0,25.0,0:0,0,0,0,15.0,0:0,1333333
8471663,Mike,Blunden,1986-12-15,RW,R,2017-18,1,0,0,0,0.0,0,1,0.0,0,391.0,6:31,0,0,0,0.0,6,0,0,0,0,0,0,0,0.0,0:0,0,0,0,0.0,0:0,737500
8471669,Paul,Stastny,1985-12-27,C,L,2017-18,82,16,37,53,0.65,1,159,10.06,18,90059.0,18:18,832,683,1515,54.92,43,38,43,19,24,3,6,9,12972.0,2:38,0,1,1,4865.0,0:59,7000000
8471675,Sidney,Crosby,1987-08-07,C,L,2017-18,82,29,60,89,1.09,0,247,11.74,46,101791.0,20:41,1026,909,1935,53.02,75,36,42,76,-34,9,29,38,17960.0,3:39,0,0,0,1266.0,0:15,8700000
8471676,Bobby,Ryan,1987-03-17,RW,R,2017-18,62,11,22,33,0.53,-12,112,9.82,14,61163.0,16:26,12,10,22,54.55,97,52,24,37,-13,1,3,4,10074.0,2:42,0,0,0,30.0,0:0,7250000
8471677,Jack,Johnson,1987-01-13,D,L,2017-18,77,3,8,11,0.14,-6,88,3.41,22,90304.0,19:32,0,0,0,0.0,101,135,20,23,-3,0,0,0,666.0,0:8,0,0,0,9664.0,2:5,4357143
8471678,Benoit,Pouliot,1986-09-29,LW,L,2017-18,74,13,6,19,0.26,-8,83,15.66,22,60751.0,13:40,12,21,33,36.36,69,34,35,31,4,1,0,1,2818.0,0:38,2,0,2,7415.0,1:40,4000000
8471685,Anze,Kopitar,1987-08-24,C,L,2017-18,82,35,57,92,1.12,21,200,17.5,20,108658.0,22:5,983,833,1816,54.13,50,64,54,70,-16,7,20,27,14202.0,2:53,0,2,2,10685.0,2:10,10000000
8471686,Marc,Staal,1987-01-13,D,L,2017-18,72,1,7,8,0.11,11,68,1.47,18,80059.0,18:31,0,0,0,0.0,76,96,32,43,-11,0,0,0,166.0,0:2,0,0,0,12202.0,2:49,5700000
8471691,Martin,Hanzal,1987-02-20,C,L,2017-18,38,5,5,10,0.26,-16,62,8.06,23,32168.0,14:6,239,195,434,55.07,66,21,10,10,0,2,1,3,3791.0,1:39,0,0,0,3923.0,1:43,4750000
8471698,T.J.,Oshie,1986-12-23,RW,R,2017-18,74,18,29,47,0.64,2,127,14.17,31,81747.0,18:24,101,110,211,47.87,124,54,51,39,12,9,9,18,14945.0,3:21,0,0,0,3487.0,0:47,5750000
8471699,Andrew,Cogliano,1987-06-14,LW,L,2017-18,80,12,23,35,0.44,19,175,6.86,41,72970.0,15:12,35,36,71,49.3,80,31,24,41,-17,0,0,0,519.0,0:6,3,1,4,8251.0,1:43,3000000
8471702,Matt,Niskanen,1986-12-06,D,R,2017-18,68,7,22,29,0.43,24,120,5.83,36,92237.0,22:36,0,0,0,0.0,117,98,18,73,-55,0,0,0,2088.0,0:30,0,1,1,11099.0,2:43,5750000
8471707,James,Neal,1987-09-03,LW,L,2017-18,71,25,19,44,0.62,-11,202,12.38,24,73166.0,17:10,0,2,2,0.0,44,30,49,32,17,5,4,9,10430.0,2:26,0,0,0,135.0,0:1,5000000
8471709,Marc-Edouard,Vlasic,1987-03-30,D,L,2017-18,81,11,21,32,0.4,9,161,6.83,34,109586.0,22:32,0,1,1,0.0,26,174,20,55,-35,1,2,3,5477.0,1:7,0,1,1,13683.0,2:48,4250000
8471710,Taylor,Chorney,1987-04-27,D,L,2017-18,25,1,3,4,0.16,10,14,7.14,8,19707.0,13:8,0,0,0,0.0,21,31,4,12,-8,0,0,0,0.0,0:0,0,1,1,2601.0,1:44,800000
8471716,Justin,Abdelkader,1987-02-25,LW,L,2017-18,75,13,22,35,0.47,-11,110,11.82,78,74479.0,16:33,47,50,97,48.45,174,40,21,34,-13,4,5,9,10545.0,2:20,0,0,0,6227.0,1:23,4250000
8471717,Adam,McQuaid,1986-10-12,D,R,2017-18,38,1,3,4,0.11,-1,39,2.56,62,35803.0,15:42,0,0,0,0.0,80,56,7,13,-6,0,0,0,39.0,0:1,0,0,0,4780.0,2:5,2750000
8471724,Kris,Letang,1987-04-24,D,R,2017-18,79,9,42,51,0.65,-9,222,4.05,56,120058.0,25:19,0,1,1,0.0,109,108,53,89,-36,4,16,20,14711.0,3:6,0,1,1,12274.0,2:35,7250000
8471729,Kris,Russell,1987-05-02,D,L,2017-18,78,4,17,21,0.27,-7,90,4.44,8,89240.0,19:4,0,0,0,0.0,97,223,20,72,-52,0,2,2,1229.0,0:15,0,0,0,9439.0,2:1,4000000
8471735,Keith,Yandle,1986-09-09,D,L,2017-18,82,8,48,56,0.68,7,179,4.47,35,120486.0,24:29,0,0,0,0.0,26,101,42,129,-87,1,17,18,16231.0,3:17,0,2,2,10999.0,2:14,6350000
8471742,Cody,Franson,1987-08-08,D,R,2017-18,23,1,6,7,0.3,-1,51,1.96,8,22930.0,16:36,0,0,0,0.0,18,18,7,21,-14,0,4,4,3006.0,2:10,0,0,0,70.0,0:3,1000000
8471743,Vladimir,Sobotka,1987-07-02,LW,L,2017-18,81,11,20,31,0.38,-6,136,8.09,50,83224.0,17:7,191,161,352,54.26,127,45,21,14,7,0,3,3,8067.0,1:39,1,0,1,5572.0,1:8,3500000
8471761,Chris,Butler,1986-10-27,D,L,2017-18,6,0,0,0,0.0,1,2,0.0,2,4790.0,13:18,0,0,0,0.0,3,3,0,2,-2,0,0,0,117.0,0:19,0,0,0,118.0,0:19,650000
8471766,Jared,Boll,1986-05-13,RW,R,2017-18,10,1,0,1,0.1,0,4,25.0,16,2655.0,4:25,0,0,0,0.0,9,0,0,0,0,0,0,0,38.0,0:3,0,0,0,0.0,0:0,900000
8471768,Tom,Pyatt,1987-02-14,LW,L,2017-18,81,7,15,22,0.27,-12,103,6.8,10,68302.0,14:3,17,34,51,33.33,55,93,24,18,6,0,0,0,70.0,0:0,1,1,2,9940.0,2:2,1100000
8471769,Niklas,Hjalmarsson,1987-06-06,D,L,2017-18,48,1,8,9,0.19,-3,32,3.12,18,59610.0,20:41,0,0,0,0.0,16,118,16,37,-21,0,1,1,687.0,0:14,0,0,0,7112.0,2:28,4100000
8471794,Darren,Helm,1987-01-21,LW,L,2017-18,75,13,18,31,0.41,3,141,9.22,39,70048.0,15:33,45,57,102,44.12,131,36,38,33,5,0,0,0,573.0,0:7,2,2,4,9040.0,2:0,3850000
8471804,Nathan,Gerbe,1987-07-24,C,L,2017-18,2,0,0,0,0.0,-1,1,0.0,0,1032.0,8:36,0,0,0,0.0,4,0,0,0,0,0,0,0,0.0,0:0,0,0,0,0.0,0:0,750000
8471811,Cal,O'Reilly,1986-09-30,C,L,2017-18,1,0,0,0,0.0,0,1,0.0,0,496.0,8:16,2,3,5,40.0,0,1,1,0,1,0,0,0,0.0,0:0,0,0,0,20.0,0:20,700000
8471817,Ryan,Reaves,1987-01-20,RW,R,2017-18,79,4,6,10,0.13,-7,42,9.52,94,36004.0,7:35,14,14,28,50.0,236,27,12,10,2,0,0,0,183.0,0:2,0,0,0,8.0,0:0,1125000
8471873,Anton,Stralman,1986-08-01,D,R,2017-18,80,4,14,18,0.22,29,131,3.05,18,103137.0,21:29,0,0,0,0.0,104,100,31,29,2,0,0,0,2005.0,0:25,0,0,0,13123.0,2:44,4500000
8471887,Patric,Hornqvist,1987-01-01,RW,R,2017-18,70,29,20,49,0.7,2,247,11.74,58,72756.0,17:19,16,17,33,48.48,137,64,24,14,10,15,7,22,14813.0,3:31,0,0,0,177.0,0:2,4250000
8471958,Dan,Girardi,1984-04-29,D,R,2017-18,77,6,12,18,0.23,18,93,6.45,27,80320.0,17:23,0,1,1,0.0,133,155,15,27,-12,1,0,1,318.0,0:4,0,1,1,11511.0,2:29,5500000
8471976,David,Desharnais,1986-09-14,C,L,2017-18,71,6,22,28,0.39,-22,55,10.91,18,55622.0,13:3,386,315,701,55.06,22,36,26,26,0,2,5,7,6101.0,1:25,0,0,0,0.0,0:0,1000000
8472382,Andy,Greene,1982-10-30,D,L,2017-18,81,3,10,13,0.16,-9,93,3.23,21,102662.0,21:7,0,0,0,0.0,84,188,24,37,-13,0,0,0,377.0,0:4,0,0,0,15749.0,3:14,5000000
8473412,Bryan,Little,1987-11-12,C,R,2017-18,82,16,27,43,0.52,2,129,12.4,28,83314.0,16:56,732,574,1306,56.05,50,33,37,20,17,2,10,12,10724.0,2:10,0,0,0,5093.0,1:2,4700000
8473415,Alex,Biega,1988-04-04,D,R,2017-18,44,1,8,9,0.2,3,79,1.27,32,39654.0,15:1,0,0,0,0.0,126,53,9,20,-11,0,0,0,88.0,0:2,0,1,1,2080.0,0:47,750000
8473419,Brad,Marchand,1988-05-11,LW,L,2017-18,68,34,51,85,1.25,25,182,18.68,63,80441.0,19:42,50,76,126,39.68,37,25,58,76,-18,8,15,23,12585.0,3:5,1,3,4,7373.0,1:48,6125000
8473422,Nick,Foligno,1987-10-31,LW,L,2017-18,72,15,18,33,0.46,1,137,10.95,50,79273.0,18:21,340,401,741,45.88,182,60,34,35,-1,2,2,4,10319.0,2:23,0,0,0,5199.0,1:12,5500000
8473432,Derek,Dorsett,1986-12-20,RW,R,2017-18,20,7,2,9,0.45,-1,26,26.92,74,18338.0,15:16,0,3,3,0.0,39,14,4,2,2,0,0,0,88.0,0:4,2,0,2,3244.0,2:42,2650000
8473440,Will,O'Neill,1988-04-28,D,L,2017-18,1,0,0,0,0.0,0,3,0.0,0,565.0,9:25,0,0,0,0.0,0,0,0,0,0,0,0,0,0.0,0:0,0,0,0,0.0,0:0,612500
8473446,Erik,Johnson,1988-03-21,D,R,2017-18,62,9,16,25,0.4,2,168,5.36,58,94622.0,25:26,0,1,1,0.0,114,135,41,39,2,0,3,3,6596.0,1:46,0,1,1,13658.0,3:40,6000000
8473449,Kyle,Okposo,1988-04-16,RW,R,2017-18,76,15,29,44,0.58,-34,161,9.32,40,77644.0,17:1,23,27,50,46.0,70,34,24,28,-4,6,15,21,15553.0,3:24,0,0,0,525.0,0:6,6000000
8473453,Trevor,Lewis,1987-01-08,C,R,2017-18,68,14,12,26,0.38,-6,134,10.45,25,62157.0,15:14,47,62,109,43.12,125,32,19,14,5,1,2,3,2003.0,0:29,2,0,2,6789.0,1:39,2000000
8473463,Leo,Komarov,1987-01-23,C,L,2017-18,74,7,12,19,0.26,0,114,6.14,31,70094.0,15:47,112,100,212,52.83,219,48,47,42,5,2,1,3,3101.0,0:41,1,0,1,11450.0,2:34,2950000
8473465,Jamie,McGinn,1988-08-05,LW,L,2017-18,76,13,16,29,0.38,-5,116,11.21,33,61351.0,13:27,7,19,26,26.92,120,22,20,35,-15,4,2,6,7198.0,1:34,0,0,0,90.0,0:1,3333333
8473468,Eric,Gryba,1988-04-14,D,R,2017-18,21,0,2,2,0.1,4,19,0.0,31,18564.0,14:44,0,0,0,0.0,57,19,9,11,-2,0,0,0,0.0,0:0,0,0,0,1825.0,1:26,900000
8473473,Milan,Lucic,1988-06-07,LW,L,2017-18,82,10,24,34,0.41,-12,147,6.8,80,78526.0,15:57,29,23,52,55.77,254,25,29,76,-47,3,4,7,10494.0,2:7,0,0,0,79.0,0:0,6000000
8473485,Chris,Stewart,1987-10-30,RW,R,2017-18,54,10,6,16,0.3,-5,68,14.71,27,34805.0,10:44,3,7,10,30.0,48,14,7,10,-3,1,0,1,1321.0,0:24,0,0,0,33.0,0:0,1150000
8473492,Matt,Beleskey,1988-06-07,LW,L,2017-18,15,0,0,0,0.0,-9,17,0.0,21,9877.0,10:58,2,7,9,22.22,34,5,5,2,3,0,0,0,844.0,0:56,0,0,0,356.0,0:23,3800000
8473504,Cal,Clutterbuck,1987-11-18,RW,R,2017-18,76,8,10,18,0.24,-7,101,7.92,53,58317.0,12:47,7,13,20,35.0,226,53,14,31,-17,0,0,0,428.0,0:5,1,0,1,9641.0,2:6,3500000
8473507,Jeff,Petry,1987-12-09,D,R,2017-18,82,12,30,42,0.51,-30,178,6.74,28,115595.0,23:29,0,1,1,0.0,167,138,41,102,-61,6,17,23,13699.0,2:47,0,0,0,11653.0,2:22,5500000
8473512,Claude,Giroux,1988-01-12,C,R,2017-18,82,34,68,102,1.24,28,193,17.62,20,100188.0,20:21,638,450,1088,58.64,30,23,34,44,-10,9,27,36,17114.0,3:28,0,0,0,3911.0,0:47,8275000
8473533,Jordan,Staal,1988-09-10,C,L,2017-18,79,19,27,46,0.58,-4,160,11.88,26,91249.0,19:15,757,581,1338,56.58,181,32,58,44,14,4,8,12,12311.0,2:35,2,0,2,8220.0,1:44,6000000
8473534,Patrik,Berglund,1988-06-02,C,L,2017-18,57,17,9,26,0.46,-5,112,15.18,30,55253.0,16:9,173,141,314,55.1,111,36,22,11,11,3,3,6,5885.0,1:43,1,0,1,3194.0,0:56,3850000
8473544,Derick,Brassard,1987-09-22,C,L,2017-18,72,21,25,46,0.64,0,197,10.66,34,76605.0,17:43,516,534,1050,49.14,96,25,42,40,2,5,1,6,10919.0,2:31,0,0,0,451.0,0:6,5000000
8473546,Michael,Grabner,1987-10-05,RW,L,2017-18,80,27,9,36,0.45,11,167,16.17,16,71127.0,14:49,10,12,22,45.45,68,37,46,33,13,0,1,1,265.0,0:3,2,1,3,9795.0,2:2,1650000
8473548,Phil,Kessel,1987-10-02,RW,R,2017-18,82,34,58,92,1.12,-4,261,13.03,36,91935.0,18:41,6,13,19,31.58,10,17,26,60,-34,12,30,42,18571.0,3:46,0,0,0,129.0,0:1,8000000
8473560,Korbinian,Holzer,1988-02-16,D,R,2017-18,16,0,0,0,0.0,-3,10,0.0,6,11151.0,11:36,0,0,0,0.0,22,14,1,9,-8,0,0,0,0.0,0:0,0,0,0,896.0,0:56,900000
8473563,Nicklas,Backstrom,1987-11-23,C,L,2017-18,81,21,50,71,0.88,5,165,12.73,46,95550.0,19:39,702,669,1371,51.2,37,51,44,58,-14,7,19,26,17090.0,3:30,0,0,0,4446.0,0:54,6700000
8473564,Michael,Frolik,1988-02-17,RW,L,2017-18,70,10,15,25,0.36,-19,167,5.99,26,71075.0,16:55,33,39,72,45.83,48,35,43,26,17,0,0,0,2450.0,0:35,2,0,2,8480.0,2:1,4300000
8473573,Artem,Anisimov,1988-05-24,C,L,2017-18,72,20,11,31,0.43,-17,130,15.38,22,72527.0,16:47,416,494,910,45.71,15,40,18,26,-8,11,1,12,11751.0,2:43,1,0,1,6312.0,1:27,4550000
8473574,Shawn,Matthias,1988-02-19,LW,L,2017-18,27,1,2,3,0.11,-1,26,3.85,10,18100.0,11:10,12,16,28,42.86,22,14,7,3,4,0,0,0,140.0,0:5,0,0,0,2208.0,1:21,2125000
8473579,Nikolay,Kulemin,1986-07-14,LW,L,2017-18,13,1,2,3,0.23,0,7,14.29,0,9311.0,11:56,4,6,10,40.0,16,15,1,8,-7,0,0,0,46.0,0:3,0,0,0,1899.0,2:26,4187500
8473584,Andrew,MacDonald,1986-09-07,D,L,2017-18,66,6,15,21,0.32,8,82,7.32,30,78611.0,19:51,0,0,0,0.0,36,131,16,46,-30,0,0,0,588.0,0:8,0,1,1,7092.0,1:47,5000000
8473604,Jonathan,Toews,1988-04-29,C,L,2017-18,74,20,32,52,0.7,-1,211,9.48,47,87426.0,19:41,900,653,1553,57.95,32,24,53,42,11,2,10,12,13960.0,3:8,0,0,0,7564.0,1:42,10500000
8473618,Mathieu,Perreault,1988-01-05,C,L,2017-18,70,17,22,39,0.56,4,139,12.23,38,60725.0,14:27,33,26,59,55.93,120,25,42,25,17,6,8,14,9425.0,2:14,0,1,1,100.0,0:1,4125000
8473673,David,Schlemko,1987-05-07,D,L,2017-18,37,1,4,5,0.14,3,38,2.63,6,40104.0,18:3,0,0,0,0.0,33,72,13,27,-14,0,2,2,2306.0,1:2,0,0,0,2519.0,1:8,2100000
8473914,Mark,Letestu,1985-02-04,C,R,2017-18,80,9,14,23,0.29,-17,111,8.11,10,61671.0,12:50,473,414,887,53.33,62,32,19,20,-1,3,3,6,8523.0,1:46,2,1,3,8816.0,1:50,1800000
8473933,Ben,Lovejoy,1984-02-20,D,R,2017-18,57,2,6,8,0.14,7,74,2.7,25,56738.0,16:35,0,0,0,0.0,84,86,22,27,-5,0,0,0,162.0,0:2,0,1,1,10241.0,2:59,2666667
8473986,Alex,Killorn,1989-09-14,LW,L,2017-18,82,15,32,47,0.57,22,156,9.62,45,81170.0,16:29,22,33,55,40.0,82,25,32,32,0,2,7,9,14034.0,2:51,0,0,0,8293.0,1:41,4450000
8473991,Karl,Alzner,1988-09-24,D,L,2017-18,82,1,11,12,0.15,-7,84,1.19,40,98796.0,20:4,0,0,0,0.0,141,144,22,90,-68,0,0,0,99.0,0:1,0,1,1,14077.0,2:51,4625000
8473992,Justin,Falk,1988-10-11,D,L,2017-18,46,1,1,2,0.04,-16,36,2.78,28,44404.0,16:5,0,0,0,0.0,121,62,3,12,-9,0,0,0,85.0,0:1,0,1,1,4393.0,1:35,650000
8473994,Jamie,Benn,1989-07-18,LW,L,2017-18,82,36,43,79,0.96,21,241,14.94,54,97529.0,19:49,381,345,726,52.48,140,62,63,66,-3,9,13,22,15007.0,3:3,1,1,2,6812.0,1:23,9500000
8474000,Steven,Kampfer,1988-09-24,D,R,2017-18,22,0,1,1,0.05,-7,31,0.0,20,22772.0,17:15,0,0,0,0.0,46,41,6,11,-5,0,0,0,64.0,0:2,0,0,0,2485.0,1:52,650000
8474008,Paul,Carey,1988-09-24,C,L,2017-18,60,7,7,14,0.23,-13,51,13.73,20,36936.0,10:15,19,22,41,46.34,67,22,21,31,-10,1,0,1,87.0,0:1,1,0,1,1767.0,0:29,650000
8474009,Nick,Bonino,1988-04-20,C,L,2017-18,71,12,13,25,0.35,4,83,14.46,20,66608.0,15:38,527,443,970,54.33,18,72,64,33,31,0,0,0,2897.0,0:40,0,0,0,8876.0,2:5,4100000
8474013,Ian,Cole,1989-02-21,D,L,2017-18,67,5,15,20,0.3,14,84,5.95,76,71457.0,17:46,0,0,0,0.0,95,116,21,27,-6,0,1,1,95.0,0:1,0,0,0,8999.0,2:14,2100000
8474018,Christopher,DiDomenico,1989-02-20,LW,R,2017-18,24,6,4,10,0.42,-4,23,26.09,8,16972.0,11:47,6,13,19,31.58,21,14,10,8,2,2,2,4,2187.0,1:31,0,0,0,0.0,0:0,-111
8474024,Jim,O'Brien,1989-01-29,C,R,2017-18,10,0,1,1,0.1,-1,11,0.0,0,5253.0,8:45,27,37,64,42.19,10,5,2,2,0,0,0,0,0.0,0:0,0,0,0,278.0,0:27,650000
8474027,Justin,Braun,1987-02-10,D,R,2017-18,81,5,28,33,0.41,7,115,4.35,28,103656.0,21:19,0,0,0,0.0,143,152,32,35,-3,0,0,0,407.0,0:5,0,0,0,13072.0,2:41,3800000
8474031,Kevin,Shattenkirk,1989-01-29,D,R,2017-18,46,5,18,23,0.5,-14,94,5.32,44,55949.0,20:16,0,0,0,0.0,44,65,24,61,-37,2,10,12,8802.0,3:11,0,0,0,207.0,0:4,6650000
8474034,Patrick,Maroon,1988-04-23,LW,L,2017-18,74,17,26,43,0.58,1,141,12.06,73,73420.0,16:32,11,13,24,45.83,150,14,22,37,-15,1,6,7,8961.0,2:1,0,0,0,35.0,0:0,2000000
8474037,James,van Riemsdyk,1989-05-04,LW,L,2017-18,81,36,18,54,0.67,1,248,14.52,30,72385.0,14:53,0,1,1,0.0,40,23,30,38,-8,11,9,20,11095.0,2:16,0,0,0,87.0,0:1,4250000
8474038,Paul,Byron,1989-04-27,LW,L,2017-18,82,20,15,35,0.43,-4,115,17.39,23,79337.0,16:7,40,68,108,37.04,137,55,45,36,9,2,2,4,5521.0,1:7,1,1,2,9087.0,1:50,1166667
8474040,Sam,Gagner,1989-08-10,C,R,2017-18,74,10,21,31,0.42,-18,164,6.1,35,67093.0,15:6,220,241,461,47.72,54,28,17,22,-5,3,8,11,9010.0,2:1,0,0,0,460.0,0:6,3150000
8474053,Logan,Couture,1989-03-28,C,L,2017-18,78,34,27,61,0.78,-2,204,16.67,18,86802.0,18:32,149,176,325,45.85,33,72,55,52,3,10,11,21,14562.0,3:6,2,1,3,6546.0,1:23,6000000
8474056,P.K.,Subban,1989-05-13,D,R,2017-18,82,16,43,59,0.72,18,207,7.73,82,118644.0,24:6,1,2,3,33.33,111,90,44,97,-53,5,20,25,15203.0,3:5,0,1,1,13021.0,2:38,9000000
8474062,Riley,Nash,1989-05-09,C,R,2017-18,76,15,26,41,0.54,16,113,13.27,18,70266.0,15:24,459,490,949,48.37,86,67,55,14,41,2,1,3,1910.0,0:25,0,0,0,8715.0,1:54,900000
8474066,Thomas,Hickey,1989-02-08,D,L,2017-18,69,5,20,25,0.36,20,87,5.75,24,74822.0,18:4,0,0,0,0.0,76,110,14,60,-46,0,0,0,415.0,0:6,0,0,0,8688.0,2:5,2200000
8474068,Kyle,Turris,1989-08-14,C,R,2017-18,76,16,35,51,0.67,19,145,11.03,26,75761.0,16:36,449,423,872,51.49,21,35,38,33,5,7,14,21,10573.0,2:19,0,0,0,488.0,0:6,3500000
8474074,Paul,Postma,1989-02-22,D,R,2017-18,14,0,1,1,0.07,-2,14,0.0,2,8590.0,10:13,0,0,0,0.0,13,10,1,4,-3,0,0,0,685.0,0:48,0,0,0,18.0,0:1,725000
8474089,Brad,Malone,1989-05-20,C,L,2017-18,7,0,0,0,0.0,0,9,0.0,6,3355.0,7:59,21,10,31,67.74,19,3,2,3,-1,0,0,0,11.0,0:1,0,0,0,231.0,0:33,650000
8474090,Brendan,Smith,1989-02-08,D,L,2017-18,44,1,7,8,0.18,2,66,1.52,69,45322.0,17:10,0,0,0,0.0,58,37,23,46,-23,0,1,1,138.0,0:3,0,0,0,3780.0,1:25,4350000
8474091,Brandon,Sutter,1989-02-14,C,R,2017-18,61,11,15,26,0.43,8,106,10.38,8,63375.0,17:18,570,532,1102,51.72,55,32,29,14,15,0,0,0,774.0,0:12,0,4,4,11343.0,3:5,4375000
8474098,Colton,Sceviour,1989-04-20,C,R,2017-18,76,11,13,24,0.32,6,141,7.8,24,61284.0,13:26,77,81,158,48.73,84,69,31,32,-1,0,0,0,266.0,0:3,1,2,3,10702.0,2:20,950000
8474102,David,Perron,1988-05-28,LW,R,2017-18,70,16,50,66,0.94,1,125,12.8,50,74795.0,17:48,96,142,238,40.34,118,20,48,33,15,1,17,18,10608.0,2:31,0,0,0,859.0,0:12,3750000
8474125,Carl,Gunnarsson,1986-11-09,D,L,2017-18,63,5,4,9,0.14,15,59,8.47,22,61107.0,16:9,0,0,0,0.0,35,102,7,22,-15,0,0,0,153.0,0:2,0,0,0,4837.0,1:16,2900000
8474131,Mario,Kempe,1988-09-19,RW,L,2017-18,18,2,2,4,0.22,-1,20,10.0,4,11975.0,11:5,27,43,70,38.57,20,11,3,3,0,0,0,0,5.0,0:0,0,0,0,764.0,0:42,650000
8474134,Yannick,Weber,1988-09-23,D,R,2017-18,47,2,3,5,0.11,2,40,5.0,16,34002.0,12:3,0,0,0,0.0,47,35,4,13,-9,0,0,0,49.0,0:1,0,0,0,294.0,0:6,650000
8474141,Patrick,Kane,1988-11-19,RW,L,2017-18,82,27,49,76,0.93,-20,285,9.47,32,99318.0,20:11,7,11,18,38.89,18,14,47,33,14,5,17,22,16767.0,3:24,0,0,0,359.0,0:4,10500000
8474145,Robert,Bortuzzo,1989-03-18,D,R,2017-18,72,4,9,13,0.18,11,76,5.26,41,63947.0,14:48,0,0,0,0.0,121,108,5,17,-12,0,0,0,148.0,0:2,0,0,0,5878.0,1:21,1150000
8474149,Evgenii,Dadonov,1989-03-12,RW,L,2017-18,74,28,37,65,0.88,10,188,14.89,8,83023.0,18:41,0,0,0,0.0,27,33,46,45,1,6,7,13,14747.0,3:19,0,0,0,14.0,0:0,4000000
8474150,Mikael,Backlund,1989-03-17,C,L,2017-18,82,14,31,45,0.55,-21,214,6.54,78,93593.0,19:1,705,705,1410,50.0,54,40,81,48,33,3,8,11,10525.0,2:8,1,2,3,11669.0,2:22,3575000
8474151,Ryan,McDonagh,1989-06-13,D,L,2017-18,63,4,25,29,0.46,8,99,4.04,20,88179.0,23:19,0,0,0,0.0,71,163,44,60,-16,1,8,9,6516.0,1:43,0,1,1,11662.0,3:5,4700000
8474157,Max,Pacioretty,1988-11-20,LW,L,2017-18,64,17,20,37,0.58,-16,212,8.02,30,73007.0,19:0,7,13,20,35.0,118,27,24,40,-16,6,9,15,11899.0,3:5,1,0,1,6563.0,1:42,4500000
8474161,Jakub,Voracek,1989-08-15,RW,L,2017-18,82,20,65,85,1.04,10,228,8.77,50,95729.0,19:27,15,19,34,44.12,23,32,33,65,-32,5,30,35,17180.0,3:29,0,0,0,133.0,0:1,8250000
8474162,Jake,Muzzin,1989-02-21,D,L,2017-18,74,8,34,42,0.57,10,154,5.19,40,96131.0,21:39,0,0,0,0.0,170,123,17,59,-42,4,10,14,9984.0,2:14,0,1,1,10416.0,2:20,4000000
8474166,Alec,Martinez,1987-07-26,D,L,2017-18,77,9,16,25,0.32,3,111,8.11,34,105625.0,22:51,0,1,1,0.0,100,206,11,81,-70,2,9,11,9004.0,1:56,0,1,1,10971.0,2:22,4000000
8474176,Carl,Hagelin,1988-08-23,LW,L,2017-18,81,10,21,31,0.38,8,169,5.92,28,77478.0,15:56,21,28,49,42.86,112,36,46,25,21,0,0,0,265.0,0:3,1,1,2,12333.0,2:32,4000000
8474189,Lars,Eller,1989-05-08,C,L,2017-18,81,18,20,38,0.47,-6,161,11.18,38,74361.0,15:18,471,485,956,49.27,71,69,39,47,-8,3,3,6,5722.0,1:10,0,0,0,8788.0,1:48,3500000
8474190,Wayne,Simmonds,1988-08-26,RW,R,2017-18,75,24,22,46,0.61,-16,176,13.64,57,81394.0,18:5,12,9,21,57.14,129,54,38,27,11,11,6,17,14910.0,3:18,1,0,1,3858.0,0:51,3975000
8474207,Nick,Holden,1987-05-15,D,L,2017-18,73,4,13,17,0.23,-5,80,5.0,14,83247.0,19:0,0,0,0,0.0,136,83,26,39,-13,0,3,3,2151.0,0:29,0,0,0,8807.0,2:0,1650000
8474218,Jason,Demers,1988-06-09,D,R,2017-18,69,6,14,20,0.29,-4,95,6.32,37,87503.0,21:8,0,0,0,0.0,66,79,20,36,-16,0,3,3,4349.0,1:3,0,0,0,8168.0,1:58,4500000
8474230,Micheal,Haley,1986-03-30,C,L,2017-18,75,3,6,9,0.12,-13,55,5.45,212,35059.0,7:47,19,21,40,47.5,124,23,8,14,-6,0,0,0,141.0,0:1,0,0,0,322.0,0:4,825000
8474250,Zack,Smith,1988-04-05,LW,L,2017-18,68,5,14,19,0.28,-32,124,4.03,54,68217.0,16:43,297,323,620,47.9,90,29,27,29,-2,0,3,3,6191.0,1:31,0,1,1,5851.0,1:26,3250000
8474291,Jay,Beagle,1985-10-16,C,R,2017-18,79,7,15,22,0.28,3,65,10.77,16,58995.0,12:26,584,414,998,58.52,69,44,25,10,15,0,0,0,118.0,0:1,1,0,1,11964.0,2:31,1750000
8474520,Jason,Garrison,1984-11-13,D,L,2017-18,8,0,1,1,0.12,-2,7,0.0,4,9152.0,19:4,0,0,0,0.0,7,23,3,7,-4,0,0,0,70.0,0:8,0,0,0,839.0,1:44,4600000
8474563,Drew,Doughty,1989-12-08,D,R,2017-18,82,10,50,60,0.73,23,205,4.88,54,132031.0,26:50,0,1,1,0.0,127,128,17,79,-62,3,17,20,15515.0,3:9,1,0,1,13557.0,2:45,7000000
8474564,Steven,Stamkos,1990-02-07,C,R,2017-18,78,27,59,86,1.1,18,212,12.74,72,87864.0,18:46,466,426,892,52.24,61,35,27,50,-23,15,18,33,16151.0,3:27,0,0,0,1909.0,0:24,8500000
8474565,Alex,Pietrangelo,1990-01-18,D,R,2017-18,78,15,39,54,0.69,8,216,6.94,22,120447.0,25:44,0,0,0,0.0,48,164,54,41,13,3,10,13,14229.0,3:2,0,1,1,10910.0,2:19,6500000
8474567,Zach,Bogosian,1990-07-15,D,R,2017-18,18,0,1,1,0.06,-9,29,0.0,20,20689.0,19:9,0,0,0,0.0,22,23,3,9,-6,0,0,0,959.0,0:53,0,0,0,1198.0,1:6,5142857
8474568,Luke,Schenn,1989-11-02,D,R,2017-18,64,1,6,7,0.11,-12,59,1.69,35,62916.0,16:23,0,0,0,0.0,219,105,14,31,-17,0,0,0,101.0,0:1,0,0,0,7387.0,1:55,1250000
8474569,Colin,Wilson,1989-10-20,C,L,2017-18,56,6,12,18,0.32,-5,75,8.0,6,44125.0,13:7,60,55,115,52.17,38,23,11,13,-2,1,5,6,6739.0,2:0,0,0,0,111.0,0:1,3937500
8474571,Mikkel,Boedker,1989-12-16,LW,L,2017-18,74,15,22,37,0.5,0,119,12.61,12,59304.0,13:21,5,14,19,26.32,41,24,29,26,3,4,4,8,6099.0,1:22,0,0,0,73.0,0:0,4000000
8474573,Josh,Bailey,1989-10-02,RW,L,2017-18,76,18,53,71,0.93,-20,151,11.92,17,81551.0,17:53,11,39,50,22.0,12,33,45,62,-17,5,26,31,13730.0,3:0,0,0,0,1197.0,0:15,3300000
8474574,Tyler,Myers,1990-02-01,D,R,2017-18,82,6,30,36,0.44,9,150,4.0,48,105417.0,21:25,0,0,0,0.0,68,119,32,77,-45,3,14,17,10191.0,2:4,1,0,1,12772.0,2:35,5500000
8474578,Erik,Karlsson,1990-05-31,D,R,2017-18,71,9,53,62,0.87,-25,196,4.59,36,113914.0,26:44,0,0,0,0.0,58,120,55,86,-31,3,15,18,14149.0,3:19,0,1,1,6198.0,1:27,6500000
8474579,Luca,Sbisa,1990-01-30,D,L,2017-18,30,2,12,14,0.47,8,26,7.69,15,35137.0,19:31,0,0,0,0.0,50,54,12,16,-4,0,0,0,432.0,0:14,0,1,1,4265.0,2:22,3600000
8474581,Jake,Gardiner,1990-07-04,D,L,2017-18,82,5,47,52,0.63,9,133,3.76,32,110824.0,22:31,0,0,0,0.0,51,103,39,105,-66,1,14,15,10183.0,2:4,0,0,0,1833.0,0:22,4050000
8474584,Michael,Del Zotto,1990-06-24,D,L,2017-18,82,6,16,22,0.27,-8,128,4.69,48,102356.0,20:48,0,0,0,0.0,244,127,22,67,-45,0,5,5,4494.0,0:54,0,0,0,10600.0,2:9,3000000
8474586,Jordan,Eberle,1990-05-15,C,R,2017-18,81,25,34,59,0.73,5,183,13.66,21,78091.0,16:4,12,21,33,36.36,46,30,38,38,0,3,7,10,9467.0,1:56,0,0,0,132.0,0:1,6000000
8474589,Tyler,Ennis,1989-10-06,LW,L,2017-18,73,8,14,22,0.3,-1,115,6.96,12,52443.0,11:58,3,9,12,25.0,51,33,30,11,19,2,1,3,2457.0,0:33,0,0,0,15.0,0:0,4600000
8474590,John,Carlson,1990-01-10,D,R,2017-18,82,15,53,68,0.83,0,237,6.33,32,121926.0,24:46,0,1,1,0.0,47,146,58,97,-39,4,28,32,18223.0,3:42,0,0,0,12929.0,2:37,3966667
8474600,Roman,Josi,1990-06-01,D,L,2017-18,75,14,39,53,0.71,24,253,5.53,24,110117.0,24:28,0,0,0,0.0,80,120,30,59,-29,7,13,20,13001.0,2:53,0,1,1,13716.0,3:2,4000000
8474602,Justin,Schultz,1990-07-06,D,R,2017-18,63,4,23,27,0.43,22,109,3.67,14,73759.0,19:30,0,0,0,0.0,36,93,17,27,-10,0,10,10,8656.0,2:17,0,0,0,430.0,0:6,5500000
8474604,Aaron,Ness,1990-05-18,D,L,2017-18,8,0,1,1,0.12,2,2,0.0,8,6109.0,12:43,0,0,0,0.0,1,8,1,2,-1,0,0,0,0.0,0:0,0,0,0,409.0,0:51,612500
8474610,Zac,Dalpe,1989-11-01,C,R,2017-18,12,0,0,0,0.0,-3,18,0.0,13,5358.0,7:26,7,17,24,29.17,6,4,3,2,1,0,0,0,173.0,0:14,0,0,0,0.0,0:0,725000
8474612,Travis,Hamonic,1990-08-16,D,R,2017-18,74,1,10,11,0.15,-9,107,0.93,79,91900.0,20:41,0,1,1,0.0,83,124,28,46,-18,0,0,0,385.0,0:5,0,0,0,12514.0,2:49,3857143
8474613,Derek,Stepan,1990-06-18,C,R,2017-18,82,14,42,56,0.68,-7,209,6.7,26,94795.0,19:16,740,810,1550,47.74,52,54,42,28,14,3,15,18,12794.0,2:36,2,0,2,5831.0,1:11,6500000
8474618,Marco,Scandella,1990-02-23,D,L,2017-18,82,5,17,22,0.27,-15,138,3.62,37,114719.0,23:19,0,0,0,0.0,91,114,24,41,-17,0,4,4,7426.0,1:30,0,1,1,13192.0,2:40,4000000
8474625,Jimmy,Hayes,1989-11-21,RW,R,2017-18,33,3,6,9,0.27,-2,37,8.11,6,23617.0,11:55,6,9,15,40.0,50,6,15,8,7,1,0,1,3070.0,1:33,0,0,0,28.0,0:0,2300000
8474627,Jori,Lehtera,1987-12-23,C,L,2017-18,62,3,5,8,0.13,-8,45,6.67,14,39114.0,10:30,85,64,149,57.05,55,21,14,13,1,0,0,0,2076.0,0:33,1,0,1,2779.0,0:44,4700000
8474628,Michael,Stone,1990-06-07,D,R,2017-18,82,3,7,10,0.12,-11,98,3.06,28,82396.0,16:44,0,0,0,0.0,106,158,15,31,-16,0,1,1,2839.0,0:34,0,0,0,12020.0,2:26,3500000
8474641,Adam,Henrique,1990-02-06,C,L,2017-18,81,24,26,50,0.62,11,151,15.89,20,86436.0,17:47,508,547,1055,48.15,61,61,40,29,11,6,7,13,12295.0,2:31,1,2,3,7676.0,1:34,4000000
8474642,Lance,Bouma,1990-03-25,LW,L,2017-18,53,3,6,9,0.17,1,56,5.36,36,33868.0,10:39,14,19,33,42.42,132,27,5,8,-3,0,1,1,847.0,0:15,0,0,0,2902.0,0:54,2200000
8474660,David,Warsofsky,1990-05-30,D,L,2017-18,16,0,5,5,0.31,4,18,0.0,0,12859.0,13:23,0,0,0,0.0,1,22,4,7,-3,0,0,0,55.0,0:3,0,0,0,782.0,0:48,675000
8474668,Dale,Weise,1988-08-05,RW,R,2017-18,46,4,4,8,0.17,-7,44,9.09,21,29180.0,10:34,1,1,2,50.0,77,14,13,8,5,0,0,0,1046.0,0:22,0,0,0,48.0,0:1,2350000
8474673,TJ,Brodie,1990-06-07,D,L,2017-18,73,4,28,32,0.44,-16,118,3.39,18,103719.0,23:40,0,0,0,0.0,24,99,48,68,-20,1,10,11,11047.0,2:31,0,0,0,9162.0,2:5,4650400
8474679,Gustav,Nyquist,1989-09-01,RW,L,2017-18,82,21,19,40,0.49,-2,213,9.86,20,87828.0,17:51,6,7,13,46.15,65,36,44,44,0,3,5,8,12079.0,2:27,0,0,0,30.0,0:0,4750000
8474683,Derek,Grant,1990-04-20,C,L,2017-18,66,12,12,24,0.36,3,65,18.46,11,43948.0,11:5,317,280,597,53.1,63,39,18,13,5,3,0,3,2465.0,0:37,0,1,1,3224.0,0:48,650000
8474685,Matt,Calvert,1989-12-24,LW,L,2017-18,69,9,15,24,0.35,-10,108,8.33,33,55377.0,13:22,15,29,44,34.09,61,35,28,15,13,1,0,1,1186.0,0:17,2,0,2,6350.0,1:32,2200000
8474688,Greg,Pateryn,1990-06-20,D,R,2017-18,73,1,12,13,0.18,6,100,1.0,50,85918.0,19:36,0,0,0,0.0,155,148,5,38,-33,0,0,0,245.0,0:3,0,0,0,11299.0,2:34,800000
8474697,Mark,Borowiecki,1989-07-12,D,L,2017-18,52,3,8,11,0.21,-6,66,4.55,64,45684.0,14:38,0,1,1,0.0,226,81,11,17,-6,0,0,0,33.0,0:0,0,0,0,3719.0,1:11,1100000
8474709,Matt,Martin,1989-05-08,LW,L,2017-18,50,3,9,12,0.24,0,46,6.52,50,23965.0,7:59,12,4,16,75.0,147,9,6,7,-1,0,0,0,49.0,0:0,0,0,0,0.0,0:0,2500000
8474715,Cam,Atkinson,1989-06-05,RW,R,2017-18,65,24,22,46,0.71,19,231,10.39,14,73716.0,18:54,21,44,65,32.31,32,29,31,19,12,3,7,10,10744.0,2:45,1,0,1,5547.0,1:25,3500000
8474716,Jared,Spurgeon,1989-11-29,D,R,2017-18,61,9,28,37,0.61,-6,110,8.18,8,89837.0,24:32,0,1,1,0.0,64,127,23,20,3,3,10,13,9595.0,2:37,0,0,0,10295.0,2:48,5187500
8474717,Mark,Barberio,1990-03-23,D,L,2017-18,46,3,10,13,0.28,6,52,5.77,31,47693.0,17:16,0,0,0,0.0,26,62,8,16,-8,0,1,1,445.0,0:9,1,1,2,5856.0,2:7,750000
8474722,Luke,Witkowski,1990-04-14,RW,R,2017-18,31,1,3,4,0.13,-1,16,6.25,68,12809.0,6:53,1,1,2,50.0,57,11,2,7,-5,0,0,0,8.0,0:0,0,0,0,120.0,0:3,750000
8474736,Zac,Rinaldo,1990-06-15,C,L,2017-18,53,5,2,7,0.13,-7,56,8.93,44,35883.0,11:17,4,11,15,26.67,188,23,6,7,-1,0,0,0,84.0,0:1,0,0,0,2344.0,0:44,700000
8474739,Tommy,Wingels,1988-04-12,C,R,2017-18,75,9,8,17,0.23,-11,86,10.47,45,51687.0,11:29,211,244,455,46.37,179,41,21,19,2,1,0,1,1270.0,0:16,2,0,2,5705.0,1:16,750000
8474743,Zach,Redmond,1988-07-26,D,R,2017-18,3,0,0,0,0.0,1,7,0.0,2,2606.0,14:28,0,0,0,0.0,4,2,1,0,1,0,0,0,3.0,0:1,0,0,0,34.0,0:11,612500
8474749,Matt,Bartkowski,1988-06-04,D,L,2017-18,18,0,3,3,0.17,-3,21,0.0,4,14413.0,13:20,0,0,0,0.0,31,13,3,18,-15,0,0,0,10.0,0:0,0,0,0,1033.0,0:57,612500
8474774,Dalton,Prout,1990-03-13,D,R,2017-18,4,0,0,0,0.0,-2,5,0.0,13,3357.0,13:59,0,0,0,0.0,7,3,0,4,-4,0,0,0,4.0,0:1,0,0,0,145.0,0:36,1575000
8474818,Jordie,Benn,1987-07-26,D,L,2017-18,77,4,11,15,0.19,-2,106,3.77,34,87647.0,18:58,0,0,0,0.0,90,153,20,74,-54,0,0,0,112.0,0:1,0,0,0,10150.0,2:11,1100000
8474849,Antoine,Roussel,1989-11-21,LW,L,2017-18,73,5,12,17,0.23,1,85,5.88,126,54451.0,12:25,22,16,38,57.89,104,42,16,23,-7,0,0,0,336.0,0:4,0,0,0,4266.0,0:58,2000000
8474870,Tyler,Johnson,1990-07-29,C,R,2017-18,81,21,29,50,0.62,3,186,11.29,24,82580.0,16:59,360,359,719,50.07,48,47,39,23,16,4,9,13,11089.0,2:16,2,0,2,7334.0,1:30,5000000
8474884,Mike,Hoffman,1989-11-24,LW,L,2017-18,82,22,34,56,0.68,-20,257,8.56,32,90562.0,18:24,22,18,40,55.0,31,34,51,69,-18,8,13,21,15219.0,3:5,0,0,0,224.0,0:2,5187500
8475098,Tyler,Bozak,1986-03-19,C,R,2017-18,81,11,32,43,0.53,6,154,7.14,28,76023.0,15:38,627,542,1169,53.64,43,28,37,42,-5,3,10,13,10631.0,2:11,0,0,0,60.0,0:0,4200000
8475147,Jordan,Schroeder,1990-09-29,LW,R,2017-18,21,1,1,2,0.1,-4,20,5.0,4,9421.0,7:28,39,24,63,61.9,14,2,5,2,3,0,0,0,140.0,0:6,0,0,0,29.0,0:1,650000
8475149,Marcus,Johansson,1990-10-06,LW,L,2017-18,29,5,9,14,0.48,-11,42,11.9,14,27825.0,15:59,36,38,74,48.65,8,9,15,21,-6,1,2,3,5031.0,2:53,0,0,0,161.0,0:5,4583333
8475151,Kyle,Palmieri,1991-02-01,RW,R,2017-18,62,24,20,44,0.71,-1,181,13.26,30,64392.0,17:18,25,50,75,33.33,94,50,33,19,14,11,12,23,10326.0,2:46,0,0,0,2630.0,0:42,4650000
8475157,Landon,Ferraro,1991-08-08,C,R,2017-18,2,1,0,1,0.5,1,3,33.33,0,530.0,4:25,0,0,0,0.0,1,0,0,0,0,0,0,0,3.0,0:1,0,0,0,0.0,0:0,700000
8475158,Ryan,O'Reilly,1991-02-07,C,L,2017-18,81,24,37,61,0.75,-23,230,10.43,2,101170.0,20:49,1274,850,2124,59.98,42,48,65,39,26,15,8,23,17495.0,3:35,0,4,4,7568.0,1:33,7500000
8475160,Kyle,Clifford,1991-01-13,LW,L,2017-18,50,6,4,10,0.2,-4,81,7.41,48,31648.0,10:32,1,8,9,11.11,127,8,8,6,2,0,0,0,324.0,0:6,0,0,0,111.0,0:2,1600000
8475163,Alex,Chiasson,1990-10-01,RW,R,2017-18,61,9,9,18,0.3,1,59,15.25,26,43062.0,11:45,11,30,41,26.83,57,29,29,16,13,1,0,1,2254.0,0:36,1,2,3,6092.0,1:39,660000
8475164,Jakob,Silfverberg,1990-10-13,RW,R,2017-18,77,17,23,40,0.52,6,187,9.09,18,82977.0,17:57,18,35,53,33.96,52,61,40,43,-3,2,6,8,7820.0,1:41,1,1,2,7850.0,1:41,3750000
8475166,John,Tavares,1990-09-20,C,L,2017-18,82,37,47,84,1.02,-12,257,14.4,26,98032.0,19:55,913,813,1726,52.9,30,34,49,78,-29,12,18,30,15570.0,3:9,2,1,3,7673.0,1:33,5500000
8475167,Victor,Hedman,1990-12-18,D,L,2017-18,77,17,46,63,0.82,32,216,7.87,54,119430.0,25:51,1,1,2,50.0,139,110,46,67,-21,2,24,26,15708.0,3:24,0,2,2,11943.0,2:35,7875000
8475168,Matt,Duchene,1991-01-16,C,L,2017-18,82,27,32,59,0.72,-22,190,14.21,18,90194.0,18:19,717,637,1354,52.95,60,49,47,40,7,9,4,13,13189.0,2:40,0,0,0,1242.0,0:15,6000000
8475169,Evander,Kane,1991-08-02,LW,L,2017-18,78,29,25,54,0.69,-9,307,9.45,82,91617.0,19:34,120,150,270,44.44,159,34,40,50,-10,3,6,9,12078.0,2:34,4,0,4,3305.0,0:42,5250000
8475170,Brayden,Schenn,1991-08-22,C,L,2017-18,82,28,42,70,0.85,10,210,13.33,56,97049.0,19:43,660,714,1374,48.03,154,37,56,42,14,8,11,19,15737.0,3:11,0,0,0,2689.0,0:32,5125000
8475171,Oliver,Ekman-Larsson,1991-07-17,D,L,2017-18,82,14,28,42,0.51,-28,202,6.93,44,116515.0,23:40,0,1,1,0.0,160,79,29,53,-24,6,9,15,14998.0,3:2,0,0,0,8210.0,1:40,5500000
8475172,Nazem,Kadri,1990-10-06,C,L,2017-18,80,32,23,55,0.69,2,211,15.17,42,80445.0,16:45,546,547,1093,49.95,94,26,42,48,-6,12,7,19,10026.0,2:5,0,0,0,42.0,0:0,4500000
8475175,Magnus,Paajarvi,1991-04-12,LW,L,2017-18,79,8,4,12,0.15,-11,126,6.35,12,59015.0,12:27,2,6,8,25.0,104,42,25,12,13,0,0,0,280.0,0:3,0,0,0,6605.0,1:23,800000
8475176,Ryan,Ellis,1991-01-03,D,R,2017-18,44,9,23,32,0.73,26,110,8.18,6,61661.0,23:21,0,0,0,0.0,27,84,33,33,0,2,3,5,5818.0,2:12,0,3,3,7180.0,2:43,2500000
8475177,Calvin,de Haan,1991-05-09,D,L,2017-18,33,1,11,12,0.36,11,44,2.27,8,37124.0,18:44,0,0,0,0.0,45,65,14,24,-10,0,0,0,178.0,0:5,0,0,0,4674.0,2:21,3300000
8475178,Zack,Kassian,1991-01-24,RW,R,2017-18,74,7,12,19,0.26,-8,86,8.14,92,51812.0,11:40,5,19,24,20.83,129,9,26,33,-7,0,1,1,406.0,0:5,0,2,2,6553.0,1:28,1950000
8475179,Dmitry,Kulikov,1990-10-29,D,L,2017-18,62,3,8,11,0.18,6,48,6.25,22,63508.0,17:4,0,0,0,0.0,69,78,11,53,-42,0,0,0,226.0,0:3,0,0,0,9385.0,2:31,4333333
8475180,Peter,Holland,1991-01-14,C,L,2017-18,23,1,3,4,0.17,-10,30,3.33,7,17103.0,12:23,107,120,227,47.14,14,12,7,11,-4,0,0,0,148.0,0:6,0,1,1,1711.0,1:14,675000
8475181,Nick,Leddy,1991-03-20,D,L,2017-18,80,10,32,42,0.52,-42,153,6.54,20,107621.0,22:25,0,0,0,0.0,95,104,21,57,-36,4,10,14,15691.0,3:16,0,0,0,3292.0,0:41,5500000
8475184,Chris,Kreider,1991-04-30,LW,L,2017-18,58,16,21,37,0.64,-2,137,11.68,44,54352.0,15:37,25,35,60,41.67,103,24,18,39,-21,7,5,12,8989.0,2:34,0,0,0,84.0,0:1,4625000
8475185,Jacob,Josefson,1991-03-02,C,L,2017-18,39,2,2,4,0.1,-4,35,5.71,6,26621.0,11:22,141,179,320,44.06,26,33,7,8,-1,0,0,0,165.0,0:4,0,0,0,3609.0,1:32,700000
8475186,John,Moore,1990-11-19,D,L,2017-18,81,7,11,18,0.22,3,141,4.96,47,97245.0,20:0,0,0,0,0.0,135,105,17,48,-31,0,2,2,1800.0,0:22,1,0,1,8856.0,1:49,1666667
8475188,Brayden,McNabb,1991-01-21,D,L,2017-18,76,5,10,15,0.2,26,88,5.68,52,91892.0,20:9,0,0,0,0.0,225,176,30,40,-10,0,0,0,340.0,0:4,0,0,0,12391.0,2:43,1700000
8475191,Reilly,Smith,1991-04-01,RW,L,2017-18,67,22,38,60,0.9,31,162,13.58,24,72056.0,17:55,4,9,13,30.77,40,24,54,47,7,7,7,14,9484.0,2:21,1,1,2,6699.0,1:39,5000000
8475193,Tomas,Tatar,1990-12-01,LW,L,2017-18,82,20,14,34,0.41,-19,174,11.49,34,80026.0,16:15,2,13,15,13.33,67,29,45,45,0,9,4,13,10892.0,2:12,0,0,0,103.0,0:1,5300000
8475197,Tyson,Barrie,1991-07-26,D,R,2017-18,68,14,43,57,0.84,-15,178,7.87,22,92604.0,22:41,0,0,0,0.0,40,79,20,38,-18,7,23,30,15223.0,3:43,0,0,0,758.0,0:11,5500000
8475200,Dmitry,Orlov,1991-07-23,D,L,2017-18,82,10,21,31,0.38,10,125,8.0,22,113794.0,23:7,0,0,0,0.0,128,116,54,51,3,0,4,4,5710.0,1:9,0,0,0,9740.0,1:58,5100000
8475204,Brandon,Pirri,1991-04-10,RW,L,2017-18,2,3,0,3,1.5,3,11,27.27,0,2114.0,17:37,1,1,2,50.0,2,0,2,1,1,0,0,0,281.0,2:20,0,0,0,0.0,0:0,650000
8475208,Brian,Dumoulin,1991-09-06,D,L,2017-18,80,5,13,18,0.22,-5,102,4.9,30,98964.0,20:37,0,0,0,0.0,101,132,35,43,-8,0,0,0,1069.0,0:13,0,0,0,12154.0,2:31,4100000
8475209,Richard,Panik,1991-02-07,RW,L,2017-18,72,14,21,35,0.49,7,136,10.29,38,65652.0,15:11,4,8,12,33.33,137,37,26,14,12,4,2,6,8204.0,1:53,0,0,0,779.0,0:10,2800000
8475218,Mattias,Ekholm,1990-05-24,D,L,2017-18,81,10,24,34,0.42,25,135,7.41,46,114586.0,23:34,0,1,1,0.0,75,117,38,70,-32,5,8,13,9097.0,1:52,1,0,1,14028.0,2:53,3750000
8475220,Marcus,Foligno,1991-08-10,LW,L,2017-18,77,8,15,23,0.3,2,79,10.13,72,50187.0,10:51,9,10,19,47.37,185,44,20,17,3,1,1,2,1228.0,0:15,0,0,0,19.0,0:0,2875000
8475222,Sami,Vatanen,1991-06-03,D,R,2017-18,72,4,28,32,0.44,-7,145,2.76,40,96773.0,22:24,0,0,0,0.0,92,105,18,52,-34,1,12,13,10995.0,2:32,0,1,1,7458.0,1:43,4875000
8475224,Jordan,Szwarz,1991-05-14,RW,R,2017-18,12,0,3,3,0.25,-4,19,0.0,2,8287.0,11:30,28,42,70,40.0,9,8,3,1,2,0,1,1,511.0,0:42,0,0,0,217.0,0:18,650000
8475225,Craig,Smith,1989-09-05,RW,R,2017-18,79,25,26,51,0.65,20,229,10.92,24,72909.0,15:22,40,54,94,42.55,60,35,61,28,33,9,5,14,11100.0,2:20,0,0,0,38.0,0:0,4250000
8475227,Chris,Wideman,1990-01-07,D,R,2017-18,16,3,5,8,0.5,5,24,12.5,6,11094.0,11:33,0,0,0,0.0,17,9,0,9,-9,2,0,2,2041.0,2:7,0,0,0,50.0,0:3,800000
8475231,Casey,Cizikas,1991-02-27,C,L,2017-18,64,7,10,17,0.27,-12,74,9.46,23,50746.0,13:12,473,418,891,53.09,128,53,33,23,10,0,0,0,278.0,0:4,1,0,1,8839.0,2:18,3350000
8475233,David,Savard,1990-10-22,D,R,2017-18,81,4,12,16,0.2,2,145,2.76,32,94187.0,19:22,0,0,0,0.0,144,143,24,27,-3,0,0,0,862.0,0:10,0,1,1,10752.0,2:12,4250000
8475235,Nicolas,Deslauriers,1991-02-22,LW,L,2017-18,58,10,4,14,0.24,7,77,12.99,55,40350.0,11:35,4,2,6,66.67,238,30,14,3,11,0,0,0,78.0,0:1,0,1,1,3672.0,1:3,775000
8475236,Cody,Eakin,1991-05-24,C,L,2017-18,80,11,16,27,0.34,-6,107,10.28,22,69768.0,14:32,479,440,919,52.12,63,45,60,31,29,0,0,0,2191.0,0:27,1,2,3,7759.0,1:36,3850000
8475246,Kevin,Connauton,1990-02-23,D,L,2017-18,73,11,10,21,0.29,3,102,10.78,20,66472.0,15:10,0,0,0,0.0,116,72,13,32,-19,0,0,0,783.0,0:10,0,0,0,2490.0,0:34,1000000
8475254,Gabriel,Dumont,1990-10-06,C,R,2017-18,30,1,1,2,0.07,1,38,2.63,6,16276.0,9:2,41,62,103,39.81,62,16,5,3,2,0,0,0,56.0,0:1,0,0,0,1612.0,0:53,650000
8475263,Wade,Megan,1990-07-22,C,L,2017-18,1,0,0,0,0.0,0,1,0.0,0,501.0,8:21,1,1,2,50.0,0,0,0,0,0,0,0,0,0.0,0:0,0,0,0,105.0,1:45,650000
8475268,Gabriel,Bourque,1990-09-23,LW,L,2017-18,58,5,6,11,0.19,-6,44,11.36,12,37947.0,10:54,7,16,23,30.43,123,59,12,2,10,0,0,0,39.0,0:0,0,0,0,6587.0,1:53,750000
8475278,Byron,Froese,1991-03-12,C,R,2017-18,48,3,8,11,0.23,0,49,6.12,26,33349.0,11:34,156,196,352,44.32,54,42,19,11,8,0,0,0,114.0,0:2,0,0,0,3424.0,1:11,650000
8475279,Ben,Chiarot,1991-05-09,D,L,2017-18,57,2,12,14,0.25,15,57,3.51,32,52244.0,15:16,0,0,0,0.0,105,75,10,34,-24,0,0,0,180.0,0:3,0,0,0,4521.0,1:19,1400000
8475287,Erik,Haula,1991-03-23,LW,L,2017-18,76,29,26,55,0.72,-16,175,16.57,37,79224.0,17:22,489,479,968,50.52,85,42,44,37,7,12,7,19,10861.0,2:22,0,0,0,2429.0,0:31,2750000
8475310,Curtis,McKenzie,1991-02-22,LW,L,2017-18,7,0,2,2,0.29,3,11,0.0,11,3403.0,8:6,0,1,1,0.0,8,1,3,2,1,0,0,0,262.0,0:37,0,0,0,0.0,0:0,700000
8475314,Anders,Lee,1990-07-03,LW,L,2017-18,82,40,22,62,0.76,-25,208,19.23,44,84953.0,17:16,11,5,16,68.75,102,38,26,35,-9,14,8,22,15072.0,3:3,0,0,0,67.0,0:0,3750000
8475323,Marcus,Kruger,1990-05-27,C,L,2017-18,48,1,5,6,0.12,-6,30,3.33,28,31211.0,10:50,159,128,287,55.4,56,16,10,11,-1,0,0,0,291.0,0:6,0,0,0,3412.0,1:11,3083333
8475324,Nick,Jensen,1990-09-21,D,R,2017-18,81,0,15,15,0.19,-8,107,0.0,27,79002.0,16:15,0,0,0,0.0,71,88,25,54,-29,0,1,1,346.0,0:4,0,0,0,9348.0,1:55,812500
8475325,Jordan,Nolan,1989-06-23,C,L,2017-18,69,4,4,8,0.12,-13,50,8.0,69,40562.0,9:47,1,3,4,25.0,123,17,10,15,-5,0,0,0,327.0,0:4,0,0,0,205.0,0:2,950000
8475328,Ben,Sexton,1991-06-06,C,R,2017-18,2,0,0,0,0.0,-1,1,0.0,0,1233.0,10:16,3,2,5,60.0,6,0,0,1,-1,0,0,0,0.0,0:0,0,0,0,0.0,0:0,725000
8475343,Nic,Dowd,1990-05-27,C,R,2017-18,56,3,1,4,0.07,-10,51,5.88,28,35401.0,10:32,202,194,396,51.01,81,30,16,15,1,1,0,1,64.0,0:1,0,0,0,3809.0,1:8,640000
8475423,Darren,Archibald,1990-02-09,RW,L,2017-18,27,4,5,9,0.33,-1,28,14.29,14,24072.0,14:51,0,1,1,0.0,80,14,5,1,4,0,0,0,65.0,0:2,1,0,1,4527.0,2:47,650000
8475430,Brandon,Manning,1990-06-04,D,L,2017-18,65,7,12,19,0.29,0,111,6.31,56,70013.0,17:57,0,0,0,0.0,113,76,17,34,-17,0,1,1,1095.0,0:16,0,0,0,4923.0,1:15,975000
8475436,Mike,Liambas,1989-02-16,LW,L,2017-18,7,0,1,1,0.14,0,3,0.0,21,2221.0,5:17,0,2,2,0.0,15,1,1,0,1,0,0,0,14.0,0:2,0,0,0,0.0,0:0,650000
8475455,Brenden,Dillon,1990-11-13,D,L,2017-18,81,5,17,22,0.27,-7,88,5.68,60,84174.0,17:19,0,0,0,0.0,197,107,11,29,-18,0,0,0,182.0,0:2,0,0,0,6992.0,1:26,3270000
8475462,Radko,Gudas,1990-06-05,D,R,2017-18,70,2,14,16,0.23,0,142,1.41,83,71826.0,17:6,0,0,0,0.0,170,123,7,50,-43,0,0,0,236.0,0:3,0,1,1,7881.0,1:52,3350000
8475613,Nate,Prosser,1986-05-07,D,R,2017-18,57,3,6,9,0.16,8,27,11.11,19,46041.0,13:27,0,0,0,0.0,60,84,11,17,-6,0,0,0,148.0,0:2,1,0,1,4477.0,1:18,650000
8475625,Matt,Irwin,1987-11-29,D,L,2017-18,50,2,6,8,0.16,2,62,3.23,8,40296.0,13:25,0,0,0,0.0,78,54,10,16,-6,0,0,0,71.0,0:1,0,0,0,1829.0,0:36,650000
8475690,Christopher,Tanev,1989-12-20,D,R,2017-18,42,2,9,11,0.26,7,31,6.45,8,49833.0,19:46,0,0,0,0.0,21,70,15,15,0,0,0,0,480.0,0:11,0,2,2,7739.0,3:4,4450000
8475692,Mats,Zuccarello,1987-09-01,RW,L,2017-18,80,16,37,53,0.66,-10,178,8.99,36,90834.0,18:55,21,59,80,26.25,62,67,69,58,11,1,16,17,13221.0,2:45,0,0,0,5353.0,1:6,4500000
8475714,Calle,Jarnkrok,1991-09-25,C,R,2017-18,68,16,19,35,0.51,20,105,15.24,12,64812.0,15:53,266,253,519,51.25,36,31,22,10,12,1,3,4,2760.0,0:40,2,0,2,9305.0,2:16,2000000
8475715,Oscar,Lindberg,1991-10-29,C,L,2017-18,63,9,2,11,0.17,-11,81,11.11,14,44512.0,11:46,99,88,187,52.94,72,27,23,24,-1,0,0,0,580.0,0:9,0,0,0,3180.0,0:50,1700000
8475718,Justin,Holl,1992-01-30,D,R,2017-18,2,2,0,2,1.0,5,2,100.0,0,2083.0,17:21,0,0,0,0.0,2,3,0,1,-1,0,0,0,0.0,0:0,0,0,0,152.0,1:16,650000
8475722,Jason,Zucker,1992-01-16,LW,L,2017-18,82,33,31,64,0.78,8,222,14.86,44,83448.0,16:57,4,14,18,22.22,80,47,54,37,17,7,9,16,10779.0,2:11,1,1,2,2904.0,0:35,2000000
8475726,Tyler,Toffoli,1992-04-24,C,R,2017-18,82,24,23,47,0.57,9,251,9.56,16,79304.0,16:7,9,16,25,36.0,75,17,26,36,-10,6,6,12,9417.0,1:54,0,0,0,2307.0,0:28,4600000
8475727,Ryan,Spooner,1992-01-30,C,L,2017-18,59,13,28,41,0.69,6,107,12.15,4,54133.0,15:17,91,119,210,43.33,66,16,15,36,-21,1,6,7,8666.0,2:26,0,0,0,132.0,0:2,2825000
8475728,Johan,Larsson,1992-07-25,C,L,2017-18,80,4,13,17,0.21,-30,86,4.65,49,67751.0,14:6,348,291,639,54.46,117,47,42,25,17,0,0,0,665.0,0:8,1,1,2,9437.0,1:57,1475000
8475729,Mark,Alt,1991-10-18,D,R,2017-18,15,0,0,0,0.0,-1,11,0.0,2,11204.0,12:26,0,0,0,0.0,17,18,3,4,-1,0,0,0,5.0,0:0,0,0,0,612.0,0:40,650000
8475730,Stephen,Johns,1992-04-18,D,R,2017-18,75,8,7,15,0.2,9,121,6.61,41,78951.0,17:32,0,0,0,0.0,201,155,25,44,-19,0,0,0,2766.0,0:36,0,1,1,10007.0,2:13,725000
8475735,Greg,McKegg,1992-06-17,C,L,2017-18,26,2,2,4,0.15,-4,21,9.52,8,15100.0,9:40,115,118,233,49.36,19,10,3,3,0,0,0,0,210.0,0:8,1,0,1,1745.0,1:7,650000
8475736,Connor,Brickley,1992-02-25,C,L,2017-18,44,4,8,12,0.27,-6,62,6.45,19,31392.0,11:53,3,13,16,18.75,82,28,10,17,-7,0,0,0,260.0,0:5,0,0,0,2312.0,0:52,750000
8475738,Jordan,Weal,1992-04-15,C,R,2017-18,69,8,13,21,0.3,-10,102,7.84,12,53613.0,12:57,53,63,116,45.69,17,25,19,15,4,3,0,3,6282.0,1:31,0,0,0,43.0,0:0,1750000
8475739,Michael,Bournival,1992-05-31,LW,L,2017-18,5,0,0,0,0.0,0,5,0.0,0,2804.0,9:20,0,0,0,0.0,8,5,1,0,1,0,0,0,0.0,0:0,0,0,0,0.0,0:0,650000
8475744,Evgeny,Kuznetsov,1992-05-19,C,L,2017-18,79,27,56,83,1.05,3,187,14.44,48,89168.0,18:48,450,568,1018,44.2,50,26,44,66,-22,7,23,30,16354.0,3:27,1,0,1,275.0,0:3,7800000
8475745,Charlie,Coyle,1992-03-02,C,R,2017-18,66,11,26,37,0.56,8,117,9.4,18,65471.0,16:31,240,220,460,52.17,76,63,29,26,3,0,3,3,5445.0,1:22,1,0,1,4036.0,1:1,3200000
8475747,Patrik,Nemeth,1992-02-08,D,L,2017-18,68,3,12,15,0.22,27,73,4.11,41,81014.0,19:51,0,3,3,0.0,66,185,14,25,-11,0,0,0,173.0,0:2,0,2,2,13551.0,3:19,945000
8475750,Jon,Merrill,1992-02-03,D,L,2017-18,34,1,2,3,0.09,7,30,3.33,22,32815.0,16:5,0,0,0,0.0,35,42,7,18,-11,0,0,0,166.0,0:4,0,0,0,826.0,0:24,1137500
8475752,Tyler,Pitlick,1991-11-01,C,R,2017-18,80,14,13,27,0.34,9,129,10.85,34,65662.0,13:40,13,34,47,27.66,122,57,25,28,-3,0,0,0,422.0,0:5,0,1,1,8299.0,1:43,1000000
8475753,Justin,Faulk,1992-03-20,D,R,2017-18,76,8,23,31,0.41,-26,211,3.79,48,101541.0,22:16,0,0,0,0.0,128,90,63,66,-3,3,16,19,13376.0,2:56,0,0,0,2455.0,0:32,4833333
8475754,Brock,Nelson,1991-10-15,C,L,2017-18,82,19,16,35,0.43,-4,138,13.77,43,72464.0,14:43,389,416,805,48.32,50,52,34,29,5,4,4,8,8950.0,1:49,0,0,0,3274.0,0:39,2500000
8475755,Alex,Petrovic,1992-03-03,D,R,2017-18,67,2,11,13,0.19,-2,60,3.33,98,58920.0,14:39,0,0,0,0.0,142,74,17,33,-16,0,0,0,96.0,0:1,0,0,0,1663.0,0:24,1850000
8475758,Devante,Smith-Pelly,1992-06-14,RW,R,2017-18,75,7,9,16,0.21,-6,103,6.8,38,55570.0,12:20,16,17,33,48.48,151,62,16,18,-2,0,0,0,131.0,0:1,0,0,0,4372.0,0:58,1300000
8475760,Nick,Bjugstad,1992-07-17,C,R,2017-18,82,19,30,49,0.6,5,230,8.26,41,74389.0,15:7,152,146,298,51.01,95,19,52,49,3,1,6,7,7488.0,1:31,0,0,0,60.0,0:0,4100000
8475761,Beau,Bennett,1991-11-27,RW,R,2017-18,6,0,0,0,0.0,-2,6,0.0,0,3889.0,10:48,1,2,3,33.33,9,1,2,0,2,0,0,0,288.0,0:48,0,0,0,0.0,0:0,650000
8475762,Derek,Forbort,1992-03-04,D,L,2017-18,78,1,17,18,0.23,18,78,1.28,49,97288.0,20:47,0,0,0,0.0,142,156,19,79,-60,0,0,0,547.0,0:7,0,0,0,12657.0,2:42,650000
8475763,Kevin,Hayes,1992-05-08,C,L,2017-18,76,25,19,44,0.58,1,172,14.53,18,79131.0,17:21,562,550,1112,50.54,40,36,52,63,-11,6,2,8,5113.0,1:7,2,0,2,10222.0,2:14,2600000
8475764,Cam,Fowler,1991-12-05,D,L,2017-18,67,8,24,32,0.48,3,122,6.56,28,99911.0,24:51,1,1,2,50.0,21,108,27,47,-20,1,9,10,10463.0,2:36,1,1,2,9619.0,2:23,4000000
8475765,Vladimir,Tarasenko,1991-12-13,RW,L,2017-18,80,33,33,66,0.82,15,306,10.78,17,91474.0,19:3,1,3,4,25.0,89,37,32,32,0,6,10,16,16321.0,3:24,0,0,0,658.0,0:8,7500000
8475766,Austin,Watson,1992-01-13,LW,R,2017-18,76,14,5,19,0.25,2,96,14.58,123,56232.0,12:19,27,16,43,62.79,187,78,29,27,2,0,0,0,134.0,0:1,4,1,5,10135.0,2:13,1100000
8475768,Jaden,Schwartz,1992-06-25,LW,L,2017-18,62,24,35,59,0.95,15,157,15.29,26,72141.0,19:23,30,43,73,41.1,52,30,45,17,28,6,5,11,11975.0,3:13,1,0,1,2408.0,0:38,5350000
8475772,Riley,Sheahan,1991-12-07,C,L,2017-18,81,11,21,32,0.4,4,109,10.09,8,71291.0,14:40,560,473,1033,54.21,52,50,34,27,7,1,1,2,2061.0,0:25,0,1,1,11856.0,2:26,2075000
8475780,Chris,Wagner,1991-05-27,RW,R,2017-18,79,7,9,16,0.2,-10,93,7.53,37,62938.0,13:16,230,240,470,48.94,253,49,16,21,-5,1,2,3,1757.0,0:22,2,0,2,10660.0,2:14,637500
8475784,Jeff,Skinner,1992-05-16,LW,L,2017-18,82,24,25,49,0.6,-27,277,8.66,34,82203.0,16:42,26,34,60,43.33,35,24,93,62,31,4,5,9,10334.0,2:6,0,0,0,41.0,0:0,5725000
8475786,Zach,Hyman,1992-06-09,C,R,2017-18,82,15,25,40,0.49,22,148,10.14,37,85400.0,17:21,72,96,168,42.86,117,55,36,31,5,0,0,0,750.0,0:9,1,1,2,13039.0,2:39,2250000
8475788,Alexander,Burmistrov,1991-10-21,C,L,2017-18,24,2,4,6,0.25,-5,18,11.11,12,17247.0,11:58,87,94,181,48.07,20,4,5,4,1,1,1,2,909.0,0:37,0,0,0,1020.0,0:42,900000
8475790,Erik,Gudbranson,1992-01-07,D,R,2017-18,52,2,3,5,0.1,-7,53,3.77,35,57473.0,18:25,0,0,0,0.0,126,81,5,28,-23,0,0,0,134.0,0:2,0,0,0,7925.0,2:32,3500000
8475791,Taylor,Hall,1991-11-14,LW,L,2017-18,76,39,54,93,1.22,14,278,14.03,34,87286.0,19:8,72,76,148,48.65,72,44,81,69,12,13,24,37,13260.0,2:54,1,0,1,459.0,0:6,6000000
8475792,Brett,Connolly,1992-05-02,RW,R,2017-18,70,15,12,27,0.39,-6,67,22.39,30,50412.0,12:0,14,17,31,45.16,72,24,17,19,-2,4,1,5,6042.0,1:26,0,0,0,62.0,0:0,1500000
8475793,Ryan,Johansen,1992-07-31,C,R,2017-18,79,15,39,54,0.68,13,129,11.63,78,87921.0,18:32,810,651,1461,55.44,87,35,46,41,5,1,14,15,14436.0,3:2,0,2,2,4956.0,1:2,8000000
8475794,Tyler,Seguin,1992-01-31,C,R,2017-18,82,40,38,78,0.95,14,335,11.94,43,102870.0,20:54,790,650,1440,54.86,74,44,38,36,2,14,11,25,15510.0,3:9,1,1,2,7599.0,1:32,5750000
8475796,Mark,Pysyk,1992-01-11,D,R,2017-18,82,3,13,16,0.2,-8,106,2.83,20,92305.0,18:45,0,0,0,0.0,102,123,35,63,-28,0,0,0,454.0,0:5,0,0,0,10168.0,2:4,2733333
8475798,Mikael,Granlund,1992-02-26,RW,L,2017-18,77,21,46,67,0.87,13,193,10.88,18,86771.0,18:46,69,56,125,55.2,47,45,33,35,-2,7,12,19,11532.0,2:29,1,2,3,8853.0,1:54,5750000
8475799,Nino,Niederreiter,1992-09-08,RW,L,2017-18,63,18,14,32,0.51,14,133,13.53,36,56705.0,15:0,15,18,33,45.45,58,20,26,21,5,7,1,8,8410.0,2:13,0,0,0,238.0,0:3,5250000
8475807,Joakim,Nordstrom,1992-02-25,LW,L,2017-18,75,2,5,7,0.09,-11,97,2.06,6,47573.0,10:34,36,41,77,46.75,107,41,27,20,7,0,0,0,296.0,0:3,0,0,0,7692.0,1:42,1275000
8475808,Michael,Chaput,1992-04-09,C,L,2017-18,9,0,0,0,0.0,-4,2,0.0,5,5285.0,9:47,43,31,74,58.11,16,2,2,0,2,0,0,0,23.0,0:2,0,0,0,669.0,1:14,687500
8475810,Bryan,Rust,1992-05-11,RW,R,2017-18,69,13,25,38,0.55,11,123,10.57,26,66443.0,16:2,8,23,31,25.81,97,40,31,32,-1,2,2,4,3160.0,0:45,2,1,3,5790.0,1:23,640000
8475820,Joonas,Donskoi,1992-04-13,RW,R,2017-18,66,14,18,32,0.48,10,129,10.85,26,59293.0,14:58,5,7,12,41.67,28,28,46,33,13,1,4,5,6430.0,1:37,0,0,0,108.0,0:1,1900000
8475832,Tom,Kuhnhackl,1992-01-21,RW,L,2017-18,69,2,6,8,0.12,-6,63,3.17,6,41489.0,10:1,2,10,12,16.67,139,50,15,10,5,0,1,1,325.0,0:4,0,1,1,8816.0,2:7,625000
8475834,Marcus,Sorensen,1992-04-07,LW,L,2017-18,32,5,2,7,0.22,-5,25,20.0,5,19486.0,10:8,2,2,4,50.0,26,15,11,6,5,0,0,0,60.0,0:1,0,0,0,1551.0,0:48,700000
8475841,Tim,Heed,1991-01-27,D,R,2017-18,29,3,8,11,0.38,0,51,5.88,8,27874.0,16:1,0,0,0,0.0,8,35,15,21,-6,2,3,5,4966.0,2:51,0,0,0,60.0,0:2,650000
8475844,Kenny,Agostino,1992-04-30,LW,L,2017-18,5,0,1,1,0.2,-1,11,0.0,4,3613.0,12:2,0,1,1,0.0,4,1,1,0,1,0,1,1,918.0,3:3,0,0,0,0.0,0:0,875000
8475848,Brendan,Gallagher,1992-05-06,RW,R,2017-18,82,31,23,54,0.66,-13,278,11.15,34,79494.0,16:9,85,97,182,46.7,90,41,42,27,15,8,9,17,12040.0,2:26,1,0,1,1215.0,0:14,3750000
8475855,Jesper,Fast,1991-12-02,RW,R,2017-18,71,13,20,33,0.46,-10,80,16.25,26,63396.0,14:52,14,24,38,36.84,130,44,22,27,-5,0,0,0,232.0,0:3,0,2,2,8158.0,1:54,1850000
8475857,Kevin,Gravel,1992-03-06,D,L,2017-18,16,0,3,3,0.19,-3,20,0.0,2,13472.0,14:2,0,0,0,0.0,16,15,0,7,-7,0,1,1,643.0,0:40,0,0,0,207.0,0:12,650000
8475868,Anthony,Bitetto,1990-07-15,D,L,2017-18,32,1,2,3,0.09,-1,25,4.0,27,25804.0,13:26,0,0,0,0.0,40,31,7,16,-9,0,0,0,108.0,0:3,0,0,0,328.0,0:10,612500
8475869,Brandon,Davidson,1991-08-21,D,L,2017-18,51,4,3,7,0.14,-13,63,6.35,23,51464.0,16:49,0,0,0,0.0,105,89,13,44,-31,0,0,0,186.0,0:3,0,1,1,5355.0,1:45,1425000
8475878,Freddie,Hamilton,1992-01-01,C,R,2017-18,16,0,1,1,0.06,0,12,0.0,2,8621.0,8:58,28,44,72,38.89,35,0,2,5,-3,0,0,0,10.0,0:0,0,1,1,301.0,0:18,612500
8475902,Zach,Trotman,1990-08-26,D,R,2017-18,3,0,0,0,0.0,-3,6,0.0,0,2301.0,12:47,0,0,0,0.0,1,2,0,0,0,0,0,0,197.0,1:5,0,0,0,0.0,0:0,650000
8475906,John,Klingberg,1992-08-14,D,R,2017-18,82,8,59,67,0.82,12,204,3.92,26,118447.0,24:4,0,0,0,0.0,44,109,31,93,-62,1,22,23,17958.0,3:39,0,0,0,5506.0,1:7,4250000
8475907,Micheal,Ferland,1992-04-20,LW,L,2017-18,77,21,20,41,0.53,5,144,14.58,24,69389.0,15:1,22,35,57,38.6,171,30,35,33,2,6,0,6,8562.0,1:51,0,0,0,141.0,0:1,1750000
8475913,Mark,Stone,1992-05-13,RW,R,2017-18,58,20,42,62,1.07,9,132,15.15,10,71942.0,20:40,33,28,61,54.1,53,39,59,57,2,1,10,11,10776.0,3:5,1,1,2,4165.0,1:11,3500000
8475949,Marek,Hrivik,1991-08-28,LW,R,2017-18,3,0,0,0,0.0,1,2,0.0,0,1531.0,8:30,0,1,1,0.0,4,1,1,4,-3,0,0,0,20.0,0:6,0,0,0,0.0,0:0,650000
8475982,Erik,Burgdoerfer,1988-12-11,D,R,2017-18,2,0,1,1,0.5,2,2,0.0,0,1610.0,13:25,0,0,0,0.0,5,2,0,0,0,0,0,0,0.0,0:0,0,0,0,0.0,0:0,650000
8476166,Taylor,Fedun,1988-06-04,D,R,2017-18,7,0,1,1,0.14,-1,8,0.0,2,6167.0,14:41,0,0,0,0.0,4,10,0,4,-4,0,0,0,316.0,0:45,0,0,0,322.0,0:46,650000
8476177,Matt,Read,1986-06-14,RW,R,2017-18,19,1,0,1,0.05,-2,16,6.25,2,12428.0,10:54,4,8,12,33.33,21,11,5,4,1,0,0,0,53.0,0:2,0,0,0,1320.0,1:9,3625000
8476191,Kevan,Miller,1987-11-15,D,R,2017-18,68,1,15,16,0.24,16,64,1.56,70,79392.0,19:27,0,0,0,0.0,164,111,26,27,-1,0,0,0,306.0,0:4,0,2,2,9101.0,2:13,2500000
8476195,Cory,Conacher,1989-12-14,C,L,2017-18,36,8,4,12,0.33,0,45,17.78,24,21588.0,9:59,4,12,16,25.0,32,14,5,5,0,1,0,1,884.0,0:24,0,0,0,9.0,0:0,650000
8476207,Brian,Gibbons,1988-02-26,LW,L,2017-18,59,12,14,26,0.44,10,72,16.67,20,51084.0,14:25,22,29,51,43.14,35,58,35,10,25,0,0,0,245.0,0:4,3,2,5,9898.0,2:47,650000
8476283,Alex,Broadhurst,1993-03-07,C,L,2017-18,2,0,0,0,0.0,0,1,0.0,2,1205.0,10:2,0,0,0,0.0,0,0,2,2,0,0,0,0,50.0,0:25,0,0,0,0.0,0:0,650000
8476285,Matthew,Peca,1993-04-27,C,L,2017-18,10,2,3,5,0.5,6,17,11.76,0,8202.0,13:40,78,59,137,56.93,11,8,1,5,-4,0,0,0,65.0,0:6,0,0,0,703.0,1:10,650000
8476288,Ryan,Dzingel,1992-03-09,LW,L,2017-18,79,23,18,41,0.52,-17,136,16.91,35,78186.0,16:29,24,32,56,42.86,60,19,27,34,-7,4,4,8,10204.0,2:9,0,0,0,117.0,0:1,1800000
8476292,Ondrej,Palat,1991-03-28,LW,L,2017-18,56,11,24,35,0.62,16,109,10.09,6,57107.0,16:59,7,24,31,22.58,80,48,34,41,-7,4,5,9,7114.0,2:7,1,0,1,3732.0,1:6,5300000
8476293,Scott,Wilson,1992-04-24,C,L,2017-18,69,6,8,14,0.2,-20,98,6.12,8,50536.0,12:12,10,9,19,52.63,128,33,14,14,0,0,1,1,1116.0,0:16,0,0,0,3974.0,0:57,625000
8476302,Frank,Corrado,1993-03-26,D,R,2017-18,5,0,0,0,0.0,-1,6,0.0,2,3450.0,11:30,0,0,0,0.0,5,6,2,1,1,0,0,0,0.0,0:0,0,0,0,0.0,0:0,650000
8476303,Rob,O'Gara,1993-07-06,D,L,2017-18,30,0,3,3,0.1,-7,21,0.0,6,27923.0,15:30,0,0,0,0.0,42,44,4,7,-3,0,0,0,1.0,0:0,0,0,0,2546.0,1:24,925000
8476310,Lukas,Sedlak,1993-02-25,C,L,2017-18,53,4,4,8,0.15,-3,50,8.0,21,29893.0,9:24,191,180,371,51.48,77,26,13,10,3,0,0,0,142.0,0:2,0,0,0,1995.0,0:37,825000
8476312,Josh,Manson,1991-10-07,D,R,2017-18,80,7,30,37,0.46,34,117,5.98,62,97697.0,20:21,0,1,1,0.0,180,99,48,60,-12,0,0,0,452.0,0:5,0,1,1,11736.0,2:26,825000
8476322,Chase,Balisy,1992-02-02,C,L,2017-18,8,0,0,0,0.0,-2,6,0.0,0,4712.0,9:49,11,19,30,36.67,4,2,5,2,3,0,0,0,0.0,0:0,0,0,0,730.0,1:31,650000
8476323,Max,McCormick,1992-05-01,LW,L,2017-18,30,3,2,5,0.17,-5,33,9.09,37,15032.0,8:21,9,12,21,42.86,56,8,5,9,-4,0,0,0,0.0,0:0,0,0,0,584.0,0:19,650000
8476326,Josh,Archibald,1992-10-06,RW,R,2017-18,42,5,6,11,0.26,-2,42,11.9,25,30102.0,11:56,25,40,65,38.46,86,16,7,4,3,0,0,0,407.0,0:9,0,0,0,2242.0,0:53,675000
8476329,Travis,Boyd,1993-09-14,C,L,2017-18,8,0,1,1,0.12,2,2,0.0,2,4236.0,8:49,18,18,36,50.0,2,1,0,0,0,0,0,0,5.0,0:0,0,0,0,0.0,0:0,650000
8476331,Dylan,DeMelo,1993-05-01,D,R,2017-18,63,0,19,19,0.3,-1,67,0.0,34,53698.0,14:12,0,0,0,0.0,75,70,13,16,-3,0,3,3,1728.0,0:27,0,0,0,1073.0,0:17,650000
8476336,Iiro,Pakarinen,1991-08-25,RW,R,2017-18,40,2,1,3,0.08,1,50,4.0,6,24464.0,10:11,1,5,6,16.67,72,17,13,13,0,0,0,0,257.0,0:6,0,0,0,3409.0,1:25,725000
8476344,Tyler,Graovac,1993-04-27,C,L,2017-18,5,0,0,0,0.0,-3,1,0.0,2,2022.0,6:44,1,2,3,33.33,5,1,3,0,3,0,0,0,9.0,0:1,0,0,0,34.0,0:6,625000
8476346,Johnny,Gaudreau,1993-08-13,LW,L,2017-18,80,24,59,83,1.04,2,227,10.57,26,93234.0,19:25,1,4,5,20.0,16,18,44,100,-56,3,21,24,16993.0,3:32,0,0,0,112.0,0:1,6750000
8476356,Tobias,Rieder,1993-01-10,C,L,2017-18,78,12,13,25,0.32,-13,114,10.53,6,68537.0,14:38,22,24,46,47.83,96,41,18,8,10,2,1,3,1425.0,0:18,0,0,0,5597.0,1:11,2225000
8476368,Fredrik,Claesson,1992-11-24,D,L,2017-18,64,1,6,7,0.11,-7,60,1.67,35,58920.0,15:20,0,0,0,0.0,158,84,15,33,-18,0,0,0,211.0,0:3,0,0,0,5004.0,1:18,650000
8476370,Blake,Pietila,1993-02-20,LW,L,2017-18,2,0,0,0,0.0,0,1,0.0,0,1135.0,9:27,0,0,0,0.0,5,0,2,1,1,0,0,0,0.0,0:0,0,0,0,0.0,0:0,667500
8476372,Nick,Seeler,1993-06-03,D,L,2017-18,22,0,4,4,0.18,10,17,0.0,21,19186.0,14:32,0,0,0,0.0,20,25,2,6,-4,0,0,0,65.0,0:2,0,0,0,784.0,0:35,717500
8476374,Sean,Kuraly,1993-01-20,C,L,2017-18,75,6,8,14,0.19,-5,134,4.48,40,55120.0,12:14,335,386,721,46.46,143,22,32,28,4,0,0,0,309.0,0:4,0,1,1,5301.0,1:10,808750
8476381,Andrew,Shaw,1991-07-20,RW,R,2017-18,51,10,10,20,0.39,-8,94,10.64,53,48377.0,15:48,177,149,326,54.29,80,26,19,28,-9,5,2,7,7124.0,2:19,0,0,0,369.0,0:7,3900000
8476386,Shane,Prince,1992-11-16,LW,L,2017-18,14,1,1,2,0.14,-3,20,5.0,11,10082.0,12:0,5,6,11,45.45,10,3,6,6,0,0,0,0,826.0,0:59,0,0,0,12.0,0:0,850000
8476389,Vincent,Trocheck,1993-07-11,C,R,2017-18,82,31,44,75,0.91,-9,287,10.8,54,105112.0,21:21,853,724,1577,54.09,145,55,65,84,-19,13,14,27,17113.0,3:28,3,1,4,8888.0,1:48,4750000
8476392,Adam,Lowry,1993-03-29,C,L,2017-18,45,8,13,21,0.47,9,70,11.43,8,40213.0,14:53,375,296,671,55.89,124,28,21,4,17,1,1,2,2091.0,0:46,0,0,0,5499.0,2:2,1125000
8476393,Nick,Cousins,1993-07-20,C,L,2017-18,71,12,7,19,0.27,-7,119,10.08,31,54795.0,12:51,84,140,224,37.5,117,39,18,24,-6,1,0,1,1384.0,0:19,0,0,0,132.0,0:1,1000000
8476396,Steven,Fogarty,1993-04-19,C,R,2017-18,1,0,0,0,0.0,0,1,0.0,2,736.0,12:16,0,0,0,0.0,2,0,0,1,-1,0,0,0,0.0,0:0,0,0,0,27.0,0:27,750000
8476397,Keegan,Lowe,1993-03-29,D,L,2017-18,2,0,0,0,0.0,-1,4,0.0,0,1668.0,13:54,0,0,0,0.0,1,1,1,1,0,0,0,0,0.0,0:0,0,0,0,139.0,1:9,650000
8476399,Blake,Coleman,1991-11-28,C,L,2017-18,79,13,12,25,0.32,7,146,8.9,50,68235.0,14:23,252,285,537,46.93,216,57,68,21,47,0,0,0,466.0,0:5,3,0,3,10158.0,2:8,660000
8476400,Logan,Shaw,1992-10-05,RW,R,2017-18,72,4,10,14,0.19,-7,105,3.81,12,51313.0,11:52,92,111,203,45.32,110,46,24,21,3,0,0,0,292.0,0:4,0,1,1,7138.0,1:39,650000
8476401,Daniel,Catenacci,1993-03-09,C,L,2017-18,1,0,0,0,0.0,-1,1,0.0,0,663.0,11:3,0,0,0,0.0,1,1,0,0,0,0,0,0,0.0,0:0,0,0,0,0.0,0:0,650000
8476403,Klas,Dahlbeck,1991-07-06,D,L,2017-18,33,1,4,5,0.15,-6,43,2.33,21,32402.0,16:21,0,0,0,0.0,74,34,7,14,-7,0,0,0,116.0,0:3,0,0,0,2118.0,1:4,850000
8476404,Andy,Andreoff,1991-05-17,LW,L,2017-18,45,3,6,9,0.2,-6,47,6.38,50,25352.0,9:23,24,29,53,45.28,77,11,3,7,-4,0,0,0,109.0,0:2,0,0,0,73.0,0:1,677500
8476406,Nick,Shore,1992-09-26,C,R,2017-18,64,5,14,19,0.3,-3,74,6.76,16,54407.0,14:10,352,386,738,47.7,55,20,23,23,0,0,1,1,929.0,0:14,0,0,0,6426.0,1:40,925000
8476407,Andy,Welinski,1993-04-27,D,R,2017-18,7,0,2,2,0.29,-1,6,0.0,0,6793.0,16:10,0,0,0,0.0,4,8,1,5,-4,0,0,0,435.0,1:2,0,0,0,199.0,0:28,925000
8476409,Alan,Quine,1993-02-25,C,L,2017-18,21,0,3,3,0.14,-2,15,0.0,4,14787.0,11:44,40,63,103,38.83,32,9,5,6,-1,0,0,0,109.0,0:5,0,0,0,404.0,0:19,612500
8476410,Josh,Leivo,1993-05-26,LW,R,2017-18,16,1,3,4,0.25,0,25,4.0,6,10145.0,10:34,6,3,9,66.67,2,5,9,6,3,0,0,0,1804.0,1:52,0,0,0,0.0,0:0,612500
8476415,Kyle,Rau,1992-10-24,C,L,2017-18,3,0,1,1,0.33,0,4,0.0,0,1985.0,11:1,0,0,0,0.0,7,0,1,0,1,0,0,0,0.0,0:0,0,0,0,0.0,0:0,700000
8476419,Jean-Gabriel,Pageau,1992-11-11,C,R,2017-18,78,14,15,29,0.37,-14,147,9.52,36,78338.0,16:44,580,553,1133,51.19,131,69,30,41,-11,1,1,2,4837.0,1:2,1,0,1,9297.0,1:59,3100000
8476422,Mike,Reilly,1993-07-13,D,L,2017-18,57,2,16,18,0.32,-5,65,3.08,26,51172.0,14:57,0,0,0,0.0,41,37,8,32,-24,0,6,6,5583.0,1:37,0,0,0,279.0,0:4,725000
8476423,Reid,Boucher,1993-09-08,C,L,2017-18,20,3,2,5,0.25,-12,37,8.11,0,13651.0,11:22,1,2,3,33.33,13,3,8,4,4,1,1,2,1286.0,1:4,0,0,0,35.0,0:1,687500
8476427,Ty,Rattie,1993-02-05,RW,R,2017-18,14,5,4,9,0.64,1,32,15.62,2,12996.0,15:28,0,0,0,0.0,11,4,2,4,-2,0,0,0,1303.0,1:33,0,0,0,0.0,0:0,700000
8476428,Rocco,Grimaldi,1993-02-08,C,R,2017-18,6,1,2,3,0.5,0,7,14.29,0,3471.0,9:38,0,1,1,0.0,3,5,5,3,2,0,0,0,53.0,0:8,0,0,0,0.0,0:0,750000
8476429,Scott,Mayfield,1992-10-14,D,R,2017-18,47,2,10,12,0.26,-6,58,3.45,45,50322.0,17:50,0,0,0,0.0,77,73,5,37,-32,0,0,0,194.0,0:4,0,0,0,4227.0,1:29,625000
8476430,Tomas,Jurco,1992-12-28,LW,L,2017-18,29,6,4,10,0.34,1,44,13.64,12,21954.0,12:37,4,12,16,25.0,22,12,9,6,3,0,0,0,418.0,0:14,0,0,0,281.0,0:9,800000
8476431,Adam,Clendening,1992-10-26,D,R,2017-18,5,0,2,2,0.4,-1,4,0.0,2,4780.0,15:56,0,0,0,0.0,2,6,2,4,-2,0,0,0,104.0,0:20,0,0,0,39.0,0:7,650000
8476432,Boone,Jenner,1993-06-15,C,L,2017-18,75,13,19,32,0.43,1,187,6.95,39,74076.0,16:27,268,215,483,55.49,205,83,34,17,17,2,1,3,5931.0,1:19,0,0,0,4099.0,0:54,2900000
8476436,Dmitrij,Jaskin,1993-03-23,RW,L,2017-18,76,6,11,17,0.22,6,124,4.84,14,56765.0,12:26,2,11,13,15.38,207,46,36,17,19,0,1,1,2200.0,0:28,0,0,0,213.0,0:2,1000000
8476437,Victor,Rask,1993-03-01,C,L,2017-18,71,14,17,31,0.44,0,126,11.11,12,65523.0,15:22,393,323,716,54.89,62,29,48,39,9,4,7,11,9004.0,2:6,0,0,0,55.0,0:0,4000000
8476438,Brandon,Saad,1992-10-27,LW,L,2017-18,82,18,17,35,0.43,-10,237,7.59,14,86120.0,17:30,56,65,121,46.28,29,32,45,16,29,1,0,1,10477.0,2:7,0,0,0,8430.0,1:42,6000000
8476439,Brett,Ritchie,1993-07-01,RW,R,2017-18,71,7,7,14,0.2,1,117,5.98,42,46175.0,10:50,0,1,1,0.0,172,10,9,16,-7,2,1,3,6163.0,1:26,0,0,0,0.0,0:0,1750000
8476440,Markus,Granlund,1993-04-16,C,L,2017-18,53,8,4,12,0.23,-10,93,8.6,8,51694.0,16:15,73,106,179,40.78,47,12,22,8,14,2,1,3,3608.0,1:8,2,0,2,7684.0,2:24,900000
8476441,Joel,Edmundson,1993-06-28,D,L,2017-18,69,7,10,17,0.25,-1,124,5.65,57,85865.0,20:44,0,0,0,0.0,116,150,17,28,-11,0,0,0,1351.0,0:19,0,0,0,9258.0,2:14,1050000
8476442,Matt,Nieto,1992-11-05,LW,L,2017-18,74,15,11,26,0.35,6,84,17.86,14,66196.0,14:54,4,9,13,30.77,27,56,21,12,9,0,0,0,389.0,0:5,1,0,1,10117.0,2:16,1000000
8476443,Xavier,Ouellet,1993-07-29,D,L,2017-18,45,0,7,7,0.16,-3,57,0.0,6,37416.0,13:51,0,0,0,0.0,36,43,6,15,-9,0,0,0,76.0,0:1,0,0,0,3366.0,1:14,1250000
8476447,Miikka,Salomaki,1993-03-09,RW,L,2017-18,58,2,6,8,0.14,-8,51,3.92,34,35773.0,10:16,5,7,12,41.67,114,35,14,8,6,0,0,0,135.0,0:2,0,0,0,822.0,0:14,612500
8476448,William,Karlsson,1993-01-08,C,L,2017-18,82,43,35,78,0.95,49,184,23.37,12,92087.0,18:43,402,435,837,48.03,48,45,78,46,32,8,8,16,11840.0,2:24,4,1,5,8131.0,1:39,1000000
8476449,Scott,Harrington,1993-03-10,D,L,2017-18,32,2,3,5,0.16,0,28,7.14,8,25535.0,13:17,0,0,0,0.0,35,44,7,3,4,0,0,0,53.0,0:1,0,1,1,1620.0,0:50,675000
8476450,Ryan,Sproul,1993-01-13,D,R,2017-18,16,1,4,5,0.31,-6,15,6.67,6,15716.0,16:22,0,0,0,0.0,6,17,5,8,-3,0,1,1,198.0,0:12,0,0,0,583.0,0:36,625000
8476453,Nikita,Kucherov,1993-06-17,RW,L,2017-18,80,39,61,100,1.25,15,279,13.98,42,95143.0,19:49,3,2,5,60.0,31,15,66,79,-13,8,28,36,16841.0,3:30,0,0,0,24.0,0:0,4766667
8476454,Ryan,Nugent-Hopkins,1993-04-12,C,L,2017-18,62,24,24,48,0.77,10,151,15.89,20,67295.0,18:5,374,393,767,48.76,44,39,46,45,1,4,5,9,7295.0,1:57,2,1,3,6021.0,1:37,6000000
8476455,Gabriel,Landeskog,1992-11-23,LW,L,2017-18,78,25,37,62,0.79,16,183,13.66,37,94270.0,20:8,215,203,418,51.44,149,51,54,31,23,8,9,17,16782.0,3:35,0,1,1,5242.0,1:7,5571429
8476456,Jonathan,Huberdeau,1993-06-04,LW,L,2017-18,82,27,42,69,0.84,-2,204,13.24,32,94495.0,19:12,21,23,44,47.73,41,42,54,88,-34,7,12,19,16682.0,3:23,0,0,0,488.0,0:5,5900000
8476457,Adam,Larsson,1992-11-12,D,R,2017-18,63,4,9,13,0.21,10,92,4.35,34,82904.0,21:55,0,0,0,0.0,239,140,26,52,-26,0,0,0,309.0,0:4,0,0,0,9060.0,2:23,4166666
8476458,Ryan,Strome,1993-07-11,C,R,2017-18,82,13,21,34,0.41,-4,147,8.84,33,74883.0,15:13,297,374,671,44.26,43,17,41,45,-4,2,4,6,9543.0,1:56,0,1,1,3726.0,0:45,2500000
8476459,Mika,Zibanejad,1993-04-18,C,R,2017-18,72,27,20,47,0.65,-23,212,12.74,14,77609.0,17:57,654,633,1287,50.82,92,64,49,63,-14,14,7,21,12880.0,2:58,0,1,1,5048.0,1:10,5350000
8476460,Mark,Scheifele,1993-03-15,C,R,2017-18,60,23,37,60,1.0,19,125,18.4,18,74442.0,20:40,594,565,1159,51.25,57,31,47,33,14,8,8,16,11228.0,3:7,2,1,3,4219.0,1:10,6125000
8476461,Sean,Couturier,1992-12-07,C,L,2017-18,82,31,45,76,0.93,34,227,13.66,31,106231.0,21:35,529,472,1001,52.85,74,44,48,37,11,7,7,14,15872.0,3:13,0,0,0,9313.0,1:53,4333333
8476462,Dougie,Hamilton,1993-06-17,D,R,2017-18,82,17,27,44,0.54,1,270,6.3,64,105932.0,21:31,1,2,3,33.33,83,80,31,72,-41,6,6,12,13095.0,2:39,0,0,0,2468.0,0:30,5750000
8476463,Jonas,Brodin,1993-07-12,D,L,2017-18,73,6,15,21,0.29,23,77,7.79,30,94627.0,21:36,0,0,0,0.0,34,139,16,22,-6,0,3,3,3428.0,0:46,0,0,0,10525.0,2:24,4166667
8476464,Duncan,Siemens,1993-09-07,D,L,2017-18,16,1,1,2,0.12,-5,14,7.14,23,11826.0,12:19,0,0,0,0.0,22,21,2,5,-3,0,0,0,2.0,0:0,0,0,0,2498.0,2:36,750000
8476465,Ryan,Murphy,1993-03-31,D,R,2017-18,21,2,3,5,0.24,8,25,8.0,16,23954.0,19:0,0,0,0,0.0,5,19,1,12,-11,1,0,1,1839.0,1:27,0,0,0,379.0,0:18,787500
8476466,Sven,Baertschi,1992-10-05,LW,L,2017-18,53,14,15,29,0.55,3,82,17.07,20,49624.0,15:36,1,6,7,14.29,19,29,19,17,2,7,2,9,6454.0,2:1,0,0,0,24.0,0:0,1850000
8476467,Jamie,Oleksiak,1992-12-21,D,L,2017-18,68,5,12,17,0.25,6,81,6.17,87,67975.0,16:39,0,0,0,0.0,174,76,19,37,-18,1,0,1,1081.0,0:15,0,0,0,7674.0,1:52,964688
8476468,J.T.,Miller,1993-03-14,C,L,2017-18,82,23,35,58,0.71,-4,143,16.08,40,83740.0,17:1,437,368,805,54.29,124,26,43,72,-29,11,7,18,11088.0,2:15,0,0,0,1711.0,0:20,2750000
8476469,Joel,Armia,1993-05-31,RW,R,2017-18,79,12,17,29,0.37,3,128,9.38,22,59731.0,12:36,7,8,15,46.67,86,39,48,16,32,0,4,4,7072.0,1:29,1,1,2,5346.0,1:7,925000
8476470,Nathan,Beaulieu,1992-12-05,D,L,2017-18,59,1,8,9,0.15,-19,67,1.49,36,56453.0,15:56,0,0,0,0.0,45,65,6,30,-24,0,1,1,3158.0,0:53,0,0,0,908.0,0:15,2400000
8476472,Oscar,Klefbom,1993-07-20,D,L,2017-18,66,5,16,21,0.32,-12,203,2.46,18,90475.0,22:50,0,0,0,0.0,49,136,27,43,-16,1,5,6,10926.0,2:45,1,0,1,8924.0,2:15,4167000
8476473,Connor,Murphy,1993-03-26,D,R,2017-18,76,2,12,14,0.18,-3,109,1.83,34,74663.0,16:22,0,0,0,0.0,138,101,15,33,-18,0,0,0,430.0,0:5,0,0,0,5113.0,1:7,3850000
8476474,Stefan,Noesen,1993-02-12,RW,R,2017-18,72,13,14,27,0.38,12,127,10.24,36,57398.0,13:17,20,35,55,36.36,112,41,33,15,18,0,0,0,1479.0,0:20,0,0,0,400.0,0:5,660000
8476476,Joe,Morrow,1992-12-09,D,L,2017-18,56,6,10,16,0.29,-4,83,7.23,26,56223.0,16:43,0,0,0,0.0,79,67,13,48,-35,1,4,5,2129.0,0:38,0,0,0,2167.0,0:38,650000
8476479,Phillip,Danault,1993-02-24,C,L,2017-18,52,8,17,25,0.48,0,94,8.51,34,51754.0,16:35,380,340,720,52.78,59,38,38,20,18,0,2,2,3176.0,1:1,1,0,1,5751.0,1:50,912500
8476480,Vladislav,Namestnikov,1992-11-22,C,L,2017-18,81,22,26,48,0.59,6,155,14.19,45,83046.0,17:5,285,337,622,45.82,79,44,27,24,3,9,7,16,14793.0,3:2,0,0,0,363.0,0:4,1937500
8476483,Rickard,Rakell,1993-05-05,C,R,2017-18,77,34,35,69,0.9,6,230,14.78,14,89705.0,19:25,105,121,226,46.46,115,30,32,53,-21,8,10,18,12595.0,2:43,0,0,0,533.0,0:6,3789444
8476495,Seth,Griffith,1993-01-04,C,R,2017-18,21,2,1,3,0.14,-6,15,13.33,6,13313.0,10:33,0,3,3,0.0,10,4,2,6,-4,0,1,1,818.0,0:38,0,0,0,3.0,0:0,650000
8476525,Colin,Miller,1992-10-29,D,R,2017-18,82,10,31,41,0.5,-4,177,5.65,53,95171.0,19:20,1,0,1,100.0,165,64,35,56,-21,5,12,17,12042.0,2:26,0,1,1,4799.0,0:58,1000000
8476539,Jonathan,Marchessault,1990-12-27,C,R,2017-18,77,27,48,75,0.97,36,268,10.07,40,80871.0,17:30,264,343,607,43.49,99,26,59,48,11,6,10,16,11365.0,2:27,0,0,0,95.0,0:1,750000
8476617,Tomas,Hyka,1993-03-23,RW,R,2017-18,10,1,2,3,0.3,2,15,6.67,0,7232.0,12:3,0,0,0,0.0,6,3,5,4,1,0,1,1,899.0,1:29,0,0,0,0.0,0:0,710000
8476619,Zack,Mitchell,1993-01-07,RW,R,2017-18,23,3,2,5,0.22,-2,17,17.65,4,14544.0,10:32,15,16,31,48.39,26,10,11,0,11,1,0,1,112.0,0:4,0,0,0,840.0,0:36,660000
8476624,Barclay,Goodrow,1993-02-26,RW,L,2017-18,47,7,7,14,0.3,1,57,12.28,28,30693.0,10:53,154,108,262,58.78,68,30,20,9,11,0,0,0,481.0,0:10,1,0,1,2438.0,0:51,650000
8476779,Brad,Hunt,1988-08-24,D,L,2017-18,45,3,15,18,0.4,-5,80,3.75,6,44947.0,16:38,0,1,1,0.0,19,36,22,11,11,2,10,12,6448.0,2:23,0,0,0,190.0,0:4,650000
8476792,Torey,Krug,1991-04-12,D,L,2017-18,76,14,45,59,0.78,0,197,7.11,36,93030.0,20:24,0,0,0,0.0,79,73,35,71,-36,5,19,24,15638.0,3:25,1,0,1,1669.0,0:21,5250000
8476806,J.T.,Brown,1990-07-02,RW,R,2017-18,47,2,5,7,0.15,-5,40,5.0,24,25580.0,9:4,51,66,117,43.59,71,23,11,11,0,0,0,0,123.0,0:2,0,0,0,615.0,0:13,1250000
8476807,Matt,Tennyson,1990-04-23,D,R,2017-18,15,0,0,0,0.0,-8,25,0.0,8,16175.0,17:58,0,0,0,0.0,13,11,1,6,-5,0,0,0,1590.0,1:46,0,0,0,607.0,0:40,650000
8476822,Luke,Glendening,1989-04-28,RW,R,2017-18,69,11,8,19,0.28,-14,88,12.5,17,54644.0,13:11,394,285,679,58.03,137,83,16,10,6,1,0,1,313.0,0:4,2,1,3,11248.0,2:43,1800000
8476826,Yanni,Gourde,1991-12-15,C,L,2017-18,82,25,39,64,0.78,34,136,18.38,50,79497.0,16:9,158,206,364,43.41,57,42,52,35,17,7,6,13,9223.0,1:52,1,1,2,5261.0,1:4,1000000
8476850,Ryan,Murray,1993-09-27,D,L,2017-18,44,1,11,12,0.27,4,34,2.94,8,48672.0,18:26,0,0,0,0.0,31,75,11,18,-7,0,0,0,726.0,0:16,0,0,0,5335.0,2:1,2825000
8476851,Alex,Galchenyuk,1994-02-12,LW,L,2017-18,82,19,32,51,0.62,-31,213,8.92,22,79872.0,16:14,49,60,109,44.95,33,37,29,56,-27,9,15,24,14401.0,2:55,0,0,0,117.0,0:1,4900000
8476853,Morgan,Rielly,1994-03-09,D,L,2017-18,76,6,46,52,0.68,-4,182,3.3,14,98495.0,21:35,0,2,2,0.0,48,84,34,79,-45,1,24,25,10011.0,2:11,0,0,0,5203.0,1:8,5000000
8476854,Hampus,Lindholm,1994-01-20,D,L,2017-18,69,13,18,31,0.45,16,131,9.92,34,94143.0,22:44,0,0,0,0.0,93,97,24,63,-39,3,5,8,7326.0,1:46,0,0,0,9844.0,2:22,5205556
8476855,Nail,Yakupov,1993-10-06,RW,L,2017-18,58,9,7,16,0.28,2,94,9.57,26,37717.0,10:50,0,2,2,0.0,60,9,17,16,1,3,1,4,6516.0,1:52,0,0,0,0.0,0:0,875000
8476856,Matt,Dumba,1994-07-25,D,R,2017-18,82,14,36,50,0.61,15,176,7.95,41,117169.0,23:48,2,0,2,100.0,136,112,22,52,-30,2,10,12,11543.0,2:20,0,1,1,9004.0,1:49,2550000
8476857,Pontus,Aberg,1993-09-23,LW,R,2017-18,53,4,12,16,0.3,9,70,5.71,10,38692.0,12:10,4,8,12,33.33,24,8,12,20,-8,0,1,1,1139.0,0:21,0,0,0,54.0,0:1,650000
8476858,Phillip,Di Giuseppe,1993-10-09,LW,L,2017-18,49,5,8,13,0.27,0,64,7.81,17,30876.0,10:30,0,1,1,0.0,88,14,16,13,3,0,0,0,369.0,0:7,0,0,0,17.0,0:0,725000
8476867,Brendan,Gaunce,1994-03-25,C,L,2017-18,37,4,2,6,0.16,0,55,7.27,10,29548.0,13:18,38,46,84,45.24,48,11,16,16,0,1,0,1,101.0,0:2,0,0,0,4072.0,1:50,750000
8476869,Brady,Skjei,1994-03-26,D,L,2017-18,82,4,21,25,0.3,-27,153,2.61,39,103443.0,21:1,0,0,0,0.0,127,119,27,62,-35,0,6,6,5918.0,1:12,1,0,1,7495.0,1:31,925000
8476870,Stefan,Matteau,1994-02-23,C,L,2017-18,8,0,1,1,0.12,0,8,0.0,0,3937.0,8:12,1,1,2,50.0,8,1,5,3,2,0,0,0,128.0,0:16,0,0,0,0.0,0:0,650000
8476871,Tanner,Pearson,1992-08-10,LW,L,2017-18,82,15,25,40,0.49,11,180,8.33,27,78561.0,15:58,36,37,73,49.32,116,36,25,39,-14,2,3,5,8870.0,1:48,0,0,0,5047.0,1:1,3750000
8476872,Scott,Laughton,1994-05-30,C,L,2017-18,81,10,10,20,0.25,-10,108,9.26,42,54043.0,11:7,314,290,604,51.99,126,27,22,23,-1,0,0,0,364.0,0:4,1,0,1,5105.0,1:3,962500
8476873,Mark,Jankowski,1994-09-13,C,L,2017-18,72,17,8,25,0.35,-7,118,14.41,33,57698.0,13:21,395,415,810,48.77,35,51,33,20,13,2,1,3,3516.0,0:48,2,0,2,4582.0,1:3,925000
8476874,Olli,Maatta,1994-08-22,D,L,2017-18,82,7,22,29,0.35,-1,164,4.27,28,92279.0,18:45,0,0,0,0.0,131,115,17,50,-33,0,8,8,6489.0,1:19,0,0,0,6992.0,1:25,4083333
8476875,Mike,Matheson,1994-02-27,D,L,2017-18,81,10,17,27,0.33,-1,167,5.99,61,103699.0,21:20,0,0,0,0.0,53,137,68,92,-24,1,3,4,5411.0,1:6,0,1,1,8709.0,1:47,925000
8476877,Jordan,Schmaltz,1993-10-08,D,R,2017-18,13,0,1,1,0.08,0,5,0.0,6,8558.0,10:58,0,0,0,0.0,4,12,0,4,-4,0,0,0,317.0,0:24,0,0,0,0.0,0:0,925000
8476878,Zemgus,Girgensons,1994-01-05,C,L,2017-18,71,7,8,15,0.21,-12,113,6.19,26,58404.0,13:42,23,40,63,36.51,134,32,18,12,6,0,0,0,374.0,0:5,2,0,2,6915.0,1:37,1600000
8476879,Cody,Ceci,1993-12-21,D,R,2017-18,82,5,14,19,0.23,-27,143,3.5,12,114830.0,23:20,0,0,0,0.0,163,171,18,40,-22,0,5,5,3132.0,0:38,0,0,0,13614.0,2:46,2800000
8476880,Tom,Wilson,1994-03-29,RW,R,2017-18,78,14,21,35,0.45,10,123,11.38,187,74828.0,15:59,25,29,54,46.3,250,51,40,44,-4,0,1,1,324.0,0:4,1,0,1,8083.0,1:43,2000000
8476881,Tomas,Hertl,1993-11-12,C,L,2017-18,79,22,25,47,0.59,-2,175,12.57,41,85801.0,18:6,587,569,1156,50.78,84,71,60,45,15,6,7,13,11832.0,2:29,1,2,3,7152.0,1:30,3000000
8476882,Teuvo,Teravainen,1994-09-11,LW,L,2017-18,82,23,41,64,0.78,8,185,12.43,14,83085.0,16:53,15,34,49,30.61,26,22,47,33,14,5,15,20,13157.0,2:40,0,0,0,56.0,0:0,2860000
8476884,Derrick,Pouliot,1994-01-16,D,L,2017-18,71,3,19,22,0.31,-22,78,3.85,39,76048.0,17:51,0,0,0,0.0,79,118,24,67,-43,1,8,9,6738.0,1:34,0,1,1,929.0,0:13,800000
8476885,Jacob,Trouba,1994-02-26,D,R,2017-18,55,3,21,24,0.44,9,144,2.08,34,72263.0,21:53,0,0,0,0.0,84,100,28,54,-26,0,3,3,4860.0,1:28,0,1,1,8299.0,2:30,2812500
8476886,Slater,Koekkoek,1994-02-18,D,L,2017-18,35,4,4,8,0.23,4,43,9.3,18,23594.0,11:14,0,0,0,0.0,36,24,3,6,-3,0,0,0,116.0,0:3,0,0,0,967.0,0:27,800000
8476887,Filip,Forsberg,1994-08-13,LW,R,2017-18,67,26,38,64,0.96,27,179,14.53,38,70246.0,17:28,4,5,9,44.44,86,37,49,65,-16,13,8,21,11642.0,2:53,0,1,1,2275.0,0:33,6000000
8476889,Radek,Faksa,1994-01-09,C,L,2017-18,79,17,16,33,0.42,21,118,14.41,36,72386.0,15:16,556,521,1077,51.62,101,56,38,16,22,0,0,0,1125.0,0:14,2,0,2,9422.0,1:59,2200000
8476890,Patrick,Sieloff,1994-05-15,D,L,2017-18,1,1,0,1,1.0,-2,3,33.33,0,671.0,11:11,0,0,0,0.0,1,1,0,0,0,0,0,0,0.0,0:0,0,0,0,0.0,0:0,650000
8476891,Matt,Grzelcyk,1994-01-05,D,L,2017-18,61,3,12,15,0.25,21,82,3.66,22,61271.0,16:44,0,0,0,0.0,45,42,26,24,2,0,2,2,4070.0,1:6,0,0,0,307.0,0:5,858750
8476892,Colton,Parayko,1993-05-12,D,R,2017-18,82,6,29,35,0.43,-7,212,2.83,13,111263.0,22:36,0,0,0,0.0,120,141,54,43,11,2,7,9,9543.0,1:56,0,0,0,9369.0,1:54,5500000
8476894,Brendan,Leipsic,1994-05-19,LW,L,2017-18,58,5,17,22,0.38,-4,95,5.26,14,45714.0,13:8,8,6,14,57.14,32,22,39,33,6,0,0,0,2903.0,0:50,0,0,0,30.0,0:0,650000
8476897,Oskar,Sundqvist,1994-03-23,C,R,2017-18,42,1,4,5,0.12,-5,41,2.44,14,26401.0,10:28,144,179,323,44.58,47,14,20,6,14,0,0,0,1094.0,0:26,0,0,0,2478.0,0:59,675000
8476902,Esa,Lindell,1994-05-23,D,L,2017-18,80,7,20,27,0.34,19,137,5.11,24,105977.0,22:4,0,0,0,0.0,92,123,19,50,-31,2,6,8,7573.0,1:34,0,0,0,9136.0,1:54,2200000
8476905,Chandler,Stephenson,1994-04-22,C,L,2017-18,67,6,12,18,0.27,13,36,16.67,8,47713.0,11:52,40,33,73,54.79,26,33,24,16,8,0,0,0,581.0,0:8,0,0,0,5240.0,1:18,650000
8476906,Shayne,Gostisbehere,1993-04-20,D,L,2017-18,78,13,52,65,0.83,10,221,5.88,25,100411.0,21:27,0,0,0,0.0,53,116,23,52,-29,7,26,33,16878.0,3:36,0,0,0,371.0,0:4,4500000
8476913,Devin,Shore,1994-07-19,C,L,2017-18,82,11,21,32,0.39,-28,123,8.94,14,75908.0,15:25,88,102,190,46.32,71,57,31,19,12,2,9,11,8993.0,1:49,1,1,2,6935.0,1:24,870000
8476915,Jujhar,Khaira,1994-08-13,LW,L,2017-18,69,11,10,21,0.3,-7,73,15.07,47,52609.0,12:42,174,209,383,45.43,128,39,26,32,-6,0,1,1,1439.0,0:20,1,1,2,6180.0,1:29,675000
8476917,Adam,Pelech,1994-08-16,D,L,2017-18,78,3,16,19,0.24,7,106,2.83,28,90203.0,19:16,0,0,0,0.0,100,142,32,47,-15,0,2,2,1534.0,0:19,0,1,1,10587.0,2:15,1600000
8476918,Jimmy,Vesey,1993-05-26,LW,L,2017-18,79,17,11,28,0.35,-18,136,12.5,20,67930.0,14:19,15,17,32,46.88,83,34,46,46,0,1,2,3,6966.0,1:28,0,0,0,791.0,0:10,925000
8476919,Chris,Tierney,1994-07-01,C,L,2017-18,82,17,23,40,0.49,0,118,14.41,8,78719.0,15:59,488,468,956,51.05,26,45,50,55,-5,3,4,7,4878.0,0:59,2,2,4,7684.0,1:33,735000
8476921,Jordan,Martinook,1992-07-25,LW,L,2017-18,81,6,9,15,0.19,-23,112,5.36,45,68126.0,14:1,39,68,107,36.45,128,42,32,8,24,0,0,0,792.0,0:9,0,1,1,8941.0,1:50,1800000
8476922,Boo,Nieves,1994-01-23,C,L,2017-18,28,1,8,9,0.32,6,23,4.35,12,17134.0,10:11,97,122,219,44.29,30,19,15,9,6,0,0,0,57.0,0:2,0,0,0,776.0,0:27,-111
8476923,Damon,Severson,1994-08-07,D,R,2017-18,76,9,15,24,0.32,-8,121,7.44,42,89740.0,19:40,0,0,0,0.0,107,62,26,50,-24,0,4,4,7464.0,1:38,0,0,0,1726.0,0:22,4166666
8476924,Martin,Frk,1993-10-05,RW,R,2017-18,68,11,14,25,0.37,-14,99,11.11,14,41972.0,10:17,0,2,2,0.0,77,10,9,21,-12,5,4,9,8796.0,2:9,0,0,0,7.0,0:0,650000
8476925,Colton,Sissons,1993-11-05,C,R,2017-18,81,9,18,27,0.33,2,120,7.5,42,78218.0,16:5,517,418,935,55.29,136,49,25,30,-5,1,6,7,9424.0,1:56,0,3,3,11246.0,2:18,625000
8476931,Jake,McCabe,1993-10-12,D,L,2017-18,53,3,9,12,0.23,-11,53,5.66,26,62013.0,19:30,0,1,1,0.0,110,79,14,26,-12,1,0,1,1883.0,0:35,0,0,0,6124.0,1:55,1600000
8476934,Brock,McGinn,1994-02-02,LW,L,2017-18,80,16,14,30,0.38,-12,159,10.06,22,69584.0,14:29,17,20,37,45.95,137,17,38,34,4,2,1,3,1618.0,0:20,1,0,1,5764.0,1:12,887500
8476941,Connor,Carrick,1994-04-13,D,R,2017-18,47,4,8,12,0.26,5,55,7.27,27,42680.0,15:8,0,0,0,0.0,42,53,10,21,-11,1,1,2,855.0,0:18,0,0,0,93.0,0:1,750000
8476948,Charles,Hudon,1994-06-23,LW,L,2017-18,72,10,20,30,0.42,-12,179,5.59,38,60605.0,14:1,88,131,219,40.18,126,38,37,25,12,3,5,8,6536.0,1:30,0,1,1,18.0,0:0,650000
8476952,Dominic,Toninato,1994-03-09,C,L,2017-18,37,0,2,2,0.05,0,25,0.0,12,17533.0,7:53,83,116,199,41.71,24,14,3,4,-1,0,0,0,80.0,0:2,0,0,0,450.0,0:12,925000
8476953,Trevor,Carrick,1994-07-04,D,L,2017-18,1,0,0,0,0.0,0,1,0.0,2,452.0,7:32,0,0,0,0.0,0,0,0,0,0,0,0,0,0.0,0:0,0,0,0,0.0,0:0,670000
8476955,Taylor,Leier,1994-02-15,LW,L,2017-18,39,1,4,5,0.13,-7,48,2.08,6,24542.0,10:29,3,2,5,60.0,10,19,11,1,10,0,0,0,658.0,0:16,0,0,0,2738.0,1:10,806558
8476958,Jaccob,Slavin,1994-05-01,D,L,2017-18,82,8,22,30,0.37,1,154,5.19,10,111132.0,22:35,0,0,0,0.0,47,154,77,40,37,1,1,2,2997.0,0:36,0,0,0,12824.0,2:36,742500
8476960,Andreas,Athanasiou,1994-08-06,LW,L,2017-18,71,16,17,33,0.46,-15,170,9.41,16,65238.0,15:18,106,149,255,41.57,24,28,38,36,2,1,2,3,7388.0,1:44,0,0,0,1605.0,0:22,1387500
8476966,Gemel,Smith,1994-04-16,C,L,2017-18,46,6,5,11,0.24,6,42,14.29,17,26031.0,9:25,43,51,94,45.74,33,13,12,5,7,0,0,0,131.0,0:2,0,0,0,324.0,0:7,650000
8476967,Brett,Kulak,1994-01-06,D,L,2017-18,71,2,6,8,0.11,-3,73,2.74,27,55319.0,12:59,0,0,0,0.0,45,49,17,24,-7,0,0,0,181.0,0:2,0,0,0,1095.0,0:15,650000
8476971,Kevin,Roy,1993-05-20,LW,L,2017-18,25,6,1,7,0.28,3,26,23.08,6,20473.0,13:38,0,9,9,0.0,11,7,13,7,6,1,0,1,1751.0,1:10,0,0,0,28.0,0:1,925000
8476975,Cedric,Paquette,1993-08-13,C,L,2017-18,56,5,4,9,0.16,-5,64,7.81,41,34279.0,10:12,234,265,499,46.89,112,32,8,6,2,0,1,1,273.0,0:4,0,0,0,1808.0,0:32,812500
8476979,Erik,Gustafsson,1992-03-14,D,L,2017-18,35,5,11,16,0.46,1,71,7.04,6,38966.0,18:33,0,1,1,0.0,30,45,12,23,-11,0,4,4,2976.0,1:25,0,0,0,61.0,0:1,650000
8476981,Josh,Anderson,1994-05-07,RW,R,2017-18,63,19,11,30,0.48,-1,188,10.11,42,68183.0,18:2,26,36,62,41.94,109,24,41,20,21,1,3,4,5147.0,1:21,0,0,0,3720.0,0:59,1850000
8476982,Danny,O'Regan,1994-01-30,C,R,2017-18,21,0,4,4,0.19,-2,17,0.0,2,12560.0,9:58,58,62,120,48.33,5,6,8,6,2,0,1,1,812.0,0:38,0,0,0,241.0,0:11,858750
8476983,Paul,LaDue,1992-09-06,D,R,2017-18,12,3,1,4,0.33,5,13,23.08,6,10059.0,13:58,0,0,0,0.0,12,11,1,4,-3,1,0,1,590.0,0:49,0,0,0,99.0,0:8,874125
8476988,Matt,Benning,1994-05-25,D,R,2017-18,73,6,15,21,0.29,5,111,5.41,49,75696.0,17:16,0,0,0,0.0,149,82,18,61,-43,0,2,2,3893.0,0:53,0,1,1,2349.0,0:32,925000
8476994,Vinnie,Hinostroza,1994-04-03,LW,R,2017-18,50,7,18,25,0.5,5,86,8.14,10,41459.0,13:49,39,50,89,43.82,26,17,27,16,11,1,4,5,4302.0,1:26,0,0,0,5.0,0:0,717500
8477009,Jake,Dotchin,1994-03-24,D,R,2017-18,48,3,8,11,0.23,17,48,6.25,38,47476.0,16:29,0,0,0,0.0,95,61,4,33,-29,0,0,0,271.0,0:5,0,1,1,1690.0,0:35,812500
8477010,Joseph,Blandisi,1994-07-18,LW,L,2017-18,3,0,0,0,0.0,2,4,0.0,2,2102.0,11:40,0,0,0,0.0,2,2,1,0,1,0,0,0,13.0,0:4,0,0,0,0.0,0:0,680000
8477015,Connor,Brown,1994-01-14,RW,R,2017-18,82,14,14,28,0.34,0,119,11.76,18,73866.0,15:0,59,93,152,38.82,23,28,45,26,19,1,1,2,5747.0,1:10,1,0,1,9008.0,1:49,2100000
8477018,Ben,Hutton,1993-04-20,D,L,2017-18,61,0,6,6,0.1,-9,103,0.0,23,67397.0,18:24,0,1,1,0.0,40,68,26,43,-17,0,2,2,3510.0,0:57,0,1,1,5833.0,1:35,2800000
8477021,Alexander,Kerfoot,1994-08-11,C,L,2017-18,79,19,24,43,0.54,-7,81,23.46,28,63714.0,13:26,207,285,492,42.07,42,35,30,24,6,5,12,17,11763.0,2:28,0,0,0,15.0,0:0,925000
8477034,Jaycob,Megna,1992-12-10,D,L,2017-18,14,0,1,1,0.07,-4,7,0.0,2,13199.0,15:42,0,0,0,0.0,6,30,4,5,-1,0,0,0,159.0,0:11,0,0,0,1727.0,2:3,650000
8477043,Christian,Djoos,1994-08-06,D,L,2017-18,63,3,11,14,0.22,13,60,5.0,10,53050.0,14:2,0,0,0,0.0,22,55,13,33,-20,0,0,0,906.0,0:14,0,0,0,251.0,0:3,650000
8477046,Joakim,Ryan,1993-06-17,D,L,2017-18,62,3,9,12,0.19,13,79,3.8,8,62315.0,16:45,0,0,0,0.0,33,98,14,16,-2,0,0,0,603.0,0:9,0,1,1,1111.0,0:17,650000
8477070,Liam,O'Brien,1994-07-29,C,L,2017-18,3,0,0,0,0.0,0,1,0.0,5,1245.0,6:55,0,2,2,0.0,4,0,1,0,1,0,0,0,0.0,0:0,0,0,0,0.0,0:0,650000
8477073,Kurtis,MacDermid,1994-03-25,D,L,2017-18,34,1,3,4,0.12,-4,19,5.26,57,23672.0,11:36,0,0,0,0.0,77,27,3,23,-20,0,0,0,746.0,0:21,0,0,0,510.0,0:15,650000
8477085,Ashton,Sautner,1994-05-27,D,L,2017-18,5,0,2,2,0.4,4,3,0.0,2,4008.0,13:21,0,0,0,0.0,9,5,0,0,0,0,0,0,0.0,0:0,0,0,0,0.0,0:0,675000
8477205,Andrej,Sustr,1990-11-29,D,R,2017-18,44,2,5,7,0.16,-5,45,4.44,18,33895.0,12:50,0,0,0,0.0,9,33,6,16,-10,0,0,0,135.0,0:3,0,0,0,1211.0,0:27,1950000
8477213,Tim,Schaller,1990-11-16,C,L,2017-18,82,12,10,22,0.27,-5,133,9.02,42,65339.0,13:16,76,90,166,45.78,132,59,31,25,6,0,0,0,422.0,0:5,3,0,3,9304.0,1:53,775000
8477215,Danny,DeKeyser,1990-03-07,D,L,2017-18,65,6,6,12,0.18,2,65,9.23,28,79256.0,20:19,0,0,0,0.0,76,125,6,31,-25,0,0,0,624.0,0:9,0,0,0,8611.0,2:12,5000000
8477220,Nate,Schmidt,1991-07-16,D,L,2017-18,76,5,31,36,0.47,19,103,4.85,16,101419.0,22:14,0,1,1,0.0,41,121,57,57,0,1,10,11,7972.0,1:44,0,0,0,8629.0,1:53,2225000
8477240,Carter,Rowney,1989-05-10,RW,R,2017-18,44,2,3,5,0.11,-13,21,9.52,4,24675.0,9:20,164,146,310,52.9,74,24,5,6,-1,0,0,0,112.0,0:2,1,0,1,5889.0,2:13,612500
8477244,Chad,Ruhwedel,1990-05-07,D,R,2017-18,44,2,3,5,0.11,-8,67,2.99,16,41516.0,15:43,0,0,0,0.0,67,43,11,9,2,0,0,0,389.0,0:8,0,0,0,1470.0,0:33,650000
8477290,Michael,Raffl,1988-12-01,LW,L,2017-18,76,13,9,22,0.29,9,96,13.54,28,60441.0,13:15,39,27,66,59.09,90,50,28,24,4,1,0,1,971.0,0:12,0,0,0,4895.0,1:4,2350000
8477337,John,Gilmour,1993-05-17,D,L,2017-18,28,2,3,5,0.18,-11,61,3.28,14,28856.0,17:10,0,0,0,0.0,27,27,11,29,-18,1,0,1,2029.0,1:12,0,0,0,590.0,0:21,742500
8477341,Andreas,Johnsson,1994-11-21,LW,L,2017-18,9,2,1,3,0.33,-2,19,10.53,0,6318.0,11:42,2,4,6,33.33,5,5,4,5,-1,0,1,1,696.0,1:17,0,0,0,386.0,0:42,750833
8477346,MacKenzie,Weegar,1994-01-07,D,R,2017-18,60,2,6,8,0.13,5,58,3.45,32,52460.0,14:34,0,0,0,0.0,108,69,25,53,-28,0,0,0,1377.0,0:22,0,0,0,508.0,0:8,675000
8477353,Tyler,Motte,1995-03-10,C,L,2017-18,46,5,2,7,0.15,-4,64,7.81,6,30979.0,11:13,6,16,22,27.27,93,27,15,5,10,0,0,0,108.0,0:2,0,0,0,2418.0,0:52,925000
8477355,Will,Butcher,1995-01-06,D,L,2017-18,81,5,39,44,0.54,1,88,5.68,8,78072.0,16:3,0,0,0,0.0,21,62,20,36,-16,3,20,23,12864.0,2:38,0,0,0,240.0,0:2,925000
8477359,Tucker,Poolman,1993-06-08,D,R,2017-18,24,1,1,2,0.08,2,27,3.7,0,18091.0,12:33,0,0,0,0.0,20,18,5,14,-9,0,0,0,54.0,0:2,0,0,0,79.0,0:3,925000
8477369,Carson,Soucy,1994-07-27,D,L,2017-18,3,0,0,0,0.0,-2,4,0.0,2,2672.0,14:50,0,0,0,0.0,4,3,1,0,1,0,0,0,4.0,0:1,0,0,0,113.0,0:37,925000
8477380,Jonny,Brodzinski,1993-06-19,C,L,2017-18,35,4,2,6,0.17,4,53,7.55,6,19961.0,9:30,4,6,10,40.0,35,9,5,6,-1,0,0,0,533.0,0:15,0,0,0,55.0,0:1,650000
8477392,Hudson,Fasching,1995-07-28,RW,R,2017-18,5,0,0,0,0.0,-1,1,0.0,2,2910.0,9:42,0,0,0,0.0,7,2,0,0,0,0,0,0,684.0,2:16,0,0,0,0.0,0:0,925000
8477399,Tyrell,Goulbourne,1994-01-26,LW,L,2017-18,9,0,0,0,0.0,-2,2,0.0,2,3015.0,5:35,0,0,0,0.0,15,2,1,0,1,0,0,0,0.0,0:0,0,0,0,0.0,0:0,677500
8477401,John,Hayden,1995-02-14,RW,R,2017-18,47,4,9,13,0.28,-4,56,7.14,54,30526.0,10:49,12,12,24,50.0,118,23,18,8,10,0,0,0,660.0,0:14,1,0,1,2406.0,0:51,925000
8477402,Pavel,Buchnevich,1995-04-17,RW,L,2017-18,74,14,29,43,0.58,-3,136,10.29,20,66663.0,15:0,12,34,46,26.09,51,35,39,43,-4,5,12,17,11854.0,2:40,0,0,0,272.0,0:3,925000
8477404,Jake,Guentzel,1994-10-06,C,L,2017-18,82,22,26,48,0.59,-9,171,12.87,42,81112.0,16:29,65,65,130,50.0,142,46,36,18,18,7,5,12,8692.0,1:46,0,0,0,1114.0,0:13,734167
8477406,Mattias,Janmark,1992-12-08,C,L,2017-18,81,19,15,34,0.42,-14,136,13.97,24,82261.0,16:55,71,109,180,39.44,15,41,32,33,-1,4,1,5,7500.0,1:32,2,0,2,6797.0,1:23,700000
8477407,Anthony,Duclair,1995-08-26,LW,L,2017-18,56,11,12,23,0.41,-5,97,11.34,16,44632.0,13:17,1,1,2,50.0,46,26,21,8,13,3,0,3,5726.0,1:42,0,0,0,60.0,0:1,1200000
8477413,Sven,Andrighetto,1993-03-21,RW,L,2017-18,50,8,14,22,0.44,-15,111,7.21,10,43459.0,14:29,7,15,22,31.82,38,18,22,15,7,3,6,9,7307.0,2:26,0,0,0,293.0,0:5,1400000
8477415,Anton,Slepyshev,1994-05-13,LW,R,2017-18,50,6,6,12,0.24,-4,73,8.22,8,35431.0,11:48,1,6,7,14.29,61,18,25,18,7,0,0,0,381.0,0:7,0,0,0,175.0,0:3,925000
8477416,Oliver,Bjorkstrand,1995-04-10,RW,R,2017-18,82,11,29,40,0.49,4,163,6.75,9,70318.0,14:17,1,7,8,12.5,64,43,26,25,1,3,6,9,8538.0,1:44,0,0,0,32.0,0:0,655833
8477417,Peter,Cehlarik,1995-08-02,LW,L,2017-18,6,1,1,2,0.33,2,3,33.33,2,5016.0,13:56,2,2,4,50.0,3,3,0,1,-1,0,0,0,726.0,2:1,0,0,0,0.0,0:0,742500
8477425,Miles,Wood,1995-09-13,LW,L,2017-18,76,19,13,32,0.42,-6,170,11.18,84,56813.0,12:27,2,1,3,66.67,75,22,24,36,-12,3,0,3,4347.0,0:57,0,0,0,34.0,0:0,925000
8477426,Nick,Paul,1995-03-20,LW,L,2017-18,11,1,0,1,0.09,-4,11,9.09,0,5212.0,7:53,1,3,4,25.0,16,4,2,4,-2,0,0,0,0.0,0:0,0,0,0,76.0,0:6,670000
8477428,Justin,Auger,1994-05-14,RW,R,2017-18,2,0,0,0,0.0,-1,1,0.0,0,959.0,7:59,0,0,0,0.0,2,2,0,0,0,0,0,0,0.0,0:0,0,0,0,0.0,0:0,650000
8477429,Andrew,Copp,1994-07-08,C,L,2017-18,82,9,19,28,0.34,17,96,9.38,14,67569.0,13:44,296,275,571,51.84,99,51,29,30,-1,0,0,0,432.0,0:5,2,1,3,9548.0,1:56,1000000
8477433,Ben,Harpur,1995-01-12,D,L,2017-18,41,0,1,1,0.02,-21,26,0.0,21,36620.0,14:53,0,0,0,0.0,71,35,8,19,-11,0,0,0,36.0,0:0,0,0,0,4237.0,1:43,653333
8477444,Andre,Burakovsky,1995-02-09,LW,L,2017-18,56,12,13,25,0.45,3,84,14.29,27,46497.0,13:50,18,15,33,54.55,40,26,23,34,-11,2,2,4,4021.0,1:11,0,0,0,0.0,0:0,3000000
8477446,Michael,McCarron,1995-03-07,RW,R,2017-18,18,0,1,1,0.06,-1,15,0.0,32,9463.0,8:45,60,63,123,48.78,61,14,3,5,-2,0,0,0,93.0,0:5,0,0,0,3.0,0:0,863333
8477447,Shea,Theodore,1995-08-03,D,L,2017-18,61,6,23,29,0.48,5,144,4.17,14,74489.0,20:21,0,0,0,0.0,29,70,25,42,-17,1,8,9,9342.0,2:33,0,0,0,1692.0,0:27,863333
8477448,Marko,Dano,1994-11-30,C,L,2017-18,23,2,1,3,0.13,-2,22,9.09,6,9918.0,7:11,1,1,2,50.0,26,7,3,4,-1,0,0,0,221.0,0:9,0,0,0,77.0,0:3,850000
8477450,Jason,Dickinson,1995-07-04,C,L,2017-18,27,0,2,2,0.07,-2,16,0.0,17,13825.0,8:32,69,73,142,48.59,45,5,5,5,0,0,0,0,78.0,0:2,0,0,0,56.0,0:2,894167
8477451,Ryan,Hartman,1994-09-20,RW,R,2017-18,78,11,20,31,0.4,1,129,8.53,72,61131.0,13:3,93,110,203,45.81,113,38,26,20,6,1,1,2,3097.0,0:39,0,0,0,1425.0,0:18,863333
8477452,Ian,McCoshen,1995-08-05,D,L,2017-18,38,3,1,4,0.11,-10,26,11.54,25,34373.0,15:4,0,0,0,0.0,71,43,3,31,-28,0,0,0,45.0,0:1,0,0,0,2503.0,1:5,925000
8477453,Chris,Bigras,1995-02-22,D,L,2017-18,15,0,1,1,0.07,-2,8,0.0,2,12474.0,13:51,0,0,0,0.0,12,15,1,8,-7,0,0,0,327.0,0:21,0,0,0,1475.0,1:38,843333
8477454,Adam,Erne,1995-04-20,LW,L,2017-18,23,3,1,4,0.17,-1,29,10.34,11,13964.0,10:7,5,3,8,62.5,37,8,4,4,0,0,0,0,106.0,0:4,0,0,0,24.0,0:1,874167
8477455,Jacob,de la Rose,1995-05-20,LW,L,2017-18,55,4,8,12,0.22,-2,53,7.55,29,39090.0,11:50,206,262,468,44.02,127,36,20,19,1,0,0,0,59.0,0:1,1,0,1,3054.0,0:55,725000
8477456,J.T.,Compher,1995-04-08,LW,R,2017-18,69,13,10,23,0.33,-29,131,9.92,20,66239.0,15:59,273,332,605,45.12,45,65,16,13,3,4,3,7,9054.0,2:11,2,0,2,5803.0,1:24,925000
8477458,Valentin,Zykov,1995-05-15,LW,R,2017-18,10,3,4,7,0.7,4,18,16.67,2,8224.0,13:42,0,1,1,0.0,3,1,5,4,1,0,0,0,606.0,1:0,0,0,0,0.0,0:0,705000
8477460,Laurent,Dauphin,1995-03-27,C,L,2017-18,2,0,0,0,0.0,-1,1,0.0,2,867.0,7:13,5,4,9,55.56,1,2,0,0,0,0,0,0,0.0,0:0,0,0,0,0.0,0:0,745000
8477461,Remi,Elie,1995-04-16,LW,L,2017-18,72,6,8,14,0.19,4,70,8.57,18,44297.0,10:15,5,9,14,35.71,101,20,20,25,-5,0,0,0,237.0,0:3,0,0,0,960.0,0:13,728333
8477462,Robert,Hagg,1995-02-08,D,L,2017-18,70,3,6,9,0.13,5,89,3.37,32,76183.0,18:8,0,0,0,0.0,238,100,8,36,-28,0,0,0,333.0,0:4,0,0,0,6780.0,1:36,894167
8477463,Steven,Santini,1995-03-07,D,R,2017-18,36,2,8,10,0.28,0,56,3.57,21,43792.0,20:16,0,1,1,0.0,113,73,4,13,-9,0,0,0,65.0,0:1,0,1,1,6666.0,3:5,925000
8477464,Nic,Petan,1995-03-22,LW,L,2017-18,15,2,0,2,0.13,0,16,12.5,6,7572.0,8:24,12,13,25,48.0,4,4,6,4,2,0,0,0,547.0,0:36,0,0,0,0.0,0:0,758333
8477467,Gustav,Olofsson,1994-12-01,D,L,2017-18,41,0,8,8,0.2,0,22,0.0,14,31424.0,12:46,0,0,0,0.0,23,44,5,12,-7,0,0,0,156.0,0:3,0,0,0,665.0,0:16,725000
8477471,Dillon,Heatherington,1995-05-09,D,L,2017-18,6,0,1,1,0.17,3,6,0.0,26,3906.0,10:51,0,0,0,0.0,7,2,0,1,-1,0,0,0,0.0,0:0,0,0,0,207.0,0:34,770833
8477472,Carl,Dahlstrom,1995-01-28,D,L,2017-18,11,0,3,3,0.27,-2,12,0.0,0,11559.0,17:30,1,0,1,100.0,6,9,2,7,-5,0,0,0,14.0,0:1,0,0,0,948.0,1:26,750833
8477473,Justin,Bailey,1995-07-01,RW,R,2017-18,12,3,1,4,0.33,-2,19,15.79,2,8120.0,11:16,0,2,2,0.0,19,9,4,2,2,0,0,0,45.0,0:3,0,0,0,547.0,0:45,670000
8477474,Madison,Bowey,1995-04-22,D,R,2017-18,51,0,12,12,0.24,-3,47,0.0,24,41963.0,13:42,0,0,0,0.0,48,42,11,38,-27,0,0,0,56.0,0:1,0,0,0,876.0,0:17,703333
8477476,Artturi,Lehkonen,1995-07-04,LW,L,2017-18,66,12,9,21,0.32,-11,164,7.32,20,65288.0,16:29,11,19,30,36.67,71,23,27,19,8,3,1,4,7666.0,1:56,1,0,1,6067.0,1:31,839166
8477478,William,Carrier,1994-12-20,LW,L,2017-18,37,1,2,3,0.08,-3,52,1.92,19,19627.0,8:50,0,0,0,0.0,113,10,15,6,9,0,0,0,230.0,0:6,0,0,0,39.0,0:1,689167
8477479,Tyler,Bertuzzi,1995-02-24,LW,L,2017-18,48,7,17,24,0.5,-7,83,8.43,39,41472.0,14:24,1,7,8,12.5,53,38,13,14,-1,1,1,2,4105.0,1:25,0,0,0,313.0,0:6,661667
8477488,Brett,Pesce,1994-11-15,D,R,2017-18,65,3,16,19,0.29,-6,88,3.41,18,81526.0,20:54,0,1,1,0.0,57,101,38,24,14,0,0,0,1110.0,0:17,0,0,0,9175.0,2:21,809167
8477491,Nicholas,Baptiste,1995-08-04,RW,R,2017-18,33,4,2,6,0.18,-4,45,8.89,14,19734.0,9:58,2,7,9,22.22,16,3,4,8,-4,0,1,1,1608.0,0:48,0,0,0,350.0,0:10,718333
8477492,Nathan,MacKinnon,1995-09-01,C,R,2017-18,74,39,58,97,1.31,11,284,13.73,55,88379.0,19:54,485,672,1157,41.92,38,22,36,41,-5,12,20,32,16020.0,3:36,0,1,1,1359.0,0:18,6300000
8477493,Aleksander,Barkov,1995-09-02,C,L,2017-18,79,27,51,78,0.99,9,256,10.55,14,104612.0,22:4,908,789,1697,53.51,30,67,82,63,19,5,12,17,16030.0,3:22,5,0,5,8310.0,1:45,5900000
8477494,Jonathan,Drouin,1995-03-28,LW,L,2017-18,77,13,33,46,0.6,-28,164,7.93,30,81309.0,17:35,447,604,1051,42.53,55,27,56,58,-2,4,18,22,15129.0,3:16,0,0,0,508.0,0:6,5500000
8477495,Seth,Jones,1994-10-03,D,R,2017-18,78,16,41,57,0.73,10,249,6.43,30,115137.0,24:36,0,0,0,0.0,92,124,67,55,12,7,17,24,12643.0,2:42,0,0,0,8502.0,1:49,5400000
8477496,Elias,Lindholm,1994-12-02,C,R,2017-18,81,16,28,44,0.54,-8,153,10.46,18,86959.0,17:53,432,361,793,54.48,98,41,48,34,14,6,3,9,12736.0,2:37,0,1,1,6529.0,1:20,2700000
8477497,Sean,Monahan,1994-10-12,C,L,2017-18,74,31,33,64,0.86,3,202,15.35,24,82948.0,18:40,709,698,1407,50.39,35,17,51,42,9,9,10,19,16109.0,3:37,0,0,0,1230.0,0:16,6375000
8477498,Darnell,Nurse,1995-02-04,D,L,2017-18,82,6,20,26,0.32,15,194,3.09,67,109469.0,22:14,0,0,0,0.0,161,153,28,72,-44,0,0,0,2365.0,0:28,0,0,0,10970.0,2:13,863333
8477499,Rasmus,Ristolainen,1994-10-27,D,R,2017-18,73,6,35,41,0.56,-25,182,3.3,48,116067.0,26:29,0,0,0,0.0,206,111,12,47,-35,1,22,23,16134.0,3:41,0,0,0,12106.0,2:45,5400000
8477500,Bo,Horvat,1995-04-05,C,L,2017-18,64,22,22,44,0.69,-1,158,13.92,10,74301.0,19:20,712,612,1324,53.78,35,29,22,25,-3,10,3,13,10337.0,2:41,1,0,1,6075.0,1:34,5500000
8477502,Samuel,Morin,1995-07-12,D,L,2017-18,2,0,0,0,0.0,1,1,0.0,4,1897.0,15:48,0,0,0,0.0,7,1,1,1,0,0,0,0,0.0,0:0,0,0,0,292.0,2:26,863333
8477503,Max,Domi,1995-03-02,LW,L,2017-18,82,9,36,45,0.55,-8,150,6.0,73,82158.0,16:41,185,227,412,44.9,49,28,40,62,-22,1,8,9,12800.0,2:36,0,0,0,242.0,0:2,863333
8477504,Josh,Morrissey,1995-03-28,D,L,2017-18,81,7,19,26,0.32,15,102,6.86,47,99403.0,20:27,1,1,2,50.0,139,168,22,48,-26,0,1,1,1591.0,0:19,0,0,0,11783.0,2:25,863333
8477505,Alexander,Wennberg,1994-09-22,C,L,2017-18,66,8,27,35,0.53,22,74,10.81,12,71800.0,18:7,350,424,774,45.22,28,46,36,15,21,3,2,5,10178.0,2:34,0,1,1,4037.0,1:1,4900000
8477506,Ryan,Pulock,1994-10-06,D,R,2017-18,68,10,22,32,0.47,-4,184,5.43,14,75096.0,18:24,0,0,0,0.0,113,86,25,35,-10,5,6,11,6812.0,1:40,0,0,0,446.0,0:6,863333
8477507,Nikita,Zadorov,1995-04-16,D,L,2017-18,77,7,13,20,0.26,4,94,7.45,103,89929.0,19:27,0,0,0,0.0,278,106,13,36,-23,0,1,1,659.0,0:8,0,0,0,9576.0,2:4,2150000
8477508,Curtis,Lazar,1995-02-02,C,R,2017-18,65,2,10,12,0.18,-8,65,3.08,23,38443.0,9:51,48,73,121,39.67,130,26,9,18,-9,0,0,0,298.0,0:4,0,0,0,1679.0,0:25,950000
8477509,Mirco,Mueller,1995-03-21,D,L,2017-18,28,0,4,4,0.14,1,19,0.0,4,28015.0,16:40,0,0,0,0.0,15,42,13,11,2,0,0,0,197.0,0:7,0,2,2,3436.0,2:2,850000
8477510,Kerby,Rychel,1994-10-07,LW,L,2017-18,4,1,1,2,0.5,-2,7,14.29,2,2647.0,11:1,2,2,4,50.0,13,2,1,1,0,0,0,0,183.0,0:45,0,0,0,0.0,0:0,863333
8477511,Anthony,Mantha,1994-09-16,RW,L,2017-18,80,24,24,48,0.6,-1,190,12.63,52,83010.0,17:17,17,35,52,32.69,91,36,36,67,-31,9,3,12,10636.0,2:12,0,0,0,93.0,0:1,863333
8477512,Frederik,Gauthier,1995-04-26,C,L,2017-18,9,1,0,1,0.11,-4,12,8.33,0,4721.0,8:44,27,28,55,49.09,12,5,3,5,-2,0,0,0,28.0,0:3,0,0,0,710.0,1:18,863333
8477520,Jean-Sebastien,Dea,1994-02-08,C,R,2017-18,5,1,0,1,0.2,1,1,100.0,2,1647.0,5:29,10,11,21,47.62,9,1,0,1,-1,0,0,0,0.0,0:0,0,0,0,0.0,0:0,-111
8477527,Ross,Johnston,1994-02-18,LW,L,2017-18,24,3,3,6,0.25,0,19,15.79,62,13442.0,9:20,1,4,5,20.0,46,11,7,2,5,0,0,0,50.0,0:2,0,0,0,30.0,0:1,666667
8477529,Colby,Cave,1994-12-26,C,L,2017-18,3,0,0,0,0.0,0,2,0.0,2,2062.0,11:27,10,14,24,41.67,3,2,1,0,1,0,0,0,0.0,0:0,0,0,0,207.0,1:9,655000
8477541,Dakota,Mermis,1994-01-05,D,L,2017-18,9,0,0,0,0.0,-2,7,0.0,0,5932.0,10:59,0,0,0,0.0,5,6,0,1,-1,0,0,0,55.0,0:6,0,0,0,3.0,0:0,626667
8477573,Nathan,Walker,1994-02-07,LW,L,2017-18,9,1,0,1,0.11,0,6,16.67,6,5101.0,9:26,0,0,0,0.0,18,1,0,1,-1,0,0,0,74.0,0:8,0,0,0,172.0,0:19,650000
8477591,Josh,Jooris,1990-07-14,RW,R,2017-18,40,3,3,6,0.15,-7,50,6.0,16,23437.0,9:45,75,88,163,46.01,51,11,12,3,9,0,0,0,211.0,0:5,0,0,0,2182.0,0:54,775000
8477634,Trevor,Murphy,1995-07-17,D,L,2017-18,8,1,2,3,0.38,5,5,20.0,0,6833.0,14:14,0,0,0,0.0,6,9,3,3,0,0,0,0,368.0,0:46,0,0,0,30.0,0:3,640000
8477642,Rinat,Valiev,1995-05-11,D,L,2017-18,2,0,0,0,0.0,0,2,0.0,2,1417.0,11:48,0,0,0,0.0,0,2,1,1,0,0,0,0,102.0,0:51,0,0,0,18.0,0:9,778333
8477810,Joel,Hanley,1991-06-08,D,L,2017-18,5,0,0,0,0.0,0,2,0.0,0,3339.0,11:7,0,0,0,0.0,1,4,0,0,0,0,0,0,17.0,0:3,0,0,0,12.0,0:2,725000
8477839,Conor,Sheary,1992-06-08,LW,L,2017-18,79,18,12,30,0.38,2,142,12.68,10,66110.0,13:56,4,7,11,36.36,29,31,36,37,-1,2,1,3,5629.0,1:11,0,0,0,69.0,0:0,3000000
8477845,Trevor,van Riemsdyk,1991-07-24,D,R,2017-18,79,3,13,16,0.2,9,111,2.7,20,80818.0,17:3,0,0,0,0.0,25,113,45,19,26,0,0,0,944.0,0:11,0,0,0,6263.0,1:19,825000
8477846,Ryan,Carpenter,1991-01-18,C,R,2017-18,52,9,6,15,0.29,1,85,10.59,11,39310.0,12:35,200,198,398,50.25,76,17,17,17,0,0,0,0,1143.0,0:21,1,0,1,4202.0,1:20,650000
8477850,Christian,Folin,1991-02-09,D,R,2017-18,65,3,10,13,0.2,1,58,5.17,30,61063.0,15:39,0,0,0,0.0,167,106,8,34,-26,0,0,0,210.0,0:3,0,1,1,4203.0,1:4,850000
8477851,Jordan,Oesterle,1992-06-25,D,L,2017-18,55,5,10,15,0.27,-11,99,5.05,8,67701.0,20:30,0,0,0,0.0,62,97,15,46,-31,1,2,3,3532.0,1:4,0,0,0,2233.0,0:40,650000
8477901,Daniel,Carr,1991-11-01,LW,L,2017-18,38,6,10,16,0.42,2,52,11.54,8,27665.0,12:8,3,14,17,17.65,30,16,12,12,0,2,1,3,2551.0,1:7,0,0,0,5.0,0:0,725000
8477903,Garnet,Hathaway,1991-11-23,RW,R,2017-18,59,4,9,13,0.22,3,68,5.88,88,40826.0,11:31,1,9,10,10.0,154,32,17,17,0,0,0,0,139.0,0:2,1,0,1,3907.0,1:6,650000
8477919,Frederick,Gaudreau,1993-05-01,C,R,2017-18,20,0,3,3,0.15,0,14,0.0,2,10993.0,9:9,69,70,139,49.64,8,8,5,2,3,0,0,0,10.0,0:0,0,0,0,137.0,0:6,666666
8477922,Melker,Karlsson,1990-07-18,C,R,2017-18,71,8,11,19,0.27,-5,76,10.53,26,56439.0,13:14,12,6,18,66.67,81,69,24,22,2,0,0,0,182.0,0:2,1,0,1,5939.0,1:23,2000000
8477929,Dennis,Rasmussen,1990-07-03,C,L,2017-18,27,1,3,4,0.15,4,19,5.26,8,14431.0,8:54,34,36,70,48.57,31,15,9,4,5,0,0,0,81.0,0:3,0,0,0,1782.0,1:6,725000
8477930,Pierre-Edouard,Bellemare,1985-03-06,LW,L,2017-18,72,6,10,16,0.22,5,92,6.52,14,53254.0,12:19,355,339,694,51.15,41,63,49,25,24,0,0,0,537.0,0:7,0,0,0,9276.0,2:8,1450000
8477931,Tomas,Nosek,1992-09-01,LW,L,2017-18,67,7,8,15,0.22,6,92,7.61,14,44590.0,11:5,35,30,65,53.85,53,24,36,14,22,0,0,0,438.0,0:6,1,1,2,6090.0,1:30,612500
8477932,Aaron,Ekblad,1996-02-07,D,R,2017-18,82,16,22,38,0.46,9,189,8.47,71,115074.0,23:23,0,0,0,0.0,69,121,40,99,-59,5,6,11,10463.0,2:7,0,0,0,11029.0,2:14,7500000
8477933,Sam,Reinhart,1995-11-06,C,R,2017-18,82,25,25,50,0.61,-24,188,13.3,26,84139.0,17:6,56,86,142,39.44,48,42,29,29,0,12,9,21,16219.0,3:17,0,0,0,56.0,0:0,894167
8477934,Leon,Draisaitl,1995-10-27,C,L,2017-18,78,25,45,70,0.9,-7,194,12.89,30,90419.0,19:19,672,526,1198,56.09,40,24,78,84,-6,6,5,11,13255.0,2:49,3,1,4,4735.0,1:0,8500000
8477935,Sam,Bennett,1996-06-20,C,L,2017-18,82,11,15,26,0.32,-18,157,7.01,59,70850.0,14:24,119,100,219,54.34,140,34,54,32,22,1,2,3,6665.0,1:21,0,0,0,3477.0,0:42,1950000
8477936,Michael,Dal Colle,1996-06-20,LW,L,2017-18,4,0,0,0,0.0,0,1,0.0,0,3205.0,13:21,0,0,0,0.0,1,1,1,0,1,0,0,0,282.0,1:10,0,0,0,0.0,0:0,863333
8477937,Jake,Virtanen,1996-08-17,RW,R,2017-18,75,10,10,20,0.27,-11,130,7.69,46,53939.0,11:59,7,15,22,31.82,156,29,51,32,19,0,0,0,1281.0,0:17,0,0,0,55.0,0:0,894167
8477938,Haydn,Fleury,1996-07-08,D,L,2017-18,67,0,8,8,0.12,-2,86,0.0,14,67516.0,16:47,0,0,0,0.0,85,94,21,34,-13,0,0,0,369.0,0:5,0,0,0,3620.0,0:54,863333
8477939,William,Nylander,1996-05-01,C,R,2017-18,82,20,41,61,0.74,20,184,10.87,10,82107.0,16:41,334,316,650,51.38,21,18,68,54,14,5,7,12,9926.0,2:1,0,0,0,111.0,0:1,894167
8477940,Nikolaj,Ehlers,1996-02-14,LW,L,2017-18,82,29,31,60,0.73,14,231,12.55,26,79116.0,16:4,5,4,9,55.56,39,27,38,58,-20,7,6,13,10003.0,2:1,0,0,0,79.0,0:0,894167
8477941,Nick,Ritchie,1995-12-05,LW,L,2017-18,76,10,17,27,0.36,3,122,8.2,72,60110.0,13:10,6,11,17,35.29,221,27,10,22,-12,1,2,3,1969.0,0:25,0,0,0,1573.0,0:20,894167
8477942,Kevin,Fiala,1996-07-22,LW,L,2017-18,80,23,25,48,0.6,20,187,12.3,26,72709.0,15:8,0,5,5,0.0,34,27,42,56,-14,4,9,13,11031.0,2:17,0,0,0,18.0,0:0,863333
8477943,Brendan,Perlini,1996-04-27,LW,L,2017-18,74,17,13,30,0.41,-2,129,13.18,28,64432.0,14:30,5,6,11,45.45,83,34,16,22,-6,5,6,11,7870.0,1:46,0,0,0,87.0,0:1,863333
8477944,Jakub,Vrana,1996-02-28,LW,L,2017-18,73,13,14,27,0.37,2,133,9.77,12,54744.0,12:29,13,12,25,52.0,31,16,28,37,-9,1,2,3,2934.0,0:40,0,0,0,16.0,0:0,863333
8477945,Julius,Honka,1995-12-03,D,R,2017-18,42,1,3,4,0.1,-1,42,2.38,14,32783.0,13:0,0,0,0,0.0,20,28,2,18,-16,0,1,1,3241.0,1:17,0,0,0,137.0,0:3,863333
8477946,Dylan,Larkin,1996-07-30,C,L,2017-18,82,16,47,63,0.77,-9,232,6.9,61,97630.0,19:50,656,658,1314,49.92,76,42,56,81,-25,1,7,8,10655.0,2:9,2,1,3,9773.0,1:59,925000
8477947,Sonny,Milano,1996-05-12,LW,L,2017-18,55,14,8,22,0.4,-8,69,20.29,10,38444.0,11:38,0,0,0,0.0,28,11,14,18,-4,0,4,4,5511.0,1:40,0,0,0,0.0,0:0,863333
8477948,Travis,Sanheim,1996-03-29,D,L,2017-18,49,2,8,10,0.2,-6,72,2.78,20,45815.0,15:35,0,0,0,0.0,27,35,8,36,-28,0,0,0,834.0,0:17,0,0,0,1188.0,0:24,863333
8477949,Alex,Tuch,1996-05-10,RW,R,2017-18,78,15,22,37,0.47,3,171,8.77,27,71382.0,15:15,70,95,165,42.42,99,42,57,29,28,4,6,10,10916.0,2:19,0,0,0,210.0,0:2,925000
8477950,Tony,DeAngelo,1995-10-24,D,R,2017-18,32,0,8,8,0.25,-18,68,0.0,11,31794.0,16:33,1,0,1,100.0,31,42,6,29,-23,0,6,6,3702.0,1:55,0,0,0,271.0,0:8,-111
8477951,Nick,Schmaltz,1996-02-23,C,R,2017-18,78,21,31,52,0.67,1,118,17.8,18,85322.0,18:13,321,480,801,40.07,13,39,86,31,55,4,9,13,12494.0,2:40,0,2,2,6179.0,1:19,925000
8477953,Kasperi,Kapanen,1996-07-23,RW,R,2017-18,38,7,2,9,0.24,-1,55,12.73,4,25640.0,11:14,1,6,7,14.29,57,9,12,6,6,0,0,0,74.0,0:1,1,0,1,2462.0,1:4,863333
8477955,Jared,McCann,1996-05-31,C,L,2017-18,68,9,19,28,0.41,11,143,6.29,30,54081.0,13:15,212,338,550,38.55,43,32,39,28,11,1,0,1,2690.0,0:39,0,1,1,2252.0,0:33,894167
8477956,David,Pastrnak,1996-05-25,RW,R,2017-18,82,35,45,80,0.98,10,246,14.23,37,88392.0,17:57,5,20,25,20.0,55,31,50,76,-26,13,13,26,15184.0,3:5,0,0,0,70.0,0:0,6666667
8477957,Nikita,Scherbak,1995-12-30,RW,L,2017-18,26,4,2,6,0.23,-5,39,10.26,8,20869.0,13:22,2,0,2,100.0,18,15,13,9,4,1,2,3,2274.0,1:27,1,0,1,42.0,0:1,863333
8477958,Nikolay,Goldobin,1995-10-07,RW,L,2017-18,38,8,6,14,0.37,-14,50,16.0,6,28120.0,12:20,1,1,2,50.0,12,7,10,12,-2,2,0,2,2160.0,0:56,0,0,0,18.0,0:0,863333
8477959,Joshua,Ho-Sang,1996-01-22,RW,R,2017-18,22,2,10,12,0.55,-7,18,11.11,4,18849.0,14:16,2,3,5,40.0,3,1,10,23,-13,0,1,1,2980.0,2:15,0,0,0,0.0,0:0,863333
8477960,Adrian,Kempe,1996-09-13,LW,L,2017-18,81,16,21,37,0.46,11,119,13.45,49,64789.0,13:19,263,420,683,38.51,91,18,26,30,-4,1,4,5,5398.0,1:6,0,0,0,394.0,0:4,894167
8477961,John,Quenneville,1996-04-16,C,L,2017-18,2,0,0,0,0.0,-3,5,0.0,0,1595.0,13:17,0,1,1,0.0,4,0,0,1,-1,0,0,0,22.0,0:11,0,0,0,0.0,0:0,811667
8477962,Brendan,Lemieux,1996-03-15,LW,L,2017-18,9,1,0,1,0.11,2,6,16.67,21,4288.0,7:56,0,0,0,0.0,12,1,1,2,-1,0,0,0,280.0,0:31,0,0,0,0.0,0:0,839167
8477964,Ivan,Barbashev,1995-12-14,C,L,2017-18,53,7,6,13,0.25,-1,45,15.56,4,38788.0,12:11,61,98,159,38.36,70,25,21,12,9,0,0,0,580.0,0:10,0,0,0,579.0,0:10,741667
8477969,Marcus,Pettersson,1996-05-08,D,L,2017-18,22,1,3,4,0.18,5,16,6.25,6,17963.0,13:36,0,0,0,0.0,18,27,2,14,-12,0,1,1,998.0,0:45,0,0,0,766.0,0:34,794167
8477973,Vladislav,Kamenev,1996-08-12,C,L,2017-18,3,0,0,0,0.0,-2,1,0.0,0,1588.0,8:49,7,11,18,38.89,3,0,0,1,-1,0,0,0,5.0,0:1,0,0,0,0.0,0:0,833333
8477981,Roland,McKeown,1996-01-20,D,R,2017-18,10,0,3,3,0.3,3,7,0.0,19,8046.0,13:24,0,0,0,0.0,3,5,1,3,-2,0,0,0,0.0,0:0,0,0,0,10.0,0:1,745000
8477986,Brandon,Montour,1994-04-11,D,R,2017-18,80,9,23,32,0.4,16,160,5.62,42,98255.0,20:28,0,0,0,0.0,96,83,20,51,-31,5,7,12,10795.0,2:14,1,1,2,5788.0,1:12,925000
8477987,Ryan,Donato,1996-04-09,C,L,2017-18,12,5,4,9,0.75,2,24,20.83,2,10581.0,14:41,12,4,16,75.0,6,2,3,3,0,2,2,4,1770.0,2:27,0,0,0,0.0,0:0,900000
8477989,Christian,Dvorak,1996-02-02,C,L,2017-18,78,15,22,37,0.47,-19,151,9.93,22,76909.0,16:26,585,554,1139,51.36,92,48,20,25,-5,2,5,7,8485.0,1:48,0,0,0,6039.0,1:17,839167
8477994,Dominic,Turgeon,1996-02-25,C,L,2017-18,5,0,0,0,0.0,-2,3,0.0,2,2770.0,9:14,7,14,21,33.33,3,8,3,2,1,0,0,0,14.0,0:2,0,0,0,570.0,1:54,686667
8477998,Warren,Foegele,1996-04-01,LW,L,2017-18,2,2,1,3,1.5,3,6,33.33,0,1431.0,11:55,0,0,0,0.0,5,1,1,0,1,0,0,0,0.0,0:0,0,0,0,246.0,2:3,746667
8478004,Brett,Lernout,1995-09-24,D,R,2017-18,18,0,1,1,0.06,-5,14,0.0,6,18063.0,16:43,0,0,0,0.0,56,18,4,11,-7,0,0,0,12.0,0:0,0,1,1,1328.0,1:13,653333
8478010,Brayden,Point,1996-03-13,C,R,2017-18,82,32,34,66,0.8,18,217,14.75,24,96529.0,19:37,557,617,1174,47.44,26,57,56,23,33,5,6,11,11336.0,2:18,3,2,5,9880.0,2:0,686667
8478020,Michael,Amadio,1996-05-13,C,R,2017-18,37,4,4,8,0.22,-2,28,14.29,8,20671.0,9:18,74,96,170,43.53,18,9,11,6,5,1,2,3,1786.0,0:48,0,0,0,46.0,0:1,717500
8478027,Lucas,Wallmark,1995-09-05,C,L,2017-18,11,1,0,1,0.09,-4,16,6.25,2,6266.0,9:29,38,31,69,55.07,13,1,4,4,0,0,0,0,61.0,0:5,0,0,0,190.0,0:17,683333
8478042,Viktor,Arvidsson,1993-04-08,LW,R,2017-18,78,29,32,61,0.78,20,247,11.74,36,83062.0,17:44,11,22,33,33.33,30,52,31,35,-4,3,5,8,11743.0,2:30,3,0,3,6241.0,1:20,4250000
8478046,Danton,Heinen,1995-07-05,C,L,2017-18,77,16,31,47,0.61,10,135,11.85,16,69402.0,15:1,10,13,23,43.48,45,33,42,26,16,2,10,12,9273.0,2:0,1,0,1,1341.0,0:17,872500
8478055,Gustav,Forsling,1996-06-12,D,L,2017-18,41,3,10,13,0.32,-2,82,3.66,8,47124.0,19:9,0,1,1,0.0,26,56,18,38,-20,1,3,4,2879.0,1:10,0,1,1,6183.0,2:30,872500
8478063,Shane,Gersich,1996-07-10,LW,L,2017-18,3,0,1,1,0.33,-1,4,0.0,0,1623.0,9:1,0,0,0,0.0,0,2,3,0,3,0,0,0,0.0,0:0,0,0,0,0.0,0:0,925000
8478067,Oskar,Lindblom,1996-08-15,LW,L,2017-18,23,2,4,6,0.26,4,36,5.56,8,20128.0,14:35,0,0,0,0.0,27,13,4,5,-1,0,1,1,2048.0,1:29,0,0,0,0.0,0:0,925000
8478073,Anton,Lindholm,1994-11-29,D,L,2017-18,48,0,4,4,0.08,4,22,0.0,14,37927.0,13:10,0,0,0,0.0,99,51,8,9,-1,0,0,0,53.0,0:1,0,0,0,4606.0,1:35,717500
8478075,Anders,Bjork,1996-08-05,LW,L,2017-18,30,4,8,12,0.4,2,30,13.33,6,22225.0,12:20,1,1,2,50.0,19,11,16,11,5,2,1,3,1772.0,0:59,0,0,0,9.0,0:0,925000
8478099,Kevin,Labanc,1995-12-12,RW,R,2017-18,77,11,28,39,0.51,-6,156,7.05,32,66303.0,14:21,5,11,16,31.25,31,23,28,29,-1,4,12,16,10313.0,2:13,0,0,0,105.0,0:1,717500
8478104,Sammy,Blais,1996-06-17,LW,L,2017-18,11,1,2,3,0.27,1,9,11.11,6,7110.0,10:46,0,0,0,0.0,15,2,1,5,-4,1,0,1,888.0,1:20,0,0,0,0.0,0:0,673333
8478106,Dylan,Sikura,1995-06-01,RW,L,2017-18,5,0,3,3,0.6,2,9,0.0,0,4020.0,13:24,0,1,1,0.0,0,2,3,0,3,0,0,0,240.0,0:48,0,0,0,0.0,0:0,925000
8478131,Ondrej,Kase,1995-11-08,RW,R,2017-18,66,20,18,38,0.58,18,146,13.7,14,55133.0,13:55,5,21,26,19.23,28,26,29,31,-2,1,2,3,5179.0,1:18,0,0,0,51.0,0:0,670000
8478146,Matthew,Highmore,1996-02-27,C,L,2017-18,13,2,0,2,0.15,-4,27,7.41,0,9479.0,12:9,1,4,5,20.0,9,7,1,4,-3,0,0,0,18.0,0:1,0,0,0,715.0,0:55,775833
8478176,Joe,Hicketts,1996-05-04,D,L,2017-18,5,0,3,3,0.6,5,2,0.0,2,5204.0,17:20,0,0,0,0.0,9,12,1,5,-4,0,1,1,714.0,2:22,0,0,0,473.0,1:34,636111
8478211,Dryden,Hunt,1995-11-24,LW,L,2017-18,11,0,1,1,0.09,-5,12,0.0,2,6971.0,10:33,1,3,4,25.0,22,4,3,4,-1,0,0,0,50.0,0:4,0,0,0,6.0,0:0,809167
8478233,Andrew,Mangiapane,1996-04-04,LW,L,2017-18,10,0,0,0,0.0,-3,7,0.0,2,5358.0,8:55,1,0,1,100.0,9,4,2,3,-1,0,0,0,15.0,0:1,0,0,0,0.0,0:0,705000
8478365,Danick,Martel,1994-12-12,LW,L,2017-18,4,0,0,0,0.0,-1,6,0.0,0,2452.0,10:13,0,0,0,0.0,2,9,1,0,1,0,0,0,0.0,0:0,0,0,0,0.0,0:0,680000
8478366,Frank,Vatrano,1994-03-14,C,L,2017-18,41,7,3,10,0.24,3,72,9.72,34,26664.0,10:50,10,9,19,52.63,51,15,11,12,-1,0,0,0,1737.0,0:42,0,0,0,0.0,0:0,792500
8478373,Nikita,Soshnikov,1993-10-14,RW,L,2017-18,15,1,1,2,0.13,-2,17,5.88,4,9916.0,11:1,0,1,1,0.0,24,2,3,2,1,0,0,0,113.0,0:7,0,0,0,565.0,0:37,736666
8478396,Noah,Hanifin,1997-01-25,D,L,2017-18,79,10,22,32,0.41,-20,165,6.06,21,89397.0,18:51,0,0,0,0.0,81,69,50,58,-8,1,6,7,8524.0,1:47,0,0,0,395.0,0:5,925000
8478397,Rasmus,Andersson,1996-10-27,D,R,2017-18,10,0,0,0,0.0,-1,8,0.0,4,9263.0,15:26,0,0,0,0.0,2,10,0,4,-4,0,0,0,937.0,1:33,0,0,0,166.0,0:16,755833
8478398,Kyle,Connor,1996-12-09,LW,L,2017-18,76,31,26,57,0.75,8,192,16.15,16,77096.0,16:54,2,5,7,28.57,18,26,39,34,5,7,4,11,12140.0,2:39,0,0,0,45.0,0:0,925000
8478400,Colin,White,1997-01-30,C,R,2017-18,21,2,4,6,0.29,1,24,8.33,8,16814.0,13:20,20,40,60,33.33,12,15,7,12,-5,0,0,0,829.0,0:39,0,0,0,49.0,0:2,925000
8478401,Pavel,Zacha,1997-04-06,C,L,2017-18,69,8,17,25,0.36,-3,112,7.14,30,59497.0,14:22,318,407,725,43.86,70,22,37,34,3,2,3,5,5410.0,1:18,1,0,1,4341.0,1:2,894167
8478402,Connor,McDavid,1997-01-13,C,L,2017-18,82,41,67,108,1.32,20,274,14.96,26,106034.0,21:33,376,533,909,41.36,28,46,111,67,44,5,15,20,14593.0,2:57,1,3,4,5356.0,1:5,925000
8478403,Jack,Eichel,1996-10-28,C,R,2017-18,67,25,39,64,0.96,-25,246,10.16,32,80976.0,20:8,347,489,836,41.51,52,35,38,61,-23,3,17,20,14975.0,3:43,0,2,2,3191.0,0:47,925000
8478407,Vince,Dunn,1996-10-29,D,L,2017-18,75,5,19,24,0.32,1,138,3.62,20,77539.0,17:13,1,0,1,100.0,29,59,29,38,-9,2,7,9,8976.0,1:59,0,0,0,361.0,0:4,722500
8478408,Travis,Dermott,1996-12-22,D,L,2017-18,37,1,12,13,0.35,16,54,1.85,8,35507.0,15:59,0,0,0,0.0,48,36,9,36,-27,0,0,0,199.0,0:5,0,0,0,857.0,0:23,863333
8478413,Jordan,Greenway,1997-02-16,LW,L,2017-18,6,0,1,1,0.17,0,4,0.0,0,4119.0,11:26,0,5,5,0.0,5,3,2,2,0,0,0,0,50.0,0:8,0,0,0,19.0,0:3,916666
8478414,Timo,Meier,1996-10-08,RW,L,2017-18,81,21,15,36,0.44,2,210,10.0,51,72257.0,14:52,71,75,146,48.63,105,48,48,40,8,3,1,4,6161.0,1:16,0,0,0,1090.0,0:13,894167
8478420,Mikko,Rantanen,1996-10-29,RW,L,2017-18,81,29,55,84,1.04,0,178,16.29,34,92159.0,18:57,60,57,117,51.28,32,40,45,30,15,12,23,35,18184.0,3:44,0,0,0,90.0,0:1,894167
8478421,A.J.,Greer,1996-12-14,LW,L,2017-18,17,0,3,3,0.18,2,13,0.0,29,7541.0,7:23,1,2,3,33.33,30,5,3,2,1,0,0,0,167.0,0:9,0,0,0,0.0,0:0,741666
8478425,Brendan,Guhle,1997-07-29,D,L,2017-18,18,0,5,5,0.28,-6,37,0.0,10,19554.0,18:6,0,0,0,0.0,10,8,1,9,-8,0,0,0,1001.0,0:55,0,0,0,450.0,0:25,697500
8478427,Sebastian,Aho,1997-07-26,RW,L,2017-18,78,29,36,65,0.83,4,200,14.5,24,83857.0,17:55,78,94,172,45.35,65,17,59,53,6,8,8,16,12520.0,2:40,0,0,0,168.0,0:2,925000
8478431,Evgeny,Svechnikov,1996-10-31,RW,L,2017-18,14,2,2,4,0.29,-2,15,13.33,8,7409.0,8:49,1,4,5,20.0,15,6,3,5,-2,0,0,0,0.0,0:0,0,0,0,0.0,0:0,863333
8478432,Christian,Fischer,1997-04-15,RW,R,2017-18,79,15,18,33,0.42,-17,154,9.74,14,65909.0,13:54,5,24,29,17.24,109,23,15,11,4,5,3,8,10236.0,2:9,0,0,0,101.0,0:1,821666
8478439,Travis,Konecny,1997-03-11,C,R,2017-18,81,24,23,47,0.58,17,177,13.56,46,72449.0,14:54,7,14,21,33.33,97,53,31,38,-7,1,2,3,6843.0,1:24,0,0,0,39.0,0:0,894167
8478440,Dylan,Strome,1997-03-07,C,L,2017-18,21,4,5,9,0.43,4,30,13.33,8,16313.0,12:56,92,122,214,42.99,7,12,12,2,10,1,0,1,1909.0,1:30,0,0,0,99.0,0:4,863333
8478443,Brandon,Carlo,1996-11-26,D,R,2017-18,76,0,6,6,0.08,10,76,0.0,45,87721.0,19:14,1,0,1,100.0,89,84,26,45,-19,0,0,0,221.0,0:2,0,1,1,12738.0,2:47,789167
8478444,Brock,Boeser,1997-02-25,RW,R,2017-18,62,29,26,55,0.89,-5,179,16.2,16,65072.0,17:29,10,29,39,25.64,29,24,26,28,-2,10,13,23,10876.0,2:55,0,0,0,146.0,0:2,925000
8478445,Mathew,Barzal,1997-05-26,C,R,2017-18,82,22,63,85,1.04,1,170,12.94,30,87407.0,17:45,355,479,834,42.57,21,31,65,88,-23,5,22,27,15582.0,3:10,0,0,0,163.0,0:1,863333
8478451,Ethan,Bear,1997-06-26,D,R,2017-18,18,1,3,4,0.22,-11,20,5.0,10,20123.0,18:37,0,0,0,0.0,14,28,5,18,-13,1,1,2,1974.0,1:49,0,0,0,211.0,0:11,720000
8478454,Noah,Juulsen,1997-04-02,D,R,2017-18,23,1,2,3,0.13,1,33,3.03,4,26804.0,19:25,0,0,0,0.0,58,34,6,22,-16,0,0,0,498.0,0:21,0,0,0,3240.0,2:20,863333
8478458,Jack,Roslovic,1997-01-29,C,R,2017-18,31,5,9,14,0.45,5,38,13.16,2,22919.0,12:19,18,21,39,46.15,20,9,14,12,2,0,0,0,2166.0,1:9,0,0,0,0.0,0:0,894166
8478460,Zach,Werenski,1997-07-19,D,L,2017-18,77,16,21,37,0.48,8,207,7.73,16,104301.0,22:34,0,0,0,0.0,58,92,32,42,-10,3,7,10,11223.0,2:25,0,0,0,3519.0,0:45,925000
8478462,Nicolas,Roy,1997-02-05,C,R,2017-18,1,0,0,0,0.0,-1,1,0.0,0,646.0,10:46,6,4,10,60.0,2,0,1,0,1,0,0,0,0.0,0:0,0,0,0,0.0,0:0,720000
8478463,Anthony,Beauvillier,1997-06-08,C,L,2017-18,71,21,15,36,0.51,2,132,15.91,16,61884.0,14:31,72,94,166,43.37,80,29,26,20,6,3,5,8,4024.0,0:56,0,0,0,3203.0,0:45,894167
8478466,Daniel,Sprong,1997-03-17,RW,R,2017-18,8,2,1,3,0.38,2,22,9.09,0,6710.0,13:58,0,0,0,0.0,9,4,0,2,-2,0,0,0,571.0,1:11,0,0,0,8.0,0:1,692500
8478469,Thomas,Chabot,1997-01-30,D,L,2017-18,63,9,16,25,0.4,-12,94,9.57,14,66191.0,17:30,0,0,0,0.0,44,64,27,36,-9,0,8,8,7093.0,1:52,0,0,0,573.0,0:9,863333
8478474,Lawson,Crouse,1997-06-23,LW,L,2017-18,11,1,0,1,0.09,-6,13,7.69,7,7220.0,10:56,3,8,11,27.27,29,6,2,3,-1,0,0,0,32.0,0:2,0,0,0,217.0,0:19,894167
8478483,Mitchell,Marner,1997-05-05,C,R,2017-18,82,22,47,69,0.84,-1,194,11.34,26,80629.0,16:23,50,45,95,52.63,31,25,85,50,35,8,19,27,10799.0,2:11,0,0,0,209.0,0:2,894167
8478488,Filip,Chlapik,1997-06-03,C,L,2017-18,20,1,3,4,0.2,-5,21,4.76,4,12087.0,10:4,50,60,110,45.45,19,14,9,5,4,0,1,1,731.0,0:36,0,0,0,8.0,0:0,728333
8478493,Joel,Eriksson Ek,1997-01-29,C,L,2017-18,75,6,10,16,0.21,2,124,4.84,22,57503.0,12:46,201,271,472,42.58,134,46,17,10,7,0,0,0,500.0,0:6,0,0,0,4886.0,1:5,894166
8478498,Jake,DeBrusk,1996-10-17,LW,L,2017-18,70,16,27,43,0.61,13,143,11.19,19,60359.0,14:22,13,17,30,43.33,70,26,31,21,10,2,7,9,7579.0,1:48,0,0,0,415.0,0:5,863333
8478500,Ivan,Provorov,1997-01-13,D,L,2017-18,82,17,24,41,0.5,17,203,8.37,20,118832.0,24:9,0,0,0,0.0,148,169,26,92,-66,2,3,5,8713.0,1:46,0,0,0,12698.0,2:34,894167
8478506,Gabriel,Carlsson,1997-01-02,D,L,2017-18,14,0,2,2,0.14,0,18,0.0,4,9517.0,11:19,0,0,0,0.0,10,10,2,4,-2,0,0,0,8.0,0:0,0,0,0,202.0,0:14,894166
8478512,Austin,Czarnik,1992-12-12,C,R,2017-18,10,0,4,4,0.4,-1,7,0.0,0,6547.0,10:54,14,14,28,50.0,4,0,2,2,0,0,1,1,301.0,0:30,0,0,0,316.0,0:31,675000
8478519,Anthony,Cirelli,1997-07-15,C,L,2017-18,18,5,6,11,0.61,11,26,19.23,6,14290.0,13:13,96,118,214,44.86,17,6,8,4,4,0,0,0,12.0,0:0,0,1,1,1551.0,1:26,728333
8478528,Tanner,Kero,1992-07-24,C,L,2017-18,8,1,2,3,0.38,1,7,14.29,0,5490.0,11:26,35,41,76,46.05,3,7,3,5,-2,0,0,0,23.0,0:2,0,0,0,1080.0,2:15,750000
8478541,Markus,Hannikainen,1993-03-26,LW,L,2017-18,33,3,3,6,0.18,-1,31,9.68,6,16577.0,8:22,3,1,4,75.0,31,15,10,4,6,0,0,0,90.0,0:2,0,1,1,975.0,0:29,675000
8478542,Evan,Rodrigues,1993-07-28,LW,R,2017-18,48,7,18,25,0.52,-10,91,7.69,14,40116.0,13:55,156,212,368,42.39,19,23,20,12,8,1,5,6,6007.0,2:5,0,0,0,772.0,0:16,650000
8478550,Artemi,Panarin,1991-10-30,LW,R,2017-18,81,27,55,82,1.01,23,228,11.84,26,97835.0,20:7,0,7,7,0.0,15,19,70,51,19,7,14,21,14316.0,2:56,0,0,0,107.0,0:1,6000000
8478561,Andreas,Martinsen,1990-06-13,LW,L,2017-18,9,1,0,1,0.11,-1,14,7.14,17,6826.0,12:38,0,0,0,0.0,35,4,2,3,-1,0,0,0,3.0,0:0,0,0,0,232.0,0:25,675000
8478567,Dean,Kukan,1993-07-08,D,L,2017-18,11,0,4,4,0.36,2,12,0.0,2,8159.0,12:21,0,0,0,0.0,2,10,0,3,-3,0,0,0,59.0,0:5,0,0,0,153.0,0:13,700000
8478569,Noel,Acciari,1991-12-01,C,R,2017-18,60,10,1,11,0.18,-6,66,15.15,9,46487.0,12:54,42,51,93,45.16,152,41,20,9,11,0,0,0,287.0,0:4,1,0,1,4928.0,1:22,725000
8478585,Derek,Ryan,1986-12-29,C,R,2017-18,80,15,23,38,0.48,-15,135,11.11,28,74909.0,15:36,531,409,940,56.49,52,27,54,48,6,3,4,7,9700.0,2:1,0,0,0,1776.0,0:22,1425000
8478842,Andrei,Mironov,1994-07-29,D,L,2017-18,10,1,2,3,0.3,2,3,33.33,12,6628.0,11:2,0,0,0,0.0,19,16,1,3,-2,0,0,0,0.0,0:0,0,0,0,850.0,1:25,925000
8478843,Denis,Malgin,1997-01-18,C,R,2017-18,51,11,11,22,0.43,4,79,13.92,6,42390.0,13:51,52,70,122,42.62,48,24,31,21,10,1,5,6,3770.0,1:13,0,0,0,24.0,0:0,690000
8478846,Christian,Wolanin,1995-03-17,D,L,2017-18,10,1,2,3,0.3,-4,14,7.14,0,8788.0,14:38,0,0,0,0.0,5,5,3,5,-2,0,0,0,842.0,1:24,0,0,0,46.0,0:4,925000
8478866,Dominik,Simon,1994-08-08,C,L,2017-18,33,4,8,12,0.36,2,36,11.11,16,22616.0,11:25,6,8,14,42.86,37,18,10,13,-3,0,0,0,1028.0,0:31,0,0,0,8.0,0:0,692500
8478873,Troy,Terry,1997-09-10,RW,R,2017-18,2,0,0,0,0.0,0,3,0.0,0,1225.0,10:12,0,0,0,0.0,0,2,0,0,0,0,0,0,18.0,0:9,0,0,0,0.0,0:0,925000
8478874,Adam,Gaudette,1996-10-03,C,R,2017-18,5,0,0,0,0.0,2,9,0.0,0,3836.0,12:47,6,10,16,37.5,2,3,1,4,-3,0,0,0,224.0,0:44,0,0,0,0.0,0:0,916667
8478906,Markus,Nutivaara,1994-06-06,D,L,2017-18,61,7,16,23,0.38,13,79,8.86,14,58664.0,16:1,0,0,0,0.0,42,40,9,19,-10,1,1,2,2043.0,0:33,0,0,0,171.0,0:2,817500
8478915,Sami,Niku,1996-10-10,D,L,2017-18,1,1,0,1,1.0,0,2,50.0,0,913.0,15:13,0,0,0,0.0,0,3,1,0,1,0,0,0,0.0,0:0,0,0,0,0.0,0:0,775000
8479066,Ryan,Lomberg,1994-12-09,LW,L,2017-18,7,0,1,1,0.14,0,5,0.0,15,2625.0,6:15,0,2,2,0.0,11,1,0,1,-1,0,0,0,7.0,0:1,0,0,0,0.0,0:0,710000
8479206,Tanner,Fritz,1991-08-20,C,R,2017-18,34,3,4,7,0.21,-3,27,11.11,8,25544.0,12:31,47,61,108,43.52,59,26,4,8,-4,0,0,0,1066.0,0:31,0,0,0,605.0,0:17,650000
8479250,Nick,Lappin,1992-11-01,RW,R,2017-18,6,1,0,1,0.17,2,7,14.29,4,3514.0,9:45,0,0,0,0.0,8,2,1,2,-1,0,0,0,18.0,0:3,0,0,0,0.0,0:0,842500
8479268,Casey,Nelson,1992-07-18,D,R,2017-18,37,3,5,8,0.22,-14,48,6.25,8,41692.0,18:46,0,0,0,0.0,31,37,8,23,-15,0,0,0,797.0,0:21,1,1,2,2249.0,1:0,650000
8479290,Kalle,Kossila,1993-04-14,C,L,2017-18,10,1,1,2,0.2,-4,9,11.11,0,5451.0,9:5,26,27,53,49.06,7,4,4,3,1,0,0,0,102.0,0:10,0,0,0,7.0,0:0,925000
8479291,Kevin,Rooney,1993-05-21,C,L,2017-18,1,0,0,0,0.0,0,3,0.0,0,706.0,11:46,1,2,3,33.33,2,0,1,0,1,0,0,0,19.0,0:19,0,0,0,14.0,0:14,650000
8479293,Brandon,Tanev,1991-12-31,LW,L,2017-18,61,8,10,18,0.3,13,79,10.13,18,46340.0,12:39,3,8,11,27.27,188,56,20,14,6,0,0,0,297.0,0:4,3,0,3,7172.0,1:57,700000
8479304,Kyle,Criscuolo,1992-05-05,C,R,2017-18,9,0,0,0,0.0,-4,5,0.0,4,4328.0,8:0,19,22,41,46.34,13,3,3,2,1,0,0,0,16.0,0:1,0,0,0,194.0,0:21,650000
8479314,Matthew,Tkachuk,1997-12-11,LW,L,2017-18,68,24,25,49,0.72,-1,188,12.77,61,70383.0,17:15,7,10,17,41.18,80,16,32,34,-2,10,7,17,12156.0,2:58,0,0,0,23.0,0:0,925000
8479316,Luke,Kunin,1997-12-04,C,R,2017-18,19,2,2,4,0.21,-3,32,6.25,13,14795.0,12:58,24,30,54,44.44,34,8,2,4,-2,0,0,0,59.0,0:3,1,0,1,1060.0,0:55,925000
8479318,Auston,Matthews,1997-09-17,C,L,2017-18,62,34,29,63,1.02,25,187,18.18,12,67437.0,18:7,375,313,688,54.51,16,61,59,59,0,5,8,13,7984.0,2:8,0,0,0,93.0,0:1,925000
8479325,Charlie,McAvoy,1997-12-21,D,R,2017-18,63,7,25,32,0.51,20,77,9.09,53,83717.0,22:8,0,0,0,0.0,133,80,22,44,-22,2,5,7,7514.0,1:59,0,0,0,3029.0,0:48,916667
8479337,Alex,DeBrincat,1997-12-18,RW,R,2017-18,82,28,24,52,0.63,6,181,15.47,6,72826.0,14:48,25,34,59,42.37,40,25,33,25,8,6,6,12,10027.0,2:2,0,0,0,713.0,0:8,778333
8479339,Patrik,Laine,1998-04-19,RW,R,2017-18,82,44,26,70,0.85,8,241,18.26,24,81085.0,16:28,11,32,43,25.58,74,43,29,51,-22,20,11,31,14793.0,3:0,0,0,0,6.0,0:0,925000
8479343,Clayton,Keller,1998-07-29,C,L,2017-18,82,23,42,65,0.79,-7,212,10.85,24,88986.0,18:5,37,41,78,47.44,7,28,42,50,-8,6,14,20,14827.0,3:0,0,1,1,660.0,0:8,885833
8479344,Jesse,Puljujarvi,1998-05-07,RW,R,2017-18,65,12,8,20,0.31,-1,136,8.82,14,52134.0,13:22,0,3,3,0.0,67,23,27,40,-13,2,0,2,2899.0,0:44,0,0,0,24.0,0:0,925000
8479345,Jakob,Chychrun,1998-03-31,D,L,2017-18,50,4,10,14,0.28,2,102,3.92,16,60750.0,20:15,0,0,0,0.0,74,72,19,27,-8,2,2,4,6110.0,2:2,0,0,0,597.0,0:11,925000
8479366,Logan,Brown,1998-03-05,C,L,2017-18,4,0,1,1,0.25,0,4,0.0,0,1951.0,8:7,4,8,12,33.33,1,1,2,4,-2,0,0,0,562.0,2:20,0,0,0,0.0,0:0,894166
8479370,Tyson,Jost,1998-03-14,C,L,2017-18,65,12,10,22,0.34,-10,113,10.62,26,57072.0,14:38,84,145,229,36.68,33,26,22,10,12,5,3,8,10099.0,2:35,0,0,0,958.0,0:14,885833
8479376,Victor,Mete,1998-06-07,D,L,2017-18,49,0,7,7,0.14,5,43,0.0,4,45824.0,15:35,0,0,0,0.0,1,71,6,53,-47,0,4,4,4130.0,1:24,0,0,0,370.0,0:7,748333
8479398,Samuel,Girard,1998-05-12,D,L,2017-18,73,4,19,23,0.32,-10,84,4.76,8,77300.0,17:38,0,0,0,0.0,46,69,13,31,-18,1,12,13,9500.0,2:10,0,0,0,80.0,0:1,728333
8479400,Pierre-Luc,Dubois,1998-06-24,C,L,2017-18,82,20,28,48,0.59,8,165,12.12,49,81842.0,16:38,461,591,1052,43.82,127,46,38,29,9,6,9,15,9541.0,1:56,0,0,0,761.0,0:9,894166
8479404,Henrik,Borgstrom,1997-08-06,C,L,2017-18,4,1,0,1,0.25,-1,6,16.67,0,3038.0,12:39,15,22,37,40.54,1,1,2,2,0,0,0,0,321.0,1:20,0,0,0,0.0,0:0,925000
8479407,Jesper,Bratt,1998-07-30,LW,L,2017-18,74,13,22,35,0.47,-16,100,13.0,18,67716.0,15:15,7,4,11,63.64,44,22,25,30,-5,4,8,12,9102.0,2:3,1,1,2,4733.0,1:3,749167
8479410,Mikhail,Sergachev,1998-06-25,D,L,2017-18,79,9,31,40,0.51,11,141,6.38,38,72808.0,15:21,0,0,0,0.0,90,64,21,60,-39,3,13,16,8769.0,1:51,0,0,0,68.0,0:0,894166
8479420,Tage,Thompson,1997-10-30,C,R,2017-18,41,3,6,9,0.22,-12,55,5.45,12,29334.0,11:55,1,9,10,10.0,39,9,20,11,9,0,1,1,2738.0,1:6,0,0,0,0.0,0:0,925000
8479423,Alexander,Nylander,1998-03-02,RW,R,2017-18,3,1,0,1,0.33,-3,2,50.0,0,2315.0,12:51,0,0,0,0.0,0,0,0,2,-2,0,0,0,117.0,0:39,0,0,0,0.0,0:0,894166
8479442,Troy,Stecher,1994-04-07,D,R,2017-18,68,1,10,11,0.16,-7,94,1.06,35,76751.0,18:48,0,1,1,0.0,111,75,22,27,-5,0,1,1,965.0,0:14,0,1,1,6189.0,1:31,925000
8479458,Nikita,Zaitsev,1991-10-29,D,R,2017-18,60,5,8,13,0.22,8,54,9.26,31,79983.0,22:13,0,0,0,0.0,113,134,21,76,-55,0,0,0,844.0,0:14,0,0,0,10604.0,2:56,4500000
8479465,Drake,Caggiula,1994-06-20,LW,L,2017-18,67,13,7,20,0.3,-13,104,12.5,37,54472.0,13:33,11,42,53,20.75,147,33,27,28,-1,3,0,3,3920.0,0:58,1,0,1,2972.0,0:44,925000
8479482,Michal,Kempny,1990-09-08,D,L,2017-18,53,3,7,10,0.19,14,82,3.66,26,50603.0,15:54,0,0,0,0.0,57,82,9,41,-32,0,0,0,255.0,0:4,0,0,0,2193.0,0:41,900000
8479483,Yohann,Auvitu,1989-07-27,D,L,2017-18,33,3,6,9,0.27,4,69,4.35,8,26840.0,13:33,0,0,0,0.0,18,26,8,17,-9,0,0,0,833.0,0:25,0,0,0,104.0,0:3,700000
8479511,Janne,Kuokkanen,1998-05-25,C,L,2017-18,4,0,0,0,0.0,-3,6,0.0,0,2655.0,11:3,0,0,0,0.0,1,1,3,2,1,0,0,0,0.0,0:0,0,0,0,0.0,0:0,842500
8479553,Maxim,Mamin,1995-01-13,C,L,2017-18,26,3,1,4,0.15,2,28,10.71,7,16412.0,10:31,0,1,1,0.0,51,9,14,12,2,0,0,0,139.0,0:5,0,0,0,0.0,0:0,757500
8479580,Dylan,Gambrell,1996-08-26,C,R,2017-18,3,0,0,0,0.0,-1,1,0.0,0,1900.0,10:33,9,9,18,50.0,0,2,0,0,0,0,0,0,0.0,0:0,0,0,0,0.0,0:0,925000
8479595,Blake,Hillman,1996-01-26,D,L,2017-18,4,1,0,1,0.25,-1,5,20.0,0,4327.0,18:1,0,0,0,0.0,5,8,0,0,0,0,0,0,5.0,0:1,1,0,1,384.0,1:36,925000
8479650,Vadim,Shipachyov,1987-03-12,C,L,2017-18,3,1,0,1,0.33,3,3,33.33,2,1906.0,10:35,12,9,21,57.14,1,0,0,0,0,0,0,0,179.0,0:59,0,0,0,0.0,0:0,4500000
8479755,Victor,Antipin,1992-12-06,D,L,2017-18,47,0,10,10,0.21,-9,40,0.0,18,43083.0,15:16,0,0,0,0.0,14,41,4,13,-9,0,1,1,2759.0,0:58,0,0,0,294.0,0:6,925000
8479944,Zach,Aston-Reese,1994-08-10,C,L,2017-18,16,4,2,6,0.38,2,20,20.0,2,10921.0,11:22,1,5,6,16.67,55,6,6,4,2,0,0,0,475.0,0:29,0,0,0,813.0,0:50,925000
8479968,Vinni,Lettieri,1995-02-06,C,R,2017-18,19,1,4,5,0.26,-12,28,3.57,0,13744.0,12:3,5,7,12,41.67,22,6,2,7,-5,0,1,1,1685.0,1:28,0,0,0,8.0,0:0,925000
8479974,Nolan,Patrick,1998-09-19,C,R,2017-18,73,13,17,30,0.41,1,127,10.24,30,60115.0,13:43,376,367,743,50.61,48,19,32,33,-1,5,3,8,7999.0,1:49,0,0,0,76.0,0:1,925000
8479977,Kailer,Yamamoto,1998-09-29,RW,R,2017-18,9,0,3,3,0.33,-2,23,0.0,2,8186.0,15:9,0,1,1,0.0,6,3,5,8,-3,0,1,1,751.0,1:23,0,0,0,23.0,0:2,925000
8479999,Casey,Mittelstadt,1998-11-22,C,L,2017-18,6,1,4,5,0.83,1,9,11.11,2,5047.0,14:1,17,19,36,47.22,2,2,0,5,-5,1,0,1,774.0,2:9,0,0,0,0.0,0:0,925000
8480002,Nico,Hischier,1999-01-04,C,L,2017-18,82,20,32,52,0.63,10,180,11.11,26,80242.0,16:18,422,561,983,42.93,56,39,56,26,30,1,5,6,10085.0,2:2,0,0,0,2563.0,0:31,925000
8480009,Eeli,Tolvanen,1999-04-22,RW,L,2017-18,3,0,0,0,0.0,0,3,0.0,0,2180.0,12:6,0,0,0,0.0,2,1,0,1,-1,0,0,0,137.0,0:45,0,0,0,0.0,0:0,925000
8480015,Owen,Tippett,1999-02-16,RW,R,2017-18,7,1,0,1,0.14,-6,17,5.88,0,4669.0,11:7,0,2,2,0.0,3,4,2,2,0,0,0,0,724.0,1:43,0,0,0,23.0,0:3,925000
8480072,Lias,Andersson,1998-10-13,C,L,2017-18,7,1,1,2,0.29,1,5,20.0,0,5017.0,11:56,19,28,47,40.43,9,3,4,0,4,0,0,0,18.0,0:2,0,0,0,187.0,0:26,925000
8480078,Filip,Chytil,1999-09-05,C,L,2017-18,9,1,2,3,0.33,-5,21,4.76,4,7349.0,13:36,28,48,76,36.84,3,1,1,3,-2,0,0,0,200.0,0:22,0,0,0,19.0,0:2,925000
8480113,Alex,Iafallo,1993-12-21,C,L,2017-18,75,9,16,25,0.33,10,129,6.98,12,67966.0,15:6,14,16,30,46.67,53,33,24,23,1,0,2,2,2445.0,0:32,0,0,0,1626.0,0:21,925000
8480143,Jakub,Jerabek,1991-05-12,D,L,2017-18,36,2,6,8,0.22,-2,33,6.06,6,35253.0,16:19,0,0,0,0.0,42,48,4,32,-28,0,0,0,179.0,0:4,0,0,0,538.0,0:14,925000
8480144,David,Kampf,1995-01-12,C,L,2017-18,46,4,7,11,0.24,-9,46,8.7,12,35327.0,12:47,291,258,549,53.01,29,23,14,8,6,0,0,0,229.0,0:4,0,0,0,4071.0,1:28,925000
8480145,Neal,Pionk,1995-07-29,D,R,2017-18,28,1,13,14,0.5,-1,54,1.85,12,37611.0,22:23,0,0,0,0.0,49,41,13,33,-20,0,5,5,2093.0,1:14,0,0,0,3947.0,2:20,925000
8480147,Oscar,Fantenberg,1991-10-07,D,L,2017-18,27,2,7,9,0.33,2,33,6.06,11,23105.0,14:15,0,0,0,0.0,43,17,3,7,-4,0,4,4,3162.0,1:57,0,0,0,428.0,0:15,925000
8480153,Victor,Ejdsell,1995-06-06,C,L,2017-18,6,0,1,1,0.17,-1,7,0.0,0,4794.0,13:19,20,40,60,33.33,6,6,2,0,2,0,0,0,276.0,0:46,0,0,0,0.0,0:0,833750
8480157,Calle,Rosen,1994-02-02,D,L,2017-18,4,0,1,1,0.25,-3,5,0.0,4,3069.0,12:47,0,0,0,0.0,1,0,2,1,1,0,0,0,102.0,0:25,0,0,0,1.0,0:0,925000
8480158,Andreas,Borgman,1995-06-18,D,L,2017-18,48,3,8,11,0.23,4,46,6.52,28,39420.0,13:41,0,0,0,0.0,121,36,13,36,-23,0,0,0,77.0,0:1,0,0,0,561.0,0:11,925000
8480164,Henrik,Haapala,1994-02-28,LW,L,2017-18,5,0,1,1,0.2,0,3,0.0,0,4110.0,13:42,0,0,0,0.0,5,3,0,4,-4,0,0,0,539.0,1:47,0,0,0,0.0,0:0,925000
8480172,Jan,Rutta,1990-07-29,D,R,2017-18,57,6,14,20,0.35,-1,71,8.45,24,65850.0,19:15,0,0,0,0.0,24,64,12,37,-25,2,2,4,1429.0,0:25,0,1,1,7686.0,2:14,925000
8480222,Sebastian,Aho,1996-02-17,D,L,2017-18,22,1,3,4,0.18,-5,24,4.17,6,21444.0,16:14,0,1,1,0.0,10,14,3,12,-9,1,0,1,1350.0,1:1,0,0,0,7.0,0:0,925000
8480330,Spencer,Foo,1994-05-19,RW,R,2017-18,4,2,0,2,0.5,1,16,12.5,0,3805.0,15:51,1,0,1,100.0,6,3,2,1,1,0,0,0,505.0,2:6,0,0,0,0.0,0:0,925000
8480761,Mitch,Reinke,1996-02-04,D,R,2017-18,1,0,0,0,0.0,0,1,0.0,0,785.0,13:5,0,0,0,0.0,0,2,0,0,0,0,0,0,0.0,0:0,0,0,0,0.0,0:0,925000
