player_id,firstName,lastName,birthDate,primaryPosition,shootsCatches,season,gamesPlayed,goals,assists,points,pointsPerGame,plusMinus,shots,shootingPercentage,penaltyMinutes,timeOnIce,avgTimeOnIce,faceOffWins,faceOffLosses,faceOffTaken,faceOffPercentage,hits,blocks,takeaways,giveaways,turnoverDifferential,powerPlayGoals,powerPlayAssists,powerPlayPoints,powerPlayTimeOnIce,avgPowerPlayTimeOnIce,shortHandedGoals,shortHandedAssists,shortHandedPoints,shortHandedTimeOnIce,avgShortHandedTimeOnIce,salary
8464989,Matt,Cullen,1976-11-02,C,L,2018-19,71,7,13,20,0.28,6,87,8.05,14,49031.0,11:30,320,320,640,50.0,32,31,24,19,5,0,0,0,155.0,0:2,2,2,4,9480.0,2:13,650000
8465009,Zdeno,Chara,1977-03-18,D,L,2018-19,62,5,9,14,0.23,22,99,5.05,57,78409.0,21:4,0,0,0,0.0,81,88,28,44,-16,1,2,3,291.0,0:4,0,0,0,11345.0,3:2,5000000
8466138,Joe,Thornton,1979-07-02,C,L,2018-19,73,16,35,51,0.7,8,90,17.78,20,68102.0,15:32,356,319,675,52.74,17,14,43,42,1,3,12,15,8301.0,1:53,0,0,0,34.0,0:0,5000000
8466139,Patrick,Marleau,1979-09-15,C,L,2018-19,82,16,21,37,0.45,-6,161,9.94,28,80415.0,16:20,104,99,203,51.23,74,41,31,22,9,4,6,10,8691.0,1:45,0,0,0,375.0,0:4,6250000
8468493,Ron,Hainsey,1981-03-24,D,L,2018-19,81,5,18,23,0.28,30,81,6.17,21,98444.0,20:15,1,0,1,100.0,91,144,31,74,-43,0,0,0,215.0,0:2,1,0,1,13795.0,2:50,3000000
8468498,Brooks,Orpik,1980-09-26,D,L,2018-19,53,2,7,9,0.17,8,43,4.65,32,49809.0,15:39,0,0,0,0.0,131,78,5,31,-26,0,0,0,47.0,0:0,0,0,0,8297.0,2:36,5500000
8468508,Justin,Williams,1981-10-04,RW,R,2018-19,82,23,30,53,0.65,-4,237,9.7,44,85818.0,17:26,92,150,242,38.02,55,32,63,88,-25,9,5,14,13327.0,2:42,0,0,0,85.0,0:1,4500000
8468509,Niklas,Kronwall,1981-01-12,D,L,2018-19,79,3,24,27,0.34,-5,71,4.23,40,94577.0,19:57,0,0,0,0.0,84,96,12,59,-47,1,7,8,7827.0,1:39,0,0,0,5126.0,1:4,4750000
8468611,Matt,Hendricks,1981-06-17,C,L,2018-19,26,0,3,3,0.12,-2,23,0.0,19,13791.0,8:50,42,35,77,54.55,40,8,5,10,-5,0,0,0,72.0,0:2,0,0,0,1155.0,0:44,700000
8468674,Deryk,Engelland,1982-04-03,D,R,2018-19,74,2,10,12,0.16,-3,105,1.9,18,88257.0,19:52,0,0,0,0.0,165,152,26,24,2,0,0,0,336.0,0:4,0,0,0,14222.0,3:12,1500000
8469454,Ilya,Kovalchuk,1983-04-15,RW,R,2018-19,64,16,18,34,0.53,-26,141,11.35,10,62333.0,16:13,16,20,36,44.44,28,19,21,43,-22,4,5,9,10719.0,2:47,0,0,0,18.0,0:0,6666666
8469455,Jason,Spezza,1983-06-13,C,R,2018-19,76,8,19,27,0.36,-13,121,6.61,29,60512.0,13:16,470,337,807,58.24,16,30,26,53,-27,2,10,12,10045.0,2:12,0,0,0,121.0,0:1,7500000
8469459,Mikko,Koivu,1983-03-12,C,L,2018-19,48,8,21,29,0.6,-2,89,8.99,22,52696.0,18:17,488,406,894,54.59,13,32,35,10,25,2,10,12,6809.0,2:21,0,1,1,4636.0,1:36,5500000
8469465,Dan,Hamhuis,1982-12-13,D,L,2018-19,57,0,5,5,0.09,-2,39,0.0,28,54881.0,16:2,0,0,0,0.0,38,61,12,40,-28,0,0,0,93.0,0:1,0,0,0,5732.0,1:40,1250000
8469506,Jason,Pominville,1982-11-30,RW,R,2018-19,73,16,15,31,0.42,-4,134,11.94,4,54592.0,12:27,18,17,35,51.43,18,20,13,20,-7,1,1,2,3780.0,0:51,0,0,0,34.0,0:0,5600000
8469521,Tomas,Plekanec,1982-10-31,C,L,2018-19,3,1,0,1,0.33,0,8,12.5,0,1958.0,10:52,19,19,38,50.0,1,1,0,0,0,0,0,0,17.0,0:5,0,0,0,260.0,1:26,2250000
8470047,Valtteri,Filppula,1984-03-20,C,L,2018-19,72,17,14,31,0.43,19,78,21.79,16,61667.0,14:16,398,413,811,49.08,12,34,36,27,9,0,0,0,2735.0,0:37,1,0,1,7983.0,1:50,2750000
8470110,Trevor,Daley,1983-10-09,D,L,2018-19,44,2,6,8,0.18,-3,47,4.26,12,48997.0,18:33,0,0,0,0.0,14,53,10,43,-33,0,0,0,248.0,0:5,1,0,1,6895.0,2:36,3166666
8470144,Frans,Nielsen,1984-04-24,C,L,2018-19,72,10,25,35,0.49,-7,120,8.33,14,72018.0,16:40,450,473,923,48.75,79,44,18,35,-17,0,8,8,9589.0,2:13,0,1,1,5927.0,1:22,5250000
8470151,Jay,Bouwmeester,1983-09-27,D,L,2018-19,78,3,14,17,0.22,-3,82,3.66,40,97019.0,20:43,0,0,0,0.0,61,127,25,42,-17,0,0,0,267.0,0:3,0,0,0,10263.0,2:11,5400000
8470187,Johnny,Boychuk,1984-01-19,D,R,2018-19,74,3,16,19,0.26,10,157,1.91,25,83604.0,18:49,0,0,0,0.0,144,120,10,56,-46,1,2,3,2993.0,0:40,0,1,1,6702.0,1:30,6000000
8470257,Alexander,Steen,1984-03-01,LW,L,2018-19,65,10,17,27,0.42,2,114,8.77,14,61781.0,15:50,11,18,29,37.93,55,50,34,16,18,2,3,5,4997.0,1:16,1,1,2,7606.0,1:57,5750000
8470281,Duncan,Keith,1983-07-16,D,L,2018-19,82,6,34,40,0.49,13,141,4.26,70,113246.0,23:1,0,0,0,0.0,42,144,33,73,-40,0,3,3,6803.0,1:22,0,1,1,9982.0,2:1,5538462
8470318,Jonathan,Ericsson,1984-03-02,D,L,2018-19,52,3,2,5,0.1,-10,48,6.25,35,53725.0,17:13,0,0,0,0.0,98,56,9,40,-31,0,0,0,33.0,0:0,0,0,0,7265.0,2:19,4250000
8470543,Chris,Kunitz,1979-09-26,LW,L,2018-19,56,5,5,10,0.18,-7,44,11.36,23,30438.0,9:3,2,5,7,28.57,85,15,13,18,-5,0,0,0,682.0,0:12,0,0,0,189.0,0:3,1000000
8470595,Eric,Staal,1984-10-29,C,L,2018-19,81,22,30,52,0.64,-7,215,10.23,34,88089.0,18:7,642,615,1257,51.07,41,28,49,39,10,7,8,15,13675.0,2:48,0,1,1,1253.0,0:15,3500000
8470598,Thomas,Vanek,1984-01-19,LW,R,2018-19,64,16,20,36,0.56,-12,108,14.81,26,54188.0,14:6,7,18,25,28.0,38,13,20,41,-21,4,7,11,9883.0,2:34,0,0,0,59.0,0:0,3000000
8470600,Ryan,Suter,1985-01-21,D,L,2018-19,82,7,40,47,0.57,-8,136,5.15,41,131325.0,26:41,1,0,1,100.0,78,109,25,30,-5,3,12,15,15068.0,3:3,1,1,2,11341.0,2:18,7538462
8470601,Braydon,Coburn,1985-02-27,D,L,2018-19,74,4,19,23,0.31,4,113,3.54,34,71529.0,16:6,0,0,0,0.0,96,62,17,22,-5,0,0,0,167.0,0:2,0,0,0,4586.0,1:1,3700000
8470602,Dion,Phaneuf,1985-04-10,D,L,2018-19,67,1,5,6,0.09,-21,80,1.25,53,60296.0,14:59,0,0,0,0.0,128,79,6,30,-24,0,0,0,2611.0,0:38,0,0,0,2987.0,0:44,7000000
8470604,Jeff,Carter,1985-01-01,C,R,2018-19,76,13,20,33,0.43,-20,174,7.47,42,82800.0,18:9,607,577,1184,51.27,80,30,23,40,-17,5,8,13,11234.0,2:27,1,1,2,5718.0,1:15,5272727
8470606,Dustin,Brown,1984-11-04,RW,R,2018-19,72,22,29,51,0.71,-17,180,12.22,24,88154.0,20:24,1,16,17,5.88,150,29,31,44,-13,9,3,12,11113.0,2:34,1,1,2,7349.0,1:42,5875000
8470607,Brent,Seabrook,1985-04-20,D,R,2018-19,78,5,23,28,0.36,-6,165,3.03,41,89373.0,19:5,0,0,0,0.0,124,180,19,72,-53,2,8,10,7626.0,1:37,0,1,1,9896.0,2:6,6875000
8470610,Zach,Parise,1984-07-28,LW,L,2018-19,74,28,33,61,0.82,-2,229,12.23,26,82887.0,18:40,9,25,34,26.47,49,71,22,25,-3,10,6,16,12881.0,2:54,0,2,2,5186.0,1:10,7538462
8470611,Eric,Fehr,1985-09-07,C,R,2018-19,72,7,8,15,0.21,-8,67,10.45,30,47705.0,11:2,364,345,709,51.34,40,48,32,12,20,0,0,0,133.0,0:1,0,1,1,8148.0,1:53,1000000
8470612,Ryan,Getzlaf,1985-05-10,C,R,2018-19,67,14,34,48,0.72,-19,133,10.53,58,78240.0,19:27,551,463,1014,54.34,150,74,60,79,-19,1,10,11,10824.0,2:41,0,0,0,2528.0,0:37,8250000
8470613,Brent,Burns,1985-03-09,D,R,2018-19,82,16,67,83,1.01,13,300,5.33,34,123488.0,25:5,0,1,1,0.0,90,105,88,118,-30,7,21,28,16145.0,3:16,1,4,5,9877.0,2:0,8000000
8470616,Ryan,Kesler,1984-08-31,C,R,2018-19,60,5,3,8,0.13,-19,86,5.81,44,59395.0,16:29,582,463,1045,55.69,93,56,18,26,-8,1,2,3,6239.0,1:43,0,0,0,8104.0,2:15,6875000
8470619,Brian,Boyle,1984-12-18,C,L,2018-19,73,18,6,24,0.33,-14,123,14.63,38,58848.0,13:26,170,163,333,51.05,145,50,22,17,5,7,2,9,11525.0,2:37,1,1,2,6763.0,1:32,2550000
8470621,Corey,Perry,1985-05-16,RW,R,2018-19,31,6,4,10,0.32,-16,59,10.17,27,27570.0,14:49,0,2,2,0.0,21,14,12,11,1,2,2,4,3392.0,1:49,0,0,0,18.0,0:0,8625000
8470622,Patrick,Eaves,1984-05-01,RW,R,2018-19,7,0,0,0,0.0,-4,6,0.0,4,5829.0,13:52,0,0,0,0.0,14,1,1,3,-2,0,0,0,656.0,1:33,0,0,0,5.0,0:0,3150000
8470626,Loui,Eriksson,1985-07-17,LW,L,2018-19,81,11,18,29,0.36,-11,107,10.28,22,68356.0,14:3,2,4,6,33.33,3,28,29,10,19,1,2,3,6177.0,1:16,0,0,0,5782.0,1:11,6000000
8470638,Patrice,Bergeron,1985-07-24,C,R,2018-19,65,32,47,79,1.22,23,205,15.61,30,72022.0,18:28,786,603,1389,56.59,43,60,42,27,15,9,18,27,12721.0,3:15,4,3,7,6598.0,1:41,6875000
8470642,Shea,Weber,1985-08-14,D,R,2018-19,58,14,19,33,0.57,15,166,8.43,28,81723.0,23:29,0,0,0,0.0,129,110,17,67,-50,5,1,6,8847.0,2:32,0,0,0,9800.0,2:48,7857143
8470655,David,Backes,1984-05-01,RW,R,2018-19,70,7,13,20,0.29,0,129,5.43,31,54763.0,13:2,176,133,309,56.96,140,30,33,26,7,2,5,7,6960.0,1:39,0,0,0,719.0,0:10,6000000
8470755,Brad,Richardson,1985-02-04,C,L,2018-19,66,19,8,27,0.41,6,128,14.84,22,63220.0,15:57,577,474,1051,54.9,63,55,27,21,6,0,0,0,997.0,0:15,3,3,6,10082.0,2:32,1250000
8470760,Marc,Methot,1985-06-21,D,L,2018-19,9,0,0,0,0.0,-3,3,0.0,6,9148.0,16:56,0,0,0,0.0,15,10,0,2,-2,0,0,0,4.0,0:0,0,0,0,883.0,1:38,4900000
8470775,Nate,Thompson,1984-10-05,C,L,2018-19,78,5,8,13,0.17,-1,71,7.04,17,60856.0,13:0,409,351,760,53.82,87,44,31,23,8,0,0,0,1262.0,0:16,0,0,0,8575.0,1:49,1650000
8470794,Joe,Pavelski,1984-07-11,C,R,2018-19,75,38,26,64,0.85,-4,188,20.21,22,85698.0,19:2,526,463,989,53.19,69,61,41,45,-4,12,9,21,13291.0,2:57,1,0,1,3223.0,0:42,6000000
8470803,Kyle,Brodziak,1984-05-25,C,R,2018-19,70,6,3,9,0.13,-14,74,8.11,33,49106.0,11:41,399,368,767,52.02,92,46,33,17,16,0,0,0,449.0,0:6,1,0,1,7012.0,1:40,1150000
8470834,Dustin,Byfuglien,1985-03-27,D,R,2018-19,42,4,27,31,0.74,4,115,3.48,69,61384.0,24:21,0,0,0,0.0,77,51,21,39,-18,1,15,16,7713.0,3:3,0,0,0,4539.0,1:48,7600000
8470966,Mark,Giordano,1983-10-03,D,L,2018-19,78,17,57,74,0.95,39,221,7.69,69,113439.0,24:14,0,0,0,0.0,58,144,73,65,8,3,18,21,15494.0,3:18,4,2,6,12479.0,2:39,6750000
8471214,Alex,Ovechkin,1985-09-17,LW,R,2018-19,81,51,38,89,1.1,7,338,15.09,40,101677.0,20:55,1,4,5,20.0,223,41,47,70,-23,18,10,28,21441.0,4:24,0,0,0,37.0,0:0,9538462
8471215,Evgeni,Malkin,1986-07-31,C,L,2018-19,68,21,51,72,1.06,-25,187,11.23,89,76720.0,18:48,381,453,834,45.68,54,33,64,84,-20,9,17,26,13915.0,3:24,0,0,0,155.0,0:2,9500000
8471217,Andrew,Ladd,1985-12-12,LW,L,2018-19,26,3,8,11,0.42,3,34,8.82,16,21594.0,13:50,2,3,5,40.0,37,8,9,14,-5,0,0,0,908.0,0:34,0,1,1,634.0,0:24,5500000
8471218,Blake,Wheeler,1986-08-31,RW,R,2018-19,82,20,71,91,1.11,0,231,8.66,60,101892.0,20:42,31,57,88,35.23,81,53,42,33,9,2,31,33,17684.0,3:35,2,1,3,5486.0,1:6,5600000
8471226,Drew,Stafford,1985-10-30,RW,R,2018-19,57,5,8,13,0.23,-7,77,6.49,18,41948.0,12:15,16,23,39,41.03,50,19,15,17,-2,1,1,2,3026.0,0:53,0,0,0,135.0,0:2,810000
8471228,Alexander,Radulov,1986-07-05,RW,L,2018-19,70,29,43,72,1.03,22,209,13.88,54,83088.0,19:46,6,10,16,37.5,60,83,43,74,-31,7,16,23,13017.0,3:5,0,0,0,130.0,0:1,6250000
8471233,Travis,Zajac,1985-05-13,C,R,2018-19,80,19,27,46,0.57,-25,120,15.83,20,92500.0,19:16,841,605,1446,58.16,66,38,63,33,30,5,7,12,12691.0,2:38,2,0,2,13049.0,2:43,5750000
8471242,Mike,Green,1985-10-12,D,R,2018-19,43,5,21,26,0.6,-1,92,5.43,28,55928.0,21:40,0,0,0,0.0,60,56,16,49,-33,0,3,3,5036.0,1:57,0,0,0,461.0,0:10,5375000
8471260,Blake,Comeau,1986-02-18,LW,R,2018-19,77,7,11,18,0.23,-7,102,6.86,42,72656.0,15:43,25,32,57,43.86,208,40,39,36,3,0,0,0,233.0,0:3,0,0,0,9597.0,2:4,2400000
8471262,Carl,Soderberg,1985-10-12,C,L,2018-19,82,23,26,49,0.6,-5,188,12.23,26,85849.0,17:26,528,542,1070,49.35,99,67,49,26,23,2,8,10,8510.0,1:43,3,0,3,12215.0,2:28,4750000
8471273,Brandon,Dubinsky,1986-04-29,C,L,2018-19,61,6,8,14,0.23,-16,63,9.52,36,45221.0,12:21,427,321,748,57.09,147,28,16,7,9,0,0,0,298.0,0:4,0,1,1,4738.0,1:17,5850000
8471274,Alex,Goligoski,1985-07-30,D,L,2018-19,76,3,24,27,0.36,-7,102,2.94,16,94925.0,20:49,1,0,1,100.0,79,154,19,59,-40,1,6,7,8420.0,1:50,0,2,2,7137.0,1:33,5475000
8471276,David,Krejci,1986-04-28,C,R,2018-19,81,20,53,73,0.9,7,139,14.39,16,85916.0,17:40,530,565,1095,48.4,28,24,54,44,10,6,10,16,10936.0,2:15,0,0,0,827.0,0:10,7250000
8471284,Andrej,Sekera,1986-06-08,D,L,2018-19,24,0,4,4,0.17,3,28,0.0,6,23744.0,16:29,0,0,0,0.0,17,21,6,13,-7,0,1,1,743.0,0:30,0,0,0,1895.0,1:18,5500000
8471303,Alexander,Edler,1986-04-21,D,L,2018-19,56,10,24,34,0.61,3,128,7.81,54,82555.0,24:34,0,0,0,0.0,127,166,13,38,-25,4,13,17,10483.0,3:7,0,1,1,8935.0,2:39,5000000
8471339,Ryan,Callahan,1985-03-21,RW,R,2018-19,52,7,10,17,0.33,7,76,9.21,14,34754.0,11:8,6,15,21,28.57,89,25,22,8,14,1,0,1,354.0,0:6,0,1,1,3180.0,1:1,5800000
8471392,Roman,Polak,1986-04-28,D,R,2018-19,77,1,8,9,0.12,6,77,1.3,69,88557.0,19:10,0,0,0,0.0,191,152,18,49,-31,0,0,0,160.0,0:2,0,0,0,12203.0,2:38,1300000
8471426,Troy,Brouwer,1985-08-17,RW,R,2018-19,75,12,9,21,0.28,-6,86,13.95,47,57100.0,12:41,19,32,51,37.25,177,38,23,44,-21,0,0,0,1307.0,0:17,1,0,1,7462.0,1:39,4500000
8471436,Matt,Hunwick,1985-05-21,D,L,2018-19,14,0,2,2,0.14,-7,10,0.0,4,13178.0,15:41,0,0,0,0.0,6,9,2,5,-3,0,0,0,33.0,0:2,0,0,0,1082.0,1:17,2250000
8471490,Adam,Cracknell,1985-07-15,RW,R,2018-19,2,0,0,0,0.0,-1,3,0.0,0,1252.0,10:26,0,0,0,0.0,6,0,0,1,-1,0,0,0,0.0,0:0,0,0,0,20.0,0:10,650000
8471657,Cody,McLeod,1984-06-26,LW,L,2018-19,38,1,0,1,0.03,-13,22,4.55,67,14786.0,6:29,0,1,1,0.0,112,10,5,1,4,0,0,0,11.0,0:0,0,0,0,2.0,0:0,750000
8471669,Paul,Stastny,1985-12-27,C,L,2018-19,50,13,29,42,0.84,14,103,12.62,30,54312.0,18:6,463,384,847,54.66,35,15,36,18,18,1,3,4,6125.0,2:2,1,1,2,3286.0,1:5,6500000
8471675,Sidney,Crosby,1987-08-07,C,L,2018-19,79,35,65,100,1.27,18,220,15.91,36,99501.0,20:59,1012,814,1826,55.42,85,43,54,67,-13,12,17,29,15197.0,3:12,0,2,2,2687.0,0:34,8700000
8471676,Bobby,Ryan,1987-03-17,RW,R,2018-19,78,15,27,42,0.54,-29,160,9.38,35,73393.0,15:40,8,18,26,30.77,77,49,50,48,2,7,9,16,11065.0,2:21,0,0,0,417.0,0:5,7250000
8471677,Jack,Johnson,1987-01-13,D,L,2018-19,82,1,12,13,0.16,-4,86,1.16,41,94850.0,19:16,0,0,0,0.0,233,147,14,32,-18,1,1,2,1608.0,0:19,0,2,2,11144.0,2:15,3250000
8471685,Anze,Kopitar,1987-08-24,C,L,2018-19,81,22,38,60,0.74,-20,156,14.1,30,108410.0,22:18,1002,817,1819,55.09,59,66,57,58,-1,1,18,19,13794.0,2:50,2,0,2,9554.0,1:57,10000000
8471686,Marc,Staal,1987-01-13,D,L,2018-19,79,3,10,13,0.16,-9,84,3.57,32,92052.0,19:25,0,0,0,0.0,94,119,28,68,-40,0,0,0,143.0,0:1,0,0,0,13702.0,2:53,5700000
8471691,Martin,Hanzal,1987-02-20,C,L,2018-19,7,1,1,2,0.29,-4,14,7.14,4,5403.0,12:51,45,31,76,59.21,14,4,2,3,-1,1,0,1,808.0,1:55,0,0,0,513.0,1:13,4750000
8471698,T.J.,Oshie,1986-12-23,RW,R,2018-19,69,25,29,54,0.78,5,143,17.48,36,77050.0,18:36,84,121,205,40.98,133,55,46,38,8,6,8,14,13893.0,3:21,1,0,1,2420.0,0:35,5750000
8471699,Andrew,Cogliano,1987-06-14,LW,L,2018-19,78,6,11,17,0.22,1,106,5.66,22,58925.0,12:35,11,18,29,37.93,68,32,22,32,-10,1,0,1,302.0,0:3,0,0,0,6414.0,1:22,3250000
8471702,Matt,Niskanen,1986-12-06,D,R,2018-19,80,8,17,25,0.31,-3,143,5.59,41,105271.0,21:55,0,0,0,0.0,167,137,40,73,-33,1,1,2,2764.0,0:34,0,1,1,13240.0,2:45,5750000
8471707,James,Neal,1987-09-03,LW,L,2018-19,63,7,12,19,0.3,-5,141,4.96,28,56542.0,14:57,5,6,11,45.45,46,19,11,35,-24,2,4,6,8343.0,2:12,0,0,0,61.0,0:0,5750000
8471709,Marc-Edouard,Vlasic,1987-03-30,D,L,2018-19,72,3,22,25,0.35,-6,100,3.0,10,90904.0,21:2,0,0,0,0.0,23,114,24,51,-27,0,1,1,3281.0,0:45,0,0,0,11272.0,2:36,7000000
8471716,Justin,Abdelkader,1987-02-25,LW,L,2018-19,71,6,13,19,0.27,-14,95,6.32,38,65606.0,15:24,52,51,103,50.49,185,34,9,40,-31,1,1,2,2635.0,0:37,1,0,1,7972.0,1:52,4250000
8471717,Adam,McQuaid,1986-10-12,D,R,2018-19,50,3,4,7,0.14,2,28,10.71,42,47332.0,15:46,0,0,0,0.0,122,88,11,19,-8,0,0,0,34.0,0:0,0,1,1,5196.0,1:43,2750000
8471724,Kris,Letang,1987-04-24,D,R,2018-19,65,16,40,56,0.86,13,206,7.77,48,101241.0,25:57,0,0,0,0.0,116,111,63,76,-13,2,17,19,12633.0,3:14,1,1,2,8398.0,2:9,7250000
8471729,Kris,Russell,1987-05-02,D,L,2018-19,72,3,13,16,0.22,5,63,4.76,27,88246.0,20:25,0,0,0,0.0,93,185,21,71,-50,0,0,0,984.0,0:13,0,1,1,8421.0,1:56,4000000
8471735,Keith,Yandle,1986-09-09,D,L,2018-19,82,9,53,62,0.76,-17,199,4.52,50,110422.0,22:26,0,0,0,0.0,47,76,27,110,-83,7,32,39,17483.0,3:33,0,0,0,1850.0,0:22,6350000
8471743,Vladimir,Sobotka,1987-07-02,LW,L,2018-19,69,5,8,13,0.19,-20,71,7.04,26,58729.0,14:11,318,295,613,51.88,87,30,12,14,-2,0,0,0,631.0,0:9,0,1,1,7831.0,1:53,3500000
8471761,Chris,Butler,1986-10-27,D,L,2018-19,13,1,1,2,0.15,3,10,10.0,0,10950.0,14:2,0,0,0,0.0,17,17,3,4,-1,0,0,0,10.0,0:0,0,0,0,732.0,0:56,650000
8471768,Tom,Pyatt,1987-02-14,LW,L,2018-19,37,0,2,2,0.05,-16,29,0.0,2,26004.0,11:42,56,92,148,37.84,15,46,4,9,-5,0,0,0,58.0,0:1,0,0,0,3956.0,1:46,1100000
8471769,Niklas,Hjalmarsson,1987-06-06,D,L,2018-19,82,0,10,10,0.12,8,57,0.0,44,96916.0,19:41,0,0,0,0.0,45,187,32,46,-14,0,0,0,85.0,0:1,0,2,2,15565.0,3:9,4100000
8471794,Darren,Helm,1987-01-21,LW,L,2018-19,61,7,10,17,0.28,-11,107,6.54,20,53342.0,14:34,16,20,36,44.44,50,26,33,30,3,0,0,0,208.0,0:3,1,3,4,6891.0,1:52,3850000
8471817,Ryan,Reaves,1987-01-20,RW,R,2018-19,80,9,11,20,0.25,1,95,9.47,74,52189.0,10:52,40,54,94,42.55,305,24,37,11,26,3,0,3,3497.0,0:43,0,0,0,0.0,0:0,2775000
8471873,Anton,Stralman,1986-08-01,D,R,2018-19,47,2,15,17,0.36,12,57,3.51,8,57875.0,20:31,0,0,0,0.0,59,71,25,16,9,0,1,1,314.0,0:6,0,0,0,8251.0,2:55,4500000
8471887,Patric,Hornqvist,1987-01-01,RW,R,2018-19,69,18,19,37,0.54,-3,197,9.14,26,64072.0,15:28,9,9,18,50.0,150,34,25,18,7,6,6,12,11273.0,2:43,0,0,0,46.0,0:0,5300000
8471958,Dan,Girardi,1984-04-29,D,R,2018-19,62,4,12,16,0.26,6,75,5.33,12,66217.0,17:48,0,0,0,0.0,151,108,8,25,-17,0,0,0,106.0,0:1,0,1,1,8357.0,2:14,5500000
8472382,Andy,Greene,1982-10-30,D,L,2018-19,82,5,20,25,0.3,-9,104,4.81,16,102502.0,20:50,0,0,0,0.0,67,208,40,45,-5,0,2,2,549.0,0:6,0,4,4,20155.0,4:5,5000000
8472410,Stephen,Gionta,1983-10-09,RW,R,2018-19,5,0,0,0,0.0,-4,4,0.0,0,2635.0,8:47,20,17,37,54.05,14,2,0,2,-2,0,0,0,7.0,0:1,0,0,0,322.0,1:4,650000
8473412,Bryan,Little,1987-11-12,C,R,2018-19,82,15,26,41,0.5,-12,126,11.9,26,77897.0,15:49,526,476,1002,52.5,62,29,36,21,15,4,3,7,6970.0,1:25,0,2,2,5791.0,1:10,5291667
8473415,Alex,Biega,1988-04-04,D,R,2018-19,41,2,14,16,0.39,0,91,2.2,22,43471.0,17:40,0,0,0,0.0,101,43,4,17,-13,0,1,1,201.0,0:4,0,0,0,1687.0,0:41,825000
8473419,Brad,Marchand,1988-05-11,LW,L,2018-19,79,36,64,100,1.27,15,231,15.58,96,93016.0,19:37,45,60,105,42.86,46,19,59,84,-25,10,24,34,14997.0,3:9,3,4,7,7438.0,1:34,6125000
8473422,Nick,Foligno,1987-10-31,LW,L,2018-19,73,17,18,35,0.48,12,141,12.06,44,77543.0,17:42,133,102,235,56.6,175,51,37,26,11,2,2,4,10743.0,2:27,0,0,0,3834.0,0:52,5500000
8473446,Erik,Johnson,1988-03-21,D,R,2018-19,80,7,18,25,0.31,8,144,4.86,38,104710.0,21:48,0,0,0,0.0,124,143,31,41,-10,0,0,0,1721.0,0:21,0,0,0,14866.0,3:5,6000000
8473449,Kyle,Okposo,1988-04-16,RW,R,2018-19,78,14,15,29,0.37,-9,147,9.52,41,64515.0,13:47,63,71,134,47.01,87,27,17,27,-10,7,4,11,8835.0,1:53,0,0,0,65.0,0:0,6000000
8473453,Trevor,Lewis,1987-01-08,C,R,2018-19,44,3,9,12,0.27,-9,87,3.45,9,37020.0,14:1,57,67,124,45.97,53,25,12,12,0,0,0,0,262.0,0:5,0,0,0,3818.0,1:26,2000000
8473463,Leo,Komarov,1987-01-23,C,L,2018-19,82,6,20,26,0.32,18,78,7.69,42,68346.0,13:53,84,100,184,45.65,203,38,28,26,2,0,0,0,330.0,0:4,0,0,0,8541.0,1:44,3000000
8473465,Jamie,McGinn,1988-08-05,LW,L,2018-19,19,4,3,7,0.37,-5,23,17.39,6,12172.0,10:40,1,0,1,100.0,34,3,4,6,-2,1,0,1,1210.0,1:3,0,0,0,7.0,0:0,3333333
8473468,Eric,Gryba,1988-04-14,D,R,2018-19,10,0,0,0,0.0,-1,11,0.0,10,9177.0,15:17,0,0,0,0.0,21,16,4,6,-2,0,0,0,7.0,0:0,0,0,0,761.0,1:16,900000
8473473,Milan,Lucic,1988-06-07,LW,L,2018-19,79,6,14,20,0.25,-9,74,8.11,91,62738.0,13:14,25,20,45,55.56,259,22,27,34,-7,2,2,4,6367.0,1:20,0,0,0,0.0,0:0,6000000
8473492,Matt,Beleskey,1988-06-07,LW,L,2018-19,4,1,0,1,0.25,1,3,33.33,5,1769.0,7:22,1,0,1,100.0,7,1,0,2,-2,0,0,0,0.0,0:0,0,0,0,0.0,0:0,3800000
8473504,Cal,Clutterbuck,1987-11-18,RW,R,2018-19,73,8,15,23,0.32,6,95,8.42,44,61200.0,13:58,15,19,34,44.12,209,40,20,28,-8,3,0,3,5495.0,1:15,0,1,1,8028.0,1:49,3500000
8473507,Jeff,Petry,1987-12-09,D,R,2018-19,82,13,33,46,0.56,-5,172,7.56,28,113747.0,23:7,0,1,1,0.0,190,123,39,129,-90,3,8,11,12464.0,2:32,0,1,1,10323.0,2:5,5500000
8473512,Claude,Giroux,1988-01-12,C,R,2018-19,82,22,63,85,1.04,9,229,9.61,24,105567.0,21:27,674,490,1164,57.9,28,19,46,48,-2,2,21,23,17304.0,3:31,1,0,1,8534.0,1:44,8275000
8473533,Jordan,Staal,1988-09-10,C,L,2018-19,50,11,17,28,0.56,6,121,9.09,26,54854.0,18:17,571,452,1023,55.82,122,18,40,24,16,0,2,2,5463.0,1:49,0,0,0,5467.0,1:49,6000000
8473534,Patrik,Berglund,1988-06-02,C,L,2018-19,23,2,2,4,0.17,-5,25,8.0,6,17999.0,13:2,68,48,116,58.62,25,16,6,5,1,0,0,0,755.0,0:32,0,0,0,1548.0,1:7,3850000
8473544,Derick,Brassard,1987-09-22,C,L,2018-19,70,14,9,23,0.33,-19,110,12.73,39,62980.0,14:59,283,305,588,48.13,102,15,35,28,7,2,3,5,6680.0,1:35,0,0,0,367.0,0:5,5000000
8473546,Michael,Grabner,1987-10-05,RW,L,2018-19,41,9,7,16,0.39,-2,65,13.85,8,35401.0,14:23,5,7,12,41.67,28,15,31,19,12,0,0,0,207.0,0:5,6,3,9,5800.0,2:21,3350000
8473548,Phil,Kessel,1987-10-02,RW,R,2018-19,82,27,55,82,1.0,-19,215,12.56,28,88453.0,17:58,4,5,9,44.44,12,18,33,78,-45,12,24,36,15897.0,3:13,0,0,0,12.0,0:0,8000000
8473560,Korbinian,Holzer,1988-02-16,D,R,2018-19,22,1,3,4,0.18,5,15,6.67,8,21208.0,16:4,0,0,0,0.0,61,38,7,15,-8,0,0,0,48.0,0:2,0,0,0,3356.0,2:32,900000
8473563,Nicklas,Backstrom,1987-11-23,C,L,2018-19,80,22,52,74,0.92,2,169,13.02,30,95773.0,19:57,700,739,1439,48.64,54,30,53,62,-9,7,18,25,17754.0,3:41,0,0,0,4434.0,0:55,6700000
8473564,Michael,Frolik,1988-02-17,RW,L,2018-19,65,16,18,34,0.52,24,132,12.12,26,52109.0,13:21,13,25,38,34.21,57,22,33,49,-16,0,0,0,268.0,0:4,2,0,2,2227.0,0:34,4300000
8473573,Artem,Anisimov,1988-05-24,C,L,2018-19,78,15,22,37,0.47,-2,142,10.56,14,76484.0,16:20,332,394,726,45.73,25,33,50,14,36,1,3,4,6591.0,1:24,1,0,1,5309.0,1:8,4550000
8473584,Andrew,MacDonald,1986-09-07,D,L,2018-19,47,0,9,9,0.19,-5,41,0.0,18,46232.0,16:23,0,0,0,0.0,30,95,3,27,-24,0,0,0,166.0,0:3,0,2,2,5391.0,1:54,5000000
8473588,Erik,Condra,1986-08-06,RW,R,2018-19,6,1,0,1,0.17,-2,10,10.0,2,4566.0,12:41,0,1,1,0.0,3,1,0,6,-6,0,0,0,432.0,1:12,0,0,0,0.0,0:0,700000
8473604,Jonathan,Toews,1988-04-29,C,L,2018-19,82,35,46,81,0.99,2,235,14.89,40,103354.0,21:0,1059,821,1880,56.33,42,44,72,52,20,9,14,23,16096.0,3:16,1,0,1,8538.0,1:44,10500000
8473618,Mathieu,Perreault,1988-01-05,C,L,2018-19,82,15,15,30,0.37,-1,95,15.79,44,60182.0,12:13,26,27,53,49.06,127,25,31,17,14,4,3,7,6772.0,1:22,0,0,0,39.0,0:0,4125000
8473673,David,Schlemko,1987-05-07,D,L,2018-19,18,0,2,2,0.11,-1,29,0.0,4,21432.0,19:50,0,0,0,0.0,29,45,4,20,-16,0,2,2,1458.0,1:21,0,0,0,2380.0,2:12,2100000
8473914,Mark,Letestu,1985-02-04,C,R,2018-19,2,0,0,0,0.0,-1,1,0.0,0,1120.0,9:20,5,1,6,83.33,3,0,0,0,0,0,0,0,41.0,0:20,0,0,0,0.0,0:0,750000
8473933,Ben,Lovejoy,1984-02-20,D,R,2018-19,71,2,7,9,0.13,-1,95,2.11,37,72788.0,17:5,0,0,0,0.0,76,118,23,38,-15,0,0,0,194.0,0:2,0,0,0,14461.0,3:23,2666667
8473986,Alex,Killorn,1989-09-14,LW,L,2018-19,82,18,22,40,0.49,22,153,11.76,45,73182.0,14:52,2,8,10,20.0,88,23,30,22,8,2,3,5,6753.0,1:22,1,1,2,9602.0,1:57,4450000
8473991,Karl,Alzner,1988-09-24,D,L,2018-19,9,0,1,1,0.11,1,8,0.0,2,9342.0,17:18,0,0,0,0.0,13,10,1,6,-5,0,0,0,24.0,0:2,0,0,0,1144.0,2:7,4625000
8473992,Justin,Falk,1988-10-11,D,L,2018-19,10,0,0,0,0.0,-4,7,0.0,11,7755.0,12:55,0,0,0,0.0,36,9,1,5,-4,0,0,0,8.0,0:0,0,0,0,672.0,1:7,650000
8473994,Jamie,Benn,1989-07-18,LW,L,2018-19,78,27,26,53,0.68,14,189,14.29,56,85302.0,18:13,205,213,418,49.04,142,71,44,80,-36,8,3,11,12322.0,2:37,0,0,0,1702.0,0:21,9500000
8474000,Steven,Kampfer,1988-09-24,D,R,2018-19,35,3,3,6,0.17,-6,40,7.5,22,30714.0,14:37,0,0,0,0.0,44,32,12,7,5,1,1,2,1942.0,0:55,0,0,0,1286.0,0:36,650000
8474008,Paul,Carey,1988-09-24,C,L,2018-19,7,0,0,0,0.0,0,4,0.0,0,4470.0,10:38,1,3,4,25.0,3,3,3,4,-1,0,0,0,16.0,0:2,0,0,0,77.0,0:11,700000
8474009,Nick,Bonino,1988-04-20,C,L,2018-19,81,17,18,35,0.43,27,118,14.41,18,79244.0,16:18,586,546,1132,51.77,24,70,30,40,-10,3,0,3,8071.0,1:39,0,1,1,9415.0,1:56,4100000
8474013,Ian,Cole,1989-02-21,D,L,2018-19,71,2,13,15,0.21,-1,82,2.44,115,84161.0,19:45,0,0,0,0.0,107,178,27,46,-19,0,0,0,356.0,0:5,0,0,0,13987.0,3:17,4250000
8474025,Eric,Tangradi,1989-02-10,LW,L,2018-19,6,0,1,1,0.17,-3,10,0.0,0,4961.0,13:46,3,3,6,50.0,11,4,3,1,2,0,0,0,637.0,1:46,0,0,0,7.0,0:1,650000
8474027,Justin,Braun,1987-02-10,D,R,2018-19,78,2,14,16,0.21,-14,105,1.9,35,95035.0,20:18,0,0,0,0.0,121,120,34,51,-17,0,1,1,509.0,0:6,0,0,0,10730.0,2:17,3800000
8474031,Kevin,Shattenkirk,1989-01-29,D,R,2018-19,73,2,26,28,0.38,-15,148,1.35,20,82956.0,18:56,0,0,0,0.0,73,104,39,55,-16,1,6,7,10644.0,2:25,0,0,0,1904.0,0:26,6650000
8474034,Patrick,Maroon,1988-04-23,LW,L,2018-19,74,10,18,28,0.38,-3,118,8.47,64,62913.0,14:10,2,3,5,40.0,135,7,25,21,4,2,9,11,8662.0,1:57,0,0,0,0.0,0:0,1750000
8474037,James,van Riemsdyk,1989-05-04,LW,L,2018-19,66,27,21,48,0.73,-10,167,16.17,18,65750.0,16:36,6,5,11,54.55,34,16,25,19,6,8,5,13,10978.0,2:46,0,0,0,28.0,0:0,7000000
8474038,Paul,Byron,1989-04-27,LW,L,2018-19,56,15,16,31,0.55,16,94,15.96,17,48944.0,14:34,12,23,35,34.29,114,36,12,26,-14,0,1,1,3618.0,1:4,2,1,3,4650.0,1:23,1166667
8474040,Sam,Gagner,1989-08-10,C,R,2018-19,32,6,7,13,0.41,-6,68,8.82,14,28003.0,14:35,59,59,118,50.0,21,7,5,20,-15,1,0,1,2730.0,1:25,0,0,0,46.0,0:1,3150000
8474053,Logan,Couture,1989-03-28,C,L,2018-19,81,27,43,70,0.86,-6,204,13.24,22,90371.0,18:35,282,327,609,46.31,65,52,71,36,35,6,12,18,14074.0,2:53,2,0,2,7589.0,1:33,6000000
8474056,P.K.,Subban,1989-05-13,D,R,2018-19,63,9,22,31,0.49,5,168,5.36,60,85671.0,22:39,0,0,0,0.0,56,75,22,57,-35,2,8,10,9787.0,2:35,1,0,1,5907.0,1:33,9000000
8474061,Anthony,Peluso,1989-04-18,RW,R,2018-19,4,0,0,0,0.0,-1,1,0.0,7,987.0,4:6,0,0,0,0.0,4,0,2,1,1,0,0,0,0.0,0:0,0,0,0,0.0,0:0,650000
8474062,Riley,Nash,1989-05-09,C,R,2018-19,78,3,9,12,0.15,-8,79,3.8,19,50730.0,10:50,150,183,333,45.05,72,43,39,13,26,0,0,0,374.0,0:4,0,0,0,1356.0,0:17,2750000
8474066,Thomas,Hickey,1989-02-08,D,L,2018-19,40,0,4,4,0.1,5,47,0.0,33,44412.0,18:30,0,0,0,0.0,40,71,9,27,-18,0,0,0,165.0,0:4,0,1,1,5427.0,2:15,2500000
8474068,Kyle,Turris,1989-08-14,C,R,2018-19,55,7,16,23,0.42,-6,78,8.97,33,51784.0,15:41,281,272,553,50.81,24,15,19,26,-7,4,2,6,7370.0,2:14,0,0,0,93.0,0:1,6000000
8474089,Brad,Malone,1989-05-20,C,L,2018-19,16,0,0,0,0.0,0,13,0.0,4,8593.0,8:57,32,40,72,44.44,35,5,1,1,0,0,0,0,39.0,0:2,0,0,0,893.0,0:55,650000
8474090,Brendan,Smith,1989-02-08,D,L,2018-19,63,4,9,13,0.21,-7,66,6.06,71,57818.0,15:17,0,1,1,0.0,100,48,32,50,-18,0,0,0,162.0,0:2,0,1,1,6049.0,1:36,4350000
8474091,Brandon,Sutter,1989-02-14,C,R,2018-19,26,4,2,6,0.23,-12,43,9.3,6,27249.0,17:28,224,238,462,48.48,33,13,8,6,2,1,0,1,1405.0,0:54,1,0,1,4883.0,3:7,4375000
8474098,Colton,Sceviour,1989-04-20,C,R,2018-19,59,5,10,15,0.25,-2,116,4.31,15,43525.0,12:17,39,71,110,35.45,89,58,18,24,-6,0,1,1,173.0,0:2,0,0,0,7156.0,2:1,1200000
8474102,David,Perron,1988-05-28,LW,R,2018-19,57,23,23,46,0.81,3,112,20.54,46,58466.0,17:5,15,18,33,45.45,52,13,41,17,24,7,7,14,7997.0,2:20,0,0,0,91.0,0:1,4000000
8474125,Carl,Gunnarsson,1986-11-09,D,L,2018-19,25,3,4,7,0.28,8,21,14.29,6,23897.0,15:55,0,0,0,0.0,11,35,6,7,-1,0,0,0,30.0,0:1,0,1,1,2541.0,1:41,2900000
8474131,Mario,Kempe,1988-09-19,RW,L,2018-19,52,4,5,9,0.17,5,57,7.02,18,34893.0,11:11,126,203,329,38.3,105,30,11,10,1,0,0,0,129.0,0:2,0,0,0,2272.0,0:43,700000
8474134,Yannick,Weber,1988-09-23,D,R,2018-19,62,2,6,8,0.13,7,67,2.99,18,44317.0,11:54,0,0,0,0.0,64,32,7,13,-6,0,0,0,274.0,0:4,0,0,0,1281.0,0:20,675000
8474141,Patrick,Kane,1988-11-19,RW,L,2018-19,81,44,66,110,1.36,2,341,12.9,22,109297.0,22:29,1,4,5,20.0,21,18,42,54,-12,9,21,30,18043.0,3:42,0,0,0,248.0,0:3,10500000
8474145,Robert,Bortuzzo,1989-03-18,D,R,2018-19,59,2,8,10,0.17,9,75,2.67,47,54775.0,15:28,0,0,0,0.0,95,72,11,20,-9,0,0,0,133.0,0:2,0,1,1,8318.0,2:20,1150000
8474149,Evgenii,Dadonov,1989-03-12,RW,L,2018-19,82,28,42,70,0.85,-6,195,14.36,8,90386.0,18:22,2,3,5,40.0,33,42,45,59,-14,8,9,17,16509.0,3:21,0,0,0,46.0,0:0,4000000
8474150,Mikael,Backlund,1989-03-17,C,L,2018-19,77,21,26,47,0.61,34,205,10.24,52,82661.0,17:53,511,520,1031,49.56,52,26,78,55,23,1,1,2,7597.0,1:38,1,1,2,6448.0,1:23,5350000
8474151,Ryan,McDonagh,1989-06-13,D,L,2018-19,82,9,37,46,0.56,38,128,7.03,34,108674.0,22:5,0,0,0,0.0,98,161,46,66,-20,0,3,3,3254.0,0:39,0,3,3,15489.0,3:8,4700000
8474157,Max,Pacioretty,1988-11-20,LW,L,2018-19,66,22,18,40,0.61,-13,191,11.52,36,67325.0,17:0,21,32,53,39.62,119,20,39,38,1,4,4,8,10017.0,2:31,0,0,0,970.0,0:14,4500000
8474161,Jakub,Voracek,1989-08-15,RW,L,2018-19,78,20,46,66,0.85,-16,210,9.52,25,87386.0,18:40,12,18,30,40.0,17,29,32,58,-26,4,14,18,15222.0,3:15,0,0,0,129.0,0:1,8250000
8474162,Jake,Muzzin,1989-02-21,D,L,2018-19,80,9,28,37,0.46,21,141,6.38,47,102439.0,21:20,0,0,0,0.0,172,134,20,102,-82,1,4,5,5625.0,1:10,0,1,1,8447.0,1:45,4000000
8474166,Alec,Martinez,1987-07-26,D,L,2018-19,60,4,14,18,0.3,-2,78,5.13,8,76907.0,21:21,0,0,0,0.0,78,135,12,70,-58,0,2,2,4354.0,1:12,0,0,0,6826.0,1:53,4000000
8474176,Carl,Hagelin,1988-08-23,LW,L,2018-19,58,5,14,19,0.33,7,99,5.05,30,51258.0,14:43,6,21,27,22.22,64,20,30,19,11,0,0,0,167.0,0:2,0,0,0,6790.0,1:57,4000000
8474189,Lars,Eller,1989-05-08,C,L,2018-19,81,13,23,36,0.44,-1,163,7.98,37,80357.0,16:32,543,566,1109,48.96,69,47,59,63,-4,0,3,3,6256.0,1:17,1,2,3,11347.0,2:20,3500000
8474190,Wayne,Simmonds,1988-08-26,RW,R,2018-19,79,17,13,30,0.38,-16,157,10.83,99,74258.0,15:39,4,13,17,23.53,137,28,27,38,-11,5,3,8,13060.0,2:45,0,0,0,27.0,0:0,3975000
8474207,Nick,Holden,1987-05-15,D,L,2018-19,61,3,12,15,0.25,5,77,3.9,14,66950.0,18:17,0,0,0,0.0,104,76,26,30,-4,0,0,0,324.0,0:5,0,2,2,6385.0,1:44,2200000
8474218,Jason,Demers,1988-06-09,D,R,2018-19,35,2,6,8,0.23,9,39,5.13,12,41984.0,19:59,0,0,0,0.0,50,43,14,18,-4,0,1,1,855.0,0:24,0,0,0,4017.0,1:54,4500000
8474230,Micheal,Haley,1986-03-30,C,L,2018-19,43,2,4,6,0.14,-2,34,5.88,75,20875.0,8:5,13,17,30,43.33,76,16,3,15,-12,0,0,0,105.0,0:2,0,0,0,31.0,0:0,825000
8474250,Zack,Smith,1988-04-05,LW,L,2018-19,70,9,19,28,0.4,-6,101,8.91,81,68679.0,16:21,403,417,820,49.15,136,27,42,47,-5,0,0,0,428.0,0:6,1,2,3,7656.0,1:49,3250000
8474291,Jay,Beagle,1985-10-16,C,R,2018-19,57,3,10,13,0.23,-8,45,6.67,18,46699.0,13:39,426,332,758,56.2,102,33,13,10,3,0,0,0,143.0,0:2,1,0,1,9156.0,2:40,3000000
8474520,Jason,Garrison,1984-11-13,D,L,2018-19,17,1,0,1,0.06,1,16,6.25,8,12950.0,12:41,0,0,0,0.0,13,23,2,5,-3,1,0,1,1113.0,1:5,0,0,0,1012.0,0:59,650000
8474563,Drew,Doughty,1989-12-08,D,R,2018-19,82,8,37,45,0.55,-35,154,5.19,44,130846.0,26:35,0,0,0,0.0,168,120,23,105,-82,7,17,24,14420.0,2:55,0,1,1,12073.0,2:27,7000000
8474564,Steven,Stamkos,1990-02-07,C,R,2018-19,82,45,53,98,1.2,4,234,19.23,37,90037.0,18:18,506,447,953,53.1,72,40,28,60,-32,19,21,40,17858.0,3:37,2,0,2,2959.0,0:36,8500000
8474565,Alex,Pietrangelo,1990-01-18,D,R,2018-19,71,13,28,41,0.58,2,168,7.74,22,102568.0,24:4,0,1,1,0.0,62,139,55,50,5,3,12,15,11730.0,2:45,0,1,1,8768.0,2:3,6500000
8474567,Zach,Bogosian,1990-07-15,D,R,2018-19,65,3,16,19,0.29,-5,93,3.23,52,84344.0,21:37,0,0,0,0.0,83,116,17,46,-29,0,1,1,997.0,0:15,1,0,1,10776.0,2:45,5142857
8474568,Luke,Schenn,1989-11-02,D,R,2018-19,26,0,2,2,0.08,-10,30,0.0,16,21692.0,13:54,0,0,0,0.0,105,39,2,9,-7,0,0,0,2.0,0:0,0,0,0,1912.0,1:13,800000
8474569,Colin,Wilson,1989-10-20,C,L,2018-19,65,12,15,27,0.42,-6,104,11.54,8,52894.0,13:33,20,32,52,38.46,55,31,16,10,6,5,2,7,8114.0,2:4,0,0,0,42.0,0:0,3937500
8474571,Mikkel,Boedker,1989-12-16,LW,L,2018-19,71,7,28,35,0.49,-23,88,7.95,6,59737.0,14:1,7,11,18,38.89,54,28,25,27,-2,2,5,7,8026.0,1:53,0,0,0,72.0,0:1,4000000
8474573,Josh,Bailey,1989-10-02,RW,L,2018-19,82,16,40,56,0.68,8,126,12.7,21,82792.0,16:49,140,132,272,51.47,19,32,41,80,-39,2,12,14,12057.0,2:27,1,0,1,170.0,0:2,5000000
8474574,Tyler,Myers,1990-02-01,D,R,2018-19,80,9,22,31,0.39,11,156,5.77,63,97665.0,20:20,0,0,0,0.0,97,99,32,63,-31,0,7,7,5559.0,1:9,1,1,2,10423.0,2:10,5500000
8474578,Erik,Karlsson,1990-05-31,D,R,2018-19,53,3,42,45,0.85,6,169,1.78,22,77879.0,24:29,0,1,1,0.0,44,69,59,63,-4,2,18,20,9904.0,3:6,0,0,0,5849.0,1:50,6500000
8474579,Luca,Sbisa,1990-01-30,D,L,2018-19,9,0,1,1,0.11,0,5,0.0,4,8353.0,15:28,0,0,0,0.0,17,7,1,3,-2,0,0,0,3.0,0:0,0,0,0,951.0,1:45,1500000
8474581,Jake,Gardiner,1990-07-04,D,L,2018-19,62,3,27,30,0.48,19,78,3.85,26,78916.0,21:12,0,1,1,0.0,61,64,25,53,-28,0,5,5,6918.0,1:51,0,0,0,470.0,0:7,4050000
8474584,Michael,Del Zotto,1990-06-24,D,L,2018-19,42,1,9,10,0.24,-2,45,2.22,8,42912.0,17:1,0,0,0,0.0,129,53,7,22,-15,0,0,0,226.0,0:5,0,0,0,4297.0,1:42,3000000
8474586,Jordan,Eberle,1990-05-15,C,R,2018-19,78,19,18,37,0.47,-6,160,11.88,17,77346.0,16:31,9,11,20,45.0,36,35,34,40,-6,7,5,12,13155.0,2:48,0,0,0,111.0,0:1,6000000
8474589,Tyler,Ennis,1989-10-06,LW,L,2018-19,51,12,6,18,0.35,-6,81,14.81,2,30414.0,9:56,1,0,1,100.0,49,14,19,21,-2,2,3,5,4928.0,1:36,0,0,0,0.0,0:0,4600000
8474590,John,Carlson,1990-01-10,D,R,2018-19,80,13,57,70,0.88,21,185,7.03,34,120311.0,25:3,0,0,0,0.0,54,164,55,87,-32,3,30,33,19585.0,4:4,0,0,0,12373.0,2:34,8000000
8474597,Cody,Goloubef,1989-11-30,D,R,2018-19,5,0,0,0,0.0,0,3,0.0,2,3247.0,10:49,0,0,0,0.0,13,5,0,2,-2,0,0,0,0.0,0:0,0,0,0,83.0,0:16,650000
8474600,Roman,Josi,1990-06-01,D,L,2018-19,82,15,41,56,0.68,9,274,5.47,42,123814.0,25:9,0,1,1,0.0,53,144,36,65,-29,2,10,12,14670.0,2:58,0,1,1,12742.0,2:35,4000000
8474602,Justin,Schultz,1990-07-06,D,R,2018-19,29,2,13,15,0.52,0,47,4.26,4,35672.0,20:30,0,0,0,0.0,25,41,5,27,-22,1,5,6,4178.0,2:24,0,0,0,235.0,0:8,5500000
8474610,Zac,Dalpe,1989-11-01,C,R,2018-19,1,0,1,1,1.0,1,1,0.0,0,541.0,9:1,0,1,1,0.0,0,0,0,0,0,0,0,0,0.0,0:0,0,0,0,0.0,0:0,725000
8474611,Cameron,Gaunce,1990-03-19,D,L,2018-19,2,0,0,0,0.0,3,2,0.0,7,1880.0,15:40,0,0,0,0.0,4,1,2,2,0,0,0,0,0.0,0:0,0,0,0,133.0,1:6,650000
8474612,Travis,Hamonic,1990-08-16,D,R,2018-19,69,7,12,19,0.28,21,128,5.47,33,86384.0,20:51,0,1,1,0.0,44,167,37,62,-25,0,0,0,779.0,0:11,1,2,3,11819.0,2:51,3857143
8474613,Derek,Stepan,1990-06-18,C,R,2018-19,72,15,20,35,0.49,-2,195,7.69,14,83046.0,19:13,651,725,1376,47.31,50,51,50,44,6,1,2,3,11718.0,2:42,3,0,3,8307.0,1:55,6500000
8474618,Marco,Scandella,1990-02-23,D,L,2018-19,63,6,7,13,0.21,-13,83,7.23,26,66567.0,17:36,0,0,0,0.0,53,75,16,41,-25,0,0,0,379.0,0:6,0,1,1,7534.0,1:59,4000000
8474627,Jori,Lehtera,1987-12-23,C,L,2018-19,27,1,2,3,0.11,-7,17,5.88,33,14760.0,9:6,79,67,146,54.11,29,7,6,4,2,0,0,0,119.0,0:4,0,0,0,2450.0,1:30,4700000
8474628,Michael,Stone,1990-06-07,D,R,2018-19,14,0,5,5,0.36,0,12,0.0,10,13386.0,15:56,0,0,0,0.0,27,16,6,6,0,0,0,0,425.0,0:30,0,0,0,1582.0,1:53,3500000
8474641,Adam,Henrique,1990-02-06,C,L,2018-19,82,18,24,42,0.51,-5,122,14.75,24,80940.0,16:27,571,512,1083,52.72,78,71,39,26,13,8,5,13,11361.0,2:18,0,1,1,5406.0,1:5,4000000
8474659,Matt,Donovan,1990-05-09,D,L,2018-19,2,0,1,1,0.5,0,1,0.0,2,887.0,7:23,0,0,0,0.0,0,3,0,0,0,0,0,0,0.0,0:0,0,0,0,0.0,0:0,675000
8474668,Dale,Weise,1988-08-05,RW,R,2018-19,51,5,6,11,0.22,-8,58,8.62,19,36037.0,11:46,6,10,16,37.5,88,21,9,10,-1,0,0,0,314.0,0:6,1,0,1,3966.0,1:17,2350000
8474673,TJ,Brodie,1990-06-07,D,L,2018-19,79,9,25,34,0.43,29,102,8.82,24,101773.0,21:28,0,1,1,0.0,21,86,68,100,-32,1,3,4,4628.0,0:58,1,0,1,9201.0,1:56,4650400
8474679,Gustav,Nyquist,1989-09-01,RW,L,2018-19,81,22,38,60,0.74,1,204,10.78,12,85146.0,17:31,11,11,22,50.0,36,23,42,74,-32,2,10,12,10476.0,2:9,0,0,0,118.0,0:1,4750000
8474683,Derek,Grant,1990-04-20,C,L,2018-19,56,4,10,14,0.25,-6,74,5.41,14,39267.0,11:41,271,244,515,52.62,92,29,19,14,5,0,0,0,310.0,0:5,0,1,1,5504.0,1:38,650000
8474685,Matt,Calvert,1989-12-24,LW,L,2018-19,82,11,15,26,0.32,-10,141,7.8,58,69824.0,14:11,41,53,94,43.62,115,51,43,20,23,1,1,2,1057.0,0:12,0,2,2,11068.0,2:14,2850000
8474688,Greg,Pateryn,1990-06-20,D,R,2018-19,80,1,6,7,0.09,-11,100,1.0,41,82179.0,17:7,0,1,1,0.0,144,118,14,17,-3,0,0,0,185.0,0:2,0,0,0,8459.0,1:45,2250000
8474697,Mark,Borowiecki,1989-07-12,D,L,2018-19,53,1,4,5,0.09,-12,59,1.69,89,49513.0,15:34,0,0,0,0.0,212,93,14,26,-12,0,0,0,57.0,0:1,0,0,0,4683.0,1:28,1200000
8474709,Matt,Martin,1989-05-08,LW,L,2018-19,67,6,8,14,0.21,5,62,9.68,53,45962.0,11:26,6,9,15,40.0,275,42,13,19,-6,0,0,0,170.0,0:2,0,0,0,889.0,0:13,2500000
8474715,Cam,Atkinson,1989-06-05,RW,R,2018-19,80,41,28,69,0.86,3,295,13.9,20,93014.0,19:22,24,52,76,31.58,27,25,47,45,2,8,6,14,12892.0,2:41,4,0,4,6425.0,1:20,5875000
8474716,Jared,Spurgeon,1989-11-29,D,R,2018-19,82,14,29,43,0.52,-1,152,9.21,20,118792.0,24:8,1,0,1,100.0,91,145,30,23,7,4,7,11,11959.0,2:25,0,1,1,11543.0,2:20,5187500
8474717,Mark,Barberio,1990-03-23,D,L,2018-19,12,1,0,1,0.08,-6,11,9.09,4,10962.0,15:13,0,0,0,0.0,13,14,3,8,-5,0,0,0,0.0,0:0,0,0,0,1810.0,2:30,1450000
8474722,Luke,Witkowski,1990-04-14,RW,R,2018-19,34,0,2,2,0.06,-5,14,0.0,23,19579.0,9:35,0,0,0,0.0,67,27,3,20,-17,0,0,0,44.0,0:1,0,0,0,1269.0,0:37,750000
8474736,Zac,Rinaldo,1990-06-15,C,L,2018-19,23,1,2,3,0.13,1,11,9.09,20,9832.0,7:7,1,4,5,20.0,47,8,4,2,2,0,0,0,7.0,0:0,0,0,0,0.0,0:0,650000
8474749,Matt,Bartkowski,1988-06-04,D,L,2018-19,2,1,0,1,0.5,2,2,50.0,0,1284.0,10:42,0,0,0,0.0,1,1,0,0,0,0,0,0,0.0,0:0,0,0,0,0.0,0:0,650000
8474774,Dalton,Prout,1990-03-13,D,R,2018-19,20,1,1,2,0.1,1,14,7.14,8,15739.0,13:6,0,0,0,0.0,36,20,4,10,-6,0,0,0,26.0,0:1,0,0,0,1438.0,1:11,800000
8474818,Jordie,Benn,1987-07-26,D,L,2018-19,81,5,17,22,0.27,15,93,5.38,39,88422.0,18:11,0,0,0,0.0,124,128,19,71,-52,0,0,0,114.0,0:1,0,0,0,13508.0,2:46,1100000
8474849,Antoine,Roussel,1989-11-21,LW,L,2018-19,65,9,22,31,0.48,5,84,10.71,118,53660.0,13:45,17,17,34,50.0,87,50,20,20,0,0,0,0,222.0,0:3,0,0,0,3404.0,0:52,3000000
8474870,Tyler,Johnson,1990-07-29,C,R,2018-19,80,29,18,47,0.59,15,163,17.79,28,76552.0,15:56,230,243,473,48.63,50,32,13,32,-19,1,7,8,7651.0,1:35,1,0,1,2255.0,0:28,5000000
8474873,Brian,Lashoff,1990-07-16,D,L,2018-19,4,0,1,1,0.25,-1,2,0.0,2,3278.0,13:39,0,0,0,0.0,3,4,0,0,0,0,0,0,0.0,0:0,0,0,0,297.0,1:14,650000
8474884,Mike,Hoffman,1989-11-24,LW,L,2018-19,82,36,34,70,0.85,-24,253,14.23,30,87762.0,17:50,13,25,38,34.21,42,26,48,98,-50,17,18,35,16922.0,3:26,0,0,0,72.0,0:0,5187500
8475098,Tyler,Bozak,1986-03-19,C,R,2018-19,72,13,25,38,0.53,-3,141,9.22,20,70627.0,16:20,451,379,830,54.34,52,33,30,19,11,2,6,8,10346.0,2:23,0,0,0,5483.0,1:16,5000000
8475149,Marcus,Johansson,1990-10-06,LW,L,2018-19,58,13,17,30,0.52,-16,115,11.3,8,55414.0,15:55,16,34,50,32.0,28,24,27,38,-11,2,7,9,8645.0,2:29,0,0,0,112.0,0:1,4583333
8475151,Kyle,Palmieri,1991-02-01,RW,R,2018-19,74,27,23,50,0.68,-9,224,12.05,42,80609.0,18:9,24,62,86,27.91,98,35,36,37,-1,11,7,18,14639.0,3:17,0,0,0,1306.0,0:17,4650000
8475158,Ryan,O'Reilly,1991-02-07,C,L,2018-19,82,28,49,77,0.94,22,234,11.97,12,102133.0,20:45,1086,824,1910,56.86,31,36,94,33,61,6,16,22,14048.0,2:51,1,2,3,9817.0,1:59,7500000
8475160,Kyle,Clifford,1991-01-13,LW,L,2018-19,72,11,10,21,0.29,4,115,9.57,96,45304.0,10:29,3,5,8,37.5,115,24,11,16,-5,1,0,1,931.0,0:12,0,0,0,55.0,0:0,1600000
8475163,Alex,Chiasson,1990-10-01,RW,R,2018-19,73,22,16,38,0.52,-1,123,17.89,32,74330.0,16:58,7,15,22,31.82,85,31,28,27,1,8,7,15,11476.0,2:37,1,1,2,2689.0,0:36,650000
8475164,Jakob,Silfverberg,1990-10-13,RW,R,2018-19,73,24,19,43,0.59,-9,163,14.72,28,74895.0,17:5,19,32,51,37.25,38,43,27,27,0,3,8,11,9203.0,2:6,2,1,3,7512.0,1:42,3750000
8475166,John,Tavares,1990-09-20,C,L,2018-19,82,47,41,88,1.07,19,286,16.43,34,93919.0,19:5,832,696,1528,54.45,59,53,53,72,-19,10,9,19,12764.0,2:35,0,0,0,973.0,0:11,11000000
8475167,Victor,Hedman,1990-12-18,D,L,2018-19,70,12,42,54,0.77,24,182,6.59,44,95636.0,22:46,0,1,1,0.0,59,97,32,50,-18,2,23,25,13936.0,3:19,0,1,1,8905.0,2:7,7875000
8475168,Matt,Duchene,1991-01-16,C,L,2018-19,73,31,39,70,0.96,-3,172,18.02,8,82494.0,18:50,676,546,1222,55.32,28,40,50,68,-18,6,8,14,11248.0,2:34,0,0,0,742.0,0:10,6000000
8475169,Evander,Kane,1991-08-02,LW,L,2018-19,75,30,26,56,0.75,-4,268,11.19,153,82847.0,18:24,92,120,212,43.4,173,25,48,38,10,5,6,11,8631.0,1:55,1,1,2,4438.0,0:59,7000000
8475170,Brayden,Schenn,1991-08-22,C,L,2018-19,72,17,37,54,0.75,3,159,10.69,40,80308.0,18:35,323,357,680,47.5,111,31,51,42,9,4,8,12,10349.0,2:23,0,0,0,2599.0,0:36,5125000
8475171,Oliver,Ekman-Larsson,1991-07-17,D,L,2018-19,81,14,30,44,0.54,-16,176,7.95,52,114887.0,23:38,0,0,0,0.0,162,52,32,65,-33,5,14,19,17284.0,3:33,1,2,3,6130.0,1:15,5500000
8475172,Nazem,Kadri,1990-10-06,C,L,2018-19,73,16,28,44,0.6,-2,184,8.7,43,70911.0,16:11,403,327,730,55.21,85,13,42,47,-5,4,9,13,11329.0,2:35,0,0,0,71.0,0:0,4500000
8475175,Magnus,Paajarvi,1991-04-12,LW,L,2018-19,80,11,8,19,0.24,-14,119,9.24,6,64650.0,13:28,7,9,16,43.75,65,67,18,16,2,0,0,0,443.0,0:5,1,1,2,9402.0,1:57,900000
8475176,Ryan,Ellis,1991-01-03,D,R,2018-19,82,7,34,41,0.5,21,149,4.7,20,118150.0,24:0,0,0,0,0.0,71,154,54,61,-7,1,4,5,10299.0,2:5,1,0,1,13168.0,2:40,2500000
8475177,Calvin,de Haan,1991-05-09,D,L,2018-19,74,1,13,14,0.19,1,102,0.98,20,82190.0,18:30,0,1,1,0.0,187,106,59,55,4,0,0,0,426.0,0:5,0,0,0,8820.0,1:59,4550000
8475178,Zack,Kassian,1991-01-24,RW,R,2018-19,79,15,11,26,0.33,-6,111,13.51,102,70161.0,14:48,0,6,6,0.0,191,15,35,48,-13,0,0,0,433.0,0:5,1,0,1,5895.0,1:14,1950000
8475179,Dmitry,Kulikov,1990-10-29,D,L,2018-19,57,0,6,6,0.11,4,40,0.0,47,53569.0,15:39,0,0,0,0.0,88,71,19,37,-18,0,0,0,314.0,0:5,0,0,0,3516.0,1:1,4333333
8475181,Nick,Leddy,1991-03-20,D,L,2018-19,82,4,22,26,0.32,0,116,3.45,18,106026.0,21:33,0,0,0,0.0,77,89,18,63,-45,0,10,10,13737.0,2:47,0,0,0,1943.0,0:23,5500000
8475184,Chris,Kreider,1991-04-30,LW,L,2018-19,79,28,24,52,0.66,4,201,13.93,57,82504.0,17:24,27,45,72,37.5,159,49,31,52,-21,7,5,12,12357.0,2:36,0,0,0,294.0,0:3,4625000
8475186,John,Moore,1990-11-19,D,L,2018-19,61,4,9,13,0.21,0,97,4.12,26,68708.0,18:46,0,0,0,0.0,77,76,10,24,-14,2,1,3,1496.0,0:24,0,0,0,7904.0,2:9,2750000
8475188,Brayden,McNabb,1991-01-21,D,L,2018-19,81,4,12,16,0.2,11,84,4.76,52,94666.0,19:28,0,0,0,0.0,200,139,37,38,-1,0,0,0,247.0,0:3,0,1,1,13681.0,2:48,2500000
8475191,Reilly,Smith,1991-04-01,RW,L,2018-19,74,19,34,53,0.72,13,178,10.67,14,81126.0,18:16,5,2,7,71.43,39,33,67,54,13,4,10,14,10903.0,2:27,1,3,4,6845.0,1:32,5000000
8475193,Tomas,Tatar,1990-12-01,LW,L,2018-19,80,25,33,58,0.72,21,195,12.82,34,78765.0,16:24,10,29,39,25.64,77,30,52,44,8,4,4,8,10850.0,2:15,0,0,0,152.0,0:1,5300000
8475197,Tyson,Barrie,1991-07-26,D,R,2018-19,78,14,45,59,0.76,-3,218,6.42,36,101912.0,21:46,0,0,0,0.0,48,93,28,41,-13,2,23,25,18944.0,4:2,0,0,0,303.0,0:3,5500000
8475200,Dmitry,Orlov,1991-07-23,D,L,2018-19,82,3,26,29,0.35,3,101,2.97,33,106451.0,21:38,0,0,0,0.0,137,103,53,80,-27,0,1,1,4002.0,0:48,0,0,0,6751.0,1:22,5100000
8475204,Brandon,Pirri,1991-04-10,RW,L,2018-19,31,12,6,18,0.58,7,82,14.63,6,26872.0,14:26,15,19,34,44.12,29,13,14,11,3,3,1,4,3722.0,2:0,0,0,0,6.0,0:0,650000
8475206,Stefan,Elliott,1991-01-30,D,R,2018-19,3,0,1,1,0.33,1,3,0.0,0,1617.0,8:59,0,0,0,0.0,2,1,0,1,-1,0,0,0,123.0,0:41,0,0,0,0.0,0:0,650000
8475208,Brian,Dumoulin,1991-09-06,D,L,2018-19,76,3,20,23,0.3,31,99,3.03,20,95875.0,21:1,0,0,0,0.0,141,129,39,51,-12,0,0,0,598.0,0:7,0,4,4,10768.0,2:21,4100000
8475209,Richard,Panik,1991-02-07,RW,L,2018-19,75,14,19,33,0.44,-3,140,10.0,44,74738.0,16:36,5,13,18,27.78,137,52,46,39,7,0,2,2,8923.0,1:58,1,0,1,5393.0,1:11,2800000
8475218,Mattias,Ekholm,1990-05-24,D,L,2018-19,80,8,36,44,0.55,27,146,5.48,47,112147.0,23:21,0,0,0,0.0,68,107,32,69,-37,2,5,7,6594.0,1:22,0,2,2,10698.0,2:13,3750000
8475220,Marcus,Foligno,1991-08-10,LW,L,2018-19,82,7,12,19,0.23,-1,91,7.69,55,58893.0,11:58,13,15,28,46.43,206,43,31,13,18,0,1,1,221.0,0:2,0,1,1,8859.0,1:48,2875000
8475222,Sami,Vatanen,1991-06-03,D,R,2018-19,50,4,13,17,0.34,-17,107,3.74,22,65185.0,21:43,0,0,0,0.0,68,77,16,36,-20,3,2,5,6756.0,2:15,0,0,0,5727.0,1:54,4875000
8475225,Craig,Smith,1989-09-05,RW,R,2018-19,76,21,17,38,0.5,11,205,10.24,20,68974.0,15:7,26,28,54,48.15,77,33,43,39,4,4,4,8,11450.0,2:30,0,0,0,44.0,0:0,4250000
8475227,Chris,Wideman,1990-01-07,D,R,2018-19,25,2,5,7,0.28,-12,27,7.41,18,19586.0,13:3,0,0,0,0.0,35,26,3,9,-6,0,1,1,3218.0,2:8,0,0,0,23.0,0:0,1000000
8475231,Casey,Cizikas,1991-02-27,C,L,2018-19,73,20,13,33,0.45,22,111,18.02,36,61424.0,14:1,497,516,1013,49.06,129,68,44,34,10,0,0,0,299.0,0:4,2,1,3,8525.0,1:56,3350000
8475233,David,Savard,1990-10-22,D,R,2018-19,82,8,16,24,0.29,19,124,6.45,36,97139.0,19:44,0,0,0,0.0,122,123,17,38,-21,0,0,0,397.0,0:4,0,0,0,8411.0,1:42,4250000
8475235,Nicolas,Deslauriers,1991-02-22,LW,L,2018-19,48,2,3,5,0.1,-12,48,4.17,22,28909.0,10:2,1,0,1,100.0,135,22,11,9,2,0,0,0,91.0,0:1,1,0,1,1116.0,0:23,950000
8475236,Cody,Eakin,1991-05-24,C,L,2018-19,78,22,19,41,0.53,19,120,18.33,16,71975.0,15:22,479,461,940,50.96,88,35,51,34,17,1,3,4,5234.0,1:7,3,0,3,6200.0,1:19,3850000
8475246,Kevin,Connauton,1990-02-23,D,L,2018-19,50,1,7,8,0.16,-2,75,1.33,22,55055.0,18:21,0,0,0,0.0,108,75,5,24,-19,0,0,0,335.0,0:6,0,2,2,8273.0,2:45,1375000
8475253,Garrett,Wilson,1991-03-16,LW,L,2018-19,50,2,6,8,0.16,2,54,3.7,18,22845.0,7:36,3,4,7,42.86,114,16,5,5,0,0,0,0,44.0,0:0,0,0,0,1754.0,0:35,650000
8475260,Corban,Knight,1990-09-10,C,R,2018-19,23,1,3,4,0.17,-5,15,6.67,0,13356.0,9:40,63,58,121,52.07,9,13,6,2,4,0,0,0,22.0,0:0,0,0,0,1226.0,0:53,650000
8475263,Wade,Megan,1990-07-22,C,L,2018-19,11,0,1,1,0.09,-4,16,0.0,2,5199.0,7:52,28,23,51,54.9,4,4,2,3,-1,0,0,0,0.0,0:0,0,0,0,105.0,0:9,650000
8475268,Gabriel,Bourque,1990-09-23,LW,L,2018-19,55,2,6,8,0.15,3,34,5.88,10,32134.0,9:44,7,13,20,35.0,100,48,11,8,3,0,0,0,84.0,0:1,0,1,1,8253.0,2:30,950000
8475279,Ben,Chiarot,1991-05-09,D,L,2018-19,78,5,15,20,0.26,6,111,4.5,62,87124.0,18:36,0,0,0,0.0,171,139,20,65,-45,0,0,0,127.0,0:1,0,1,1,8142.0,1:44,1400000
8475287,Erik,Haula,1991-03-23,LW,L,2018-19,15,2,5,7,0.47,1,26,7.69,10,14929.0,16:35,78,74,152,51.32,11,6,12,6,6,0,1,1,2124.0,2:21,0,0,0,135.0,0:9,2750000
8475314,Anders,Lee,1990-07-03,LW,L,2018-19,82,28,23,51,0.62,20,204,13.73,58,84072.0,17:5,75,80,155,48.39,103,51,22,29,-7,10,6,16,14022.0,2:51,0,0,0,118.0,0:1,3750000
8475321,Phil,Varone,1990-12-04,C,L,2018-19,47,3,4,7,0.15,-2,34,8.82,8,22315.0,7:54,81,82,163,49.69,23,19,5,11,-6,0,0,0,101.0,0:2,0,0,0,126.0,0:2,650000
8475323,Marcus,Kruger,1990-05-27,C,L,2018-19,74,4,8,12,0.16,-2,74,5.41,30,46243.0,10:24,188,203,391,48.08,51,34,17,11,6,0,0,0,120.0,0:1,0,1,1,7966.0,1:47,3083333
8475324,Nick,Jensen,1990-09-21,D,R,2018-19,80,2,18,20,0.25,4,94,2.13,21,95290.0,19:51,0,0,0,0.0,82,105,27,61,-34,0,0,0,312.0,0:3,0,1,1,11690.0,2:26,812500
8475325,Jordan,Nolan,1989-06-23,C,L,2018-19,14,0,2,2,0.14,2,17,0.0,14,6668.0,7:56,0,1,1,0.0,22,4,1,0,1,0,0,0,19.0,0:1,0,0,0,0.0,0:0,650000
8475343,Nic,Dowd,1990-05-27,C,R,2018-19,64,8,14,22,0.34,10,47,17.02,20,39524.0,10:17,245,227,472,51.91,97,37,29,22,7,0,0,0,46.0,0:0,0,1,1,6345.0,1:39,650000
8475413,Justin,Dowling,1990-10-01,C,L,2018-19,11,0,1,1,0.09,-4,9,0.0,0,8361.0,12:40,31,28,59,52.54,11,7,6,3,3,0,0,0,654.0,0:59,0,0,0,0.0,0:0,650000
8475423,Darren,Archibald,1990-02-09,RW,L,2018-19,12,1,1,2,0.17,-3,10,10.0,12,5310.0,7:22,0,1,1,0.0,10,4,1,3,-2,0,0,0,0.0,0:0,0,0,0,3.0,0:0,650000
8475430,Brandon,Manning,1990-06-04,D,L,2018-19,39,2,2,4,0.1,-15,33,6.06,25,34728.0,14:50,0,0,0,0.0,63,40,7,14,-7,0,0,0,115.0,0:2,0,0,0,4163.0,1:46,2250000
8475455,Brenden,Dillon,1990-11-13,D,L,2018-19,82,1,21,22,0.27,19,71,1.41,61,87296.0,17:44,0,0,0,0.0,202,78,16,38,-22,0,0,0,253.0,0:3,1,0,1,5402.0,1:5,3270000
8475461,Andrew,Agozzino,1991-01-03,LW,L,2018-19,11,1,1,2,0.18,2,11,9.09,0,5155.0,7:48,16,22,38,42.11,14,3,1,4,-3,0,0,0,56.0,0:5,0,0,0,298.0,0:27,650000
8475462,Radko,Gudas,1990-06-05,D,R,2018-19,77,4,16,20,0.26,6,136,2.94,63,82584.0,17:52,0,0,0,0.0,255,133,23,59,-36,0,0,0,83.0,0:1,0,0,0,12126.0,2:37,3350000
8475613,Nate,Prosser,1986-05-07,D,R,2018-19,15,0,0,0,0.0,1,10,0.0,2,9200.0,10:13,0,0,0,0.0,17,13,1,1,0,0,0,0,33.0,0:2,0,0,0,379.0,0:25,650000
8475625,Matt,Irwin,1987-11-29,D,L,2018-19,44,1,6,7,0.16,5,50,2.0,38,29820.0,11:17,0,0,0,0.0,80,37,8,13,-5,0,0,0,1.0,0:0,0,0,0,578.0,0:13,675000
8475690,Christopher,Tanev,1989-12-20,D,R,2018-19,55,2,10,12,0.22,3,51,3.92,18,66553.0,20:10,0,0,0,0.0,29,122,20,32,-12,0,0,0,407.0,0:7,0,0,0,10782.0,3:16,4450000
8475692,Mats,Zuccarello,1987-09-01,RW,L,2018-19,48,12,28,40,0.83,-8,104,11.54,24,57172.0,19:51,10,20,30,33.33,57,43,38,29,9,3,12,15,8630.0,2:59,0,0,0,4363.0,1:30,4500000
8475714,Calle,Jarnkrok,1991-09-25,C,R,2018-19,79,10,16,26,0.33,13,106,9.43,12,73140.0,15:25,166,165,331,50.15,56,22,25,21,4,1,1,2,4385.0,0:55,1,0,1,8320.0,1:45,2000000
8475715,Oscar,Lindberg,1991-10-29,C,L,2018-19,55,9,11,20,0.36,4,91,9.89,28,41165.0,12:28,101,122,223,45.29,104,27,22,25,-3,0,1,1,1380.0,0:25,0,0,0,513.0,0:9,1700000
8475716,Martin,Marincin,1992-02-18,D,L,2018-19,24,1,4,5,0.21,-4,34,2.94,12,21888.0,15:12,0,1,1,0.0,21,21,11,25,-14,0,0,0,43.0,0:1,0,0,0,2061.0,1:25,800000
8475718,Justin,Holl,1992-01-30,D,R,2018-19,11,0,1,1,0.09,-5,6,0.0,2,8238.0,12:28,0,0,0,0.0,9,5,2,6,-4,0,0,0,28.0,0:2,0,0,0,0.0,0:0,675000
8475722,Jason,Zucker,1992-01-16,LW,L,2018-19,81,21,21,42,0.52,-9,214,9.81,28,83007.0,17:4,2,11,13,15.38,87,38,47,31,16,7,7,14,10886.0,2:14,0,0,0,890.0,0:10,5500000
8475726,Tyler,Toffoli,1992-04-24,C,R,2018-19,82,13,21,34,0.41,-16,226,5.75,23,84685.0,17:12,24,27,51,47.06,39,23,44,27,17,3,2,5,10133.0,2:3,0,0,0,6333.0,1:17,4600000
8475727,Ryan,Spooner,1992-01-30,C,L,2018-19,52,3,6,9,0.17,-12,67,4.48,2,35651.0,11:25,59,54,113,52.21,39,7,10,18,-8,0,1,1,3474.0,1:6,0,0,0,3.0,0:0,4000000
8475728,Johan,Larsson,1992-07-25,C,L,2018-19,73,6,8,14,0.19,-8,79,7.59,37,62602.0,14:17,503,490,993,50.65,112,44,29,22,7,0,0,0,354.0,0:4,1,0,1,10308.0,2:21,1475000
8475729,Mark,Alt,1991-10-18,D,R,2018-19,2,0,0,0,0.0,0,2,0.0,0,1189.0,9:54,0,0,0,0.0,0,2,0,0,0,0,0,0,0.0,0:0,0,0,0,49.0,0:24,725000
8475735,Greg,McKegg,1992-06-17,C,L,2018-19,41,6,5,11,0.27,-2,27,22.22,8,26227.0,10:39,146,140,286,51.05,30,18,14,10,4,0,0,0,272.0,0:6,0,0,0,89.0,0:2,715000
8475736,Connor,Brickley,1992-02-25,C,L,2018-19,14,1,3,4,0.29,3,18,5.56,9,7541.0,8:58,0,7,7,0.0,35,6,3,5,-2,0,0,0,0.0,0:0,0,0,0,0.0,0:0,650000
8475738,Jordan,Weal,1992-04-15,C,R,2018-19,63,8,13,21,0.33,-8,75,10.67,18,50887.0,13:27,333,266,599,55.59,28,26,20,19,1,2,4,6,4030.0,1:3,0,0,0,22.0,0:0,1750000
8475744,Evgeny,Kuznetsov,1992-05-19,C,L,2018-19,76,21,51,72,0.95,7,193,10.88,50,85686.0,18:47,396,627,1023,38.71,46,20,46,62,-16,8,15,23,16710.0,3:39,0,0,0,1002.0,0:13,7800000
8475745,Charlie,Coyle,1992-03-02,C,R,2018-19,81,12,22,34,0.42,-1,155,7.74,20,81536.0,16:46,322,380,702,45.87,77,56,42,43,-1,1,3,4,8437.0,1:44,1,0,1,5042.0,1:2,3200000
8475747,Patrik,Nemeth,1992-02-08,D,L,2018-19,74,1,9,10,0.14,5,57,1.75,53,73202.0,16:29,0,0,0,0.0,137,131,4,19,-15,0,0,0,113.0,0:1,0,1,1,14267.0,3:12,2500000
8475750,Jon,Merrill,1992-02-03,D,L,2018-19,57,3,12,15,0.26,16,72,4.17,53,61144.0,17:52,0,0,0,0.0,71,72,16,26,-10,0,0,0,625.0,0:10,1,0,1,4181.0,1:13,1375000
8475752,Tyler,Pitlick,1991-11-01,C,R,2018-19,47,8,4,12,0.26,-2,75,10.67,6,37738.0,13:22,5,7,12,41.67,93,27,11,16,-5,1,0,1,1931.0,0:41,0,0,0,2295.0,0:48,1000000
8475753,Justin,Faulk,1992-03-20,D,R,2018-19,82,11,24,35,0.43,9,217,5.07,47,110325.0,22:25,0,0,0,0.0,156,121,47,66,-19,6,4,10,14471.0,2:56,0,0,0,8483.0,1:43,4833333
8475754,Brock,Nelson,1991-10-15,C,L,2018-19,82,25,28,53,0.65,20,181,13.81,28,88423.0,17:58,594,652,1246,47.67,51,55,54,47,7,2,6,8,11823.0,2:24,1,0,1,3945.0,0:48,4250000
8475755,Alex,Petrovic,1992-03-03,D,R,2018-19,35,0,2,2,0.06,-15,47,0.0,26,34705.0,16:31,0,0,0,0.0,116,53,9,28,-19,0,0,0,336.0,0:9,0,0,0,2708.0,1:17,1950000
8475758,Devante,Smith-Pelly,1992-06-14,RW,R,2018-19,54,4,4,8,0.15,-6,60,6.67,15,35167.0,10:51,16,25,41,39.02,78,36,7,9,-2,0,0,0,122.0,0:2,0,0,0,5388.0,1:39,1000000
8475760,Nick,Bjugstad,1992-07-17,C,R,2018-19,64,14,12,26,0.41,6,154,9.09,30,58057.0,15:7,262,268,530,49.43,126,27,37,39,-2,2,4,6,5749.0,1:29,0,0,0,99.0,0:1,4100000
8475762,Derek,Forbort,1992-03-04,D,L,2018-19,81,2,12,14,0.17,-13,75,2.67,52,100806.0,20:44,0,1,1,0.0,105,139,15,78,-63,0,0,0,259.0,0:3,0,0,0,11109.0,2:17,2525000
8475763,Kevin,Hayes,1992-05-08,C,L,2018-19,71,19,36,55,0.77,-2,156,12.18,12,77873.0,18:16,483,498,981,49.24,58,15,61,60,1,3,8,11,9065.0,2:7,2,1,3,7593.0,1:46,5175000
8475764,Cam,Fowler,1991-12-05,D,L,2018-19,59,5,18,23,0.39,-14,88,5.68,20,82722.0,23:22,0,0,0,0.0,32,91,24,43,-19,1,5,6,8884.0,2:30,0,1,1,5332.0,1:30,6500000
8475765,Vladimir,Tarasenko,1991-12-13,RW,L,2018-19,76,33,35,68,0.89,8,275,12.0,22,83902.0,18:23,4,2,6,66.67,88,40,34,31,3,12,10,22,13290.0,2:54,0,0,0,282.0,0:3,7500000
8475766,Austin,Watson,1992-01-13,LW,R,2018-19,37,7,9,16,0.43,11,64,10.94,39,32175.0,14:29,7,9,16,43.75,109,28,12,13,-1,1,0,1,155.0,0:4,0,0,0,3810.0,1:42,1100000
8475768,Jaden,Schwartz,1992-06-25,LW,L,2018-19,69,11,25,36,0.52,-6,183,6.01,16,75050.0,18:7,18,19,37,48.65,61,27,47,28,19,2,3,5,9363.0,2:15,0,0,0,2385.0,0:34,5350000
8475772,Riley,Sheahan,1991-12-07,C,L,2018-19,82,9,10,19,0.23,-9,110,8.18,17,66231.0,13:27,360,328,688,52.33,72,44,49,23,26,0,0,0,250.0,0:3,1,1,2,9797.0,1:59,2100000
8475780,Chris,Wagner,1991-05-27,RW,R,2018-19,76,12,7,19,0.25,3,135,8.89,51,61344.0,13:27,54,66,120,45.0,247,38,21,21,0,0,0,0,224.0,0:2,0,0,0,6604.0,1:26,1250000
8475784,Jeff,Skinner,1992-05-16,LW,L,2018-19,82,40,23,63,0.77,0,268,14.93,36,91109.0,18:31,157,144,301,52.16,31,24,56,39,17,8,8,16,15156.0,3:4,0,0,0,145.0,0:1,5725000
8475786,Zach,Hyman,1992-06-09,C,R,2018-19,71,21,20,41,0.58,16,144,14.58,65,73594.0,17:16,113,124,237,47.68,102,39,30,28,2,0,0,0,1072.0,0:15,1,0,1,9658.0,2:16,2250000
8475790,Erik,Gudbranson,1992-01-07,D,R,2018-19,76,2,8,10,0.13,-20,94,2.13,87,83132.0,18:13,0,0,0,0.0,184,84,10,31,-21,0,0,0,203.0,0:2,0,1,1,9346.0,2:2,4000000
8475791,Taylor,Hall,1991-11-14,LW,L,2018-19,33,11,26,37,1.12,-6,113,9.73,16,38980.0,19:41,26,32,58,44.83,22,29,31,39,-8,1,11,12,6731.0,3:23,0,0,0,84.0,0:2,6000000
8475792,Brett,Connolly,1992-05-02,RW,R,2018-19,81,22,24,46,0.57,13,139,15.83,24,64784.0,13:19,9,22,31,29.03,53,25,33,25,8,1,1,2,4559.0,0:56,0,0,0,83.0,0:1,1500000
8475793,Ryan,Johansen,1992-07-31,C,R,2018-19,80,14,50,64,0.8,7,136,10.29,42,93865.0,19:33,782,679,1461,53.52,95,23,43,66,-23,0,16,16,14603.0,3:2,1,1,2,6846.0,1:25,8000000
8475794,Tyler,Seguin,1992-01-31,C,R,2018-19,82,33,47,80,0.98,17,334,9.88,18,102082.0,20:44,676,579,1255,53.86,74,47,47,55,-8,9,18,27,14701.0,2:59,0,0,0,4271.0,0:52,5750000
8475795,Dylan,McIlrath,1992-04-20,D,R,2018-19,7,0,0,0,0.0,2,6,0.0,4,6379.0,15:11,0,0,0,0.0,19,7,2,2,0,0,0,0,0.0,0:0,0,0,0,788.0,1:52,650000
8475796,Mark,Pysyk,1992-01-11,D,R,2018-19,70,1,10,11,0.16,-1,64,1.56,26,76730.0,18:16,0,0,0,0.0,133,89,35,72,-37,0,0,0,210.0,0:3,0,1,1,7343.0,1:44,2733333
8475798,Mikael,Granlund,1992-02-26,RW,L,2018-19,79,16,38,54,0.68,-8,189,8.47,24,86948.0,18:20,129,159,288,44.79,46,40,47,34,13,2,18,20,12148.0,2:33,2,0,2,2941.0,0:37,5750000
8475799,Nino,Niederreiter,1992-09-08,RW,L,2018-19,82,23,30,53,0.65,-4,184,12.5,30,79828.0,16:13,37,30,67,55.22,94,20,51,39,12,6,9,15,11092.0,2:15,0,0,0,100.0,0:1,5250000
8475807,Joakim,Nordstrom,1992-02-25,LW,L,2018-19,70,7,5,12,0.17,0,103,6.8,13,56617.0,13:28,48,77,125,38.4,86,52,26,19,7,0,0,0,439.0,0:6,0,0,0,6909.0,1:38,1000000
8475808,Michael,Chaput,1992-04-09,C,L,2018-19,32,0,5,5,0.16,-4,31,0.0,14,21548.0,11:13,124,120,244,50.82,53,17,7,8,-1,0,0,0,36.0,0:1,0,0,0,3794.0,1:58,675000
8475810,Bryan,Rust,1992-05-11,RW,R,2018-19,72,18,17,35,0.49,10,141,12.77,24,68707.0,15:54,8,16,24,33.33,119,59,30,27,3,0,0,0,533.0,0:7,2,2,4,8521.0,1:58,3500000
8475820,Joonas,Donskoi,1992-04-13,RW,R,2018-19,80,14,23,37,0.46,10,115,12.17,10,64431.0,13:25,1,9,10,10.0,36,36,24,38,-14,1,2,3,2844.0,0:35,0,0,0,224.0,0:2,1900000
8475832,Tom,Kuhnhackl,1992-01-21,RW,L,2018-19,36,4,5,9,0.25,1,30,13.33,10,27393.0,12:40,0,2,2,0.0,48,41,8,16,-8,0,0,0,173.0,0:4,0,1,1,2174.0,1:0,700000
8475834,Marcus,Sorensen,1992-04-07,LW,L,2018-19,80,17,13,30,0.38,10,100,17.0,23,62221.0,12:57,12,19,31,38.71,88,29,33,21,12,0,0,0,1456.0,0:18,1,1,2,5072.0,1:3,700000
8475841,Tim,Heed,1991-01-27,D,R,2018-19,37,2,11,13,0.35,9,41,4.88,10,31898.0,14:22,0,0,0,0.0,16,31,11,23,-12,1,2,3,3053.0,1:22,0,0,0,62.0,0:1,650000
8475842,Sam,Carrick,1992-02-04,C,R,2018-19,6,0,1,1,0.17,-1,5,0.0,2,3679.0,10:13,19,18,37,51.35,15,2,1,1,0,0,0,0,0.0,0:0,0,0,0,86.0,0:14,650000
8475844,Kenny,Agostino,1992-04-30,LW,L,2018-19,63,6,18,24,0.38,-3,79,7.59,34,48826.0,12:55,15,27,42,35.71,143,14,25,30,-5,0,5,5,4615.0,1:13,0,0,0,192.0,0:3,700000
8475848,Brendan,Gallagher,1992-05-06,RW,R,2018-19,82,33,19,52,0.63,10,302,10.93,49,80673.0,16:23,23,28,51,45.1,126,31,57,30,27,4,3,7,12091.0,2:27,0,0,0,150.0,0:1,3750000
8475855,Jesper,Fast,1991-12-02,RW,R,2018-19,66,8,12,20,0.3,-3,80,10.0,26,62253.0,15:43,7,13,20,35.0,120,47,25,24,1,0,0,0,476.0,0:7,0,0,0,6842.0,1:43,1850000
8475857,Kevin,Gravel,1992-03-06,D,L,2018-19,36,0,3,3,0.08,-2,44,0.0,4,31772.0,14:42,0,0,0,0.0,31,53,7,18,-11,0,0,0,25.0,0:0,0,0,0,3464.0,1:36,700000
8475868,Anthony,Bitetto,1990-07-15,D,L,2018-19,36,0,3,3,0.08,-7,30,0.0,12,25758.0,11:55,0,0,0,0.0,80,36,6,13,-7,0,0,0,77.0,0:2,0,0,0,249.0,0:6,650000
8475869,Brandon,Davidson,1991-08-21,D,L,2018-19,10,0,1,1,0.1,-4,7,0.0,15,8276.0,13:47,0,0,0,0.0,17,15,2,3,-1,0,0,0,31.0,0:3,0,0,0,806.0,1:20,650000
8475902,Zach,Trotman,1990-08-26,D,R,2018-19,13,0,1,1,0.08,4,16,0.0,4,11907.0,15:15,0,0,0,0.0,20,18,2,5,-3,0,1,1,960.0,1:13,0,0,0,476.0,0:36,650000
8475906,John,Klingberg,1992-08-14,D,R,2018-19,64,10,35,45,0.7,6,153,6.54,12,94197.0,24:31,0,0,0,0.0,42,77,26,79,-53,5,15,20,11443.0,2:58,0,0,0,2907.0,0:45,4250000
8475907,Micheal,Ferland,1992-04-20,LW,L,2018-19,71,17,23,40,0.56,13,156,10.9,58,60044.0,14:5,23,50,73,31.51,182,19,36,48,-12,6,7,13,8282.0,1:56,0,0,0,99.0,0:1,1750000
8475913,Mark,Stone,1992-05-13,RW,R,2018-19,77,33,40,73,0.95,17,199,16.58,27,91870.0,19:53,28,34,62,45.16,72,71,122,62,60,6,14,20,11730.0,2:32,1,0,1,5155.0,1:6,7350000
8475982,Erik,Burgdoerfer,1988-12-11,D,R,2018-19,4,0,0,0,0.0,-1,2,0.0,2,2561.0,10:40,0,0,0,0.0,16,0,0,2,-2,0,0,0,36.0,0:9,0,0,0,67.0,0:16,650000
8476043,Ben,Street,1987-02-13,C,L,2018-19,21,3,2,5,0.24,-4,19,15.79,2,15205.0,12:4,16,27,43,37.21,19,9,4,4,0,0,0,0,100.0,0:4,0,0,0,2505.0,1:59,750000
8476166,Taylor,Fedun,1988-06-04,D,R,2018-19,54,4,7,11,0.2,2,86,4.65,14,44898.0,13:51,0,0,0,0.0,19,58,14,37,-23,0,2,2,754.0,0:13,0,1,1,3121.0,0:57,650000
8476177,Matt,Read,1986-06-14,RW,R,2018-19,12,1,0,1,0.08,-2,13,7.69,2,8463.0,11:45,2,4,6,33.33,11,8,5,4,1,0,0,0,118.0,0:9,0,0,0,440.0,0:36,650000
8476191,Kevan,Miller,1987-11-15,D,R,2018-19,39,0,7,7,0.18,8,32,0.0,35,41524.0,17:44,0,0,0,0.0,73,79,18,20,-2,0,0,0,131.0,0:3,0,0,0,4151.0,1:46,2500000
8476195,Cory,Conacher,1989-12-14,C,L,2018-19,1,0,0,0,0.0,0,1,0.0,2,515.0,8:35,0,0,0,0.0,0,0,0,1,-1,0,0,0,9.0,0:9,0,0,0,0.0,0:0,650000
8476207,Brian,Gibbons,1988-02-26,LW,L,2018-19,64,8,11,19,0.3,-5,50,16.0,20,41925.0,10:55,13,25,38,34.21,40,29,26,23,3,0,0,0,131.0,0:2,0,0,0,2977.0,0:46,1000000
8476278,Colin,Blackwell,1993-03-28,C,R,2018-19,6,0,0,0,0.0,-1,5,0.0,2,3506.0,9:44,13,16,29,44.83,10,3,2,3,-1,0,0,0,33.0,0:5,0,0,0,0.0,0:0,675000
8476285,Matthew,Peca,1993-04-27,C,L,2018-19,39,3,7,10,0.26,-14,35,8.57,4,24627.0,10:31,80,89,169,47.34,33,21,12,12,0,0,0,0,99.0,0:2,0,1,1,2916.0,1:14,1300000
8476288,Ryan,Dzingel,1992-03-09,LW,L,2018-19,78,26,30,56,0.72,-9,159,16.35,29,78694.0,16:48,39,56,95,41.05,54,38,25,39,-14,5,6,11,8298.0,1:46,0,0,0,63.0,0:0,1800000
8476292,Ondrej,Palat,1991-03-28,LW,L,2018-19,64,8,26,34,0.53,4,100,8.0,20,57168.0,14:53,2,15,17,11.76,104,34,18,41,-23,2,6,8,7712.0,2:0,0,0,0,575.0,0:8,5300000
8476293,Scott,Wilson,1992-04-24,C,L,2018-19,15,0,3,3,0.2,-8,25,0.0,4,10305.0,11:27,1,2,3,33.33,29,2,4,4,0,0,0,0,4.0,0:0,0,0,0,1166.0,1:17,1050000
8476310,Lukas,Sedlak,1993-02-25,C,L,2018-19,47,4,2,6,0.13,-5,43,9.3,10,25377.0,8:59,43,44,87,49.43,69,20,6,8,-2,0,0,0,168.0,0:3,0,0,0,1633.0,0:34,825000
8476312,Josh,Manson,1991-10-07,D,R,2018-19,74,3,13,16,0.22,-8,96,3.12,62,99043.0,22:18,0,0,0,0.0,184,90,36,77,-41,0,0,0,576.0,0:7,0,1,1,14100.0,3:10,4100000
8476323,Max,McCormick,1992-05-01,LW,L,2018-19,14,1,0,1,0.07,-6,12,8.33,4,6300.0,7:30,0,1,1,0.0,21,6,1,3,-2,0,0,0,24.0,0:1,0,0,0,231.0,0:16,650000
8476326,Josh,Archibald,1992-10-06,RW,R,2018-19,68,12,10,22,0.32,1,92,13.04,15,55357.0,13:34,12,25,37,32.43,161,39,18,8,10,0,0,0,250.0,0:3,0,1,1,6531.0,1:36,675000
8476329,Travis,Boyd,1993-09-14,C,L,2018-19,53,5,15,20,0.38,6,35,14.29,6,31254.0,9:49,76,134,210,36.19,13,21,14,15,-1,0,2,2,839.0,0:15,0,0,0,1819.0,0:34,800000
8476331,Dylan,DeMelo,1993-05-01,D,R,2018-19,77,4,18,22,0.29,-1,109,3.67,32,89093.0,19:17,0,0,0,0.0,121,130,16,55,-39,0,3,3,2197.0,0:28,0,1,1,7677.0,1:39,900000
8476346,Johnny,Gaudreau,1993-08-13,LW,L,2018-19,82,36,63,99,1.21,18,245,14.69,24,98765.0,20:4,1,2,3,33.33,12,12,58,124,-66,6,21,27,16410.0,3:20,0,0,0,244.0,0:2,6750000
8476356,Tobias,Rieder,1993-01-10,C,L,2018-19,67,0,11,11,0.16,-8,92,0.0,8,50829.0,12:38,5,20,25,20.0,69,44,35,12,23,0,2,2,1441.0,0:21,0,0,0,5332.0,1:19,2000000
8476368,Fredrik,Claesson,1992-11-24,D,L,2018-19,37,2,4,6,0.16,3,44,4.55,9,38291.0,17:14,0,0,0,0.0,76,33,9,31,-22,0,0,0,11.0,0:0,0,1,1,3514.0,1:34,700000
8476370,Blake,Pietila,1993-02-20,LW,L,2018-19,19,0,1,1,0.05,-7,22,0.0,6,15121.0,13:15,36,46,82,43.9,36,8,9,2,7,0,0,0,733.0,0:38,0,0,0,960.0,0:50,667500
8476372,Nick,Seeler,1993-06-03,D,L,2018-19,71,2,5,7,0.1,-4,67,2.99,64,52538.0,12:19,0,0,0,0.0,78,116,5,18,-13,0,0,0,125.0,0:1,0,0,0,3312.0,0:46,725000
8476374,Sean,Kuraly,1993-01-20,C,L,2018-19,71,8,13,21,0.3,6,134,5.97,38,58678.0,13:46,286,245,531,53.86,129,35,34,32,2,0,0,0,254.0,0:3,0,0,0,5572.0,1:18,1275000
8476381,Andrew,Shaw,1991-07-20,RW,R,2018-19,63,19,28,47,0.75,17,135,14.07,71,60159.0,15:54,181,203,384,47.14,128,36,16,24,-8,3,3,6,7699.0,2:2,0,0,0,2789.0,0:44,3900000
8476389,Vincent,Trocheck,1993-07-11,C,R,2018-19,55,10,24,34,0.62,-9,158,6.33,54,64876.0,19:39,498,463,961,51.82,112,42,55,57,-2,3,10,13,8131.0,2:27,1,0,1,5410.0,1:38,4750000
8476392,Adam,Lowry,1993-03-29,C,L,2018-19,78,12,11,23,0.29,6,105,11.43,33,68507.0,14:38,643,473,1116,57.62,223,49,42,23,19,0,0,0,495.0,0:6,1,2,3,10587.0,2:15,2916667
8476393,Nick,Cousins,1993-07-20,C,L,2018-19,81,7,20,27,0.33,-8,144,4.86,35,65827.0,13:32,243,277,520,46.73,115,51,39,22,17,1,2,3,4220.0,0:52,0,0,0,61.0,0:0,1000000
8476396,Steven,Fogarty,1993-04-19,C,R,2018-19,10,0,0,0,0.0,-1,9,0.0,0,4656.0,7:45,8,19,27,29.63,6,3,4,3,1,0,0,0,0.0,0:0,0,0,0,0.0,0:0,708750
8476399,Blake,Coleman,1991-11-28,C,L,2018-19,78,22,14,36,0.46,-19,213,10.33,71,79617.0,17:0,109,153,262,41.6,225,44,50,36,14,3,0,3,3429.0,0:43,3,2,5,12588.0,2:41,1800000
8476407,Andy,Welinski,1993-04-27,D,R,2018-19,26,1,3,4,0.15,-5,32,3.12,8,25022.0,16:2,0,0,0,0.0,47,18,6,15,-9,0,0,0,1147.0,0:44,0,0,0,181.0,0:6,690000
8476409,Alan,Quine,1993-02-25,C,L,2018-19,13,3,2,5,0.38,0,11,27.27,6,7408.0,9:29,13,20,33,39.39,14,2,3,5,-2,1,0,1,179.0,0:13,0,0,0,0.0,0:0,700000
8476410,Josh,Leivo,1993-05-26,LW,R,2018-19,76,14,10,24,0.32,5,151,9.27,32,63977.0,14:1,15,26,41,36.59,44,23,37,32,5,3,4,7,10375.0,2:16,0,0,0,34.0,0:0,925000
8476415,Kyle,Rau,1992-10-24,C,L,2018-19,6,0,1,1,0.17,0,6,0.0,0,2525.0,7:0,3,1,4,75.0,11,2,1,1,0,0,0,0,0.0,0:0,0,0,0,0.0,0:0,700000
8476419,Jean-Gabriel,Pageau,1992-11-11,C,R,2018-19,39,4,8,12,0.31,-12,83,4.82,14,41757.0,17:50,259,222,481,53.85,63,38,21,22,-1,0,0,0,2130.0,0:54,0,0,0,4663.0,1:59,3100000
8476422,Mike,Reilly,1993-07-13,D,L,2018-19,57,3,8,11,0.19,0,101,2.97,16,63871.0,18:40,0,0,0,0.0,48,53,13,56,-43,1,0,1,4841.0,1:24,0,0,0,1723.0,0:30,725000
8476427,Ty,Rattie,1993-02-05,RW,R,2018-19,50,4,7,11,0.22,-2,84,4.76,4,34037.0,11:20,1,2,3,33.33,57,7,22,12,10,0,1,1,2651.0,0:53,0,0,0,7.0,0:0,800000
8476428,Rocco,Grimaldi,1993-02-08,C,R,2018-19,53,5,8,13,0.25,-2,81,6.17,10,31820.0,10:0,4,3,7,57.14,32,20,27,15,12,0,0,0,91.0,0:1,0,0,0,56.0,0:1,650000
8476429,Scott,Mayfield,1992-10-14,D,R,2018-19,79,4,15,19,0.24,18,104,3.85,68,88801.0,18:44,0,1,1,0.0,118,159,10,72,-62,0,0,0,143.0,0:1,1,0,1,11020.0,2:19,1450000
8476431,Adam,Clendening,1992-10-26,D,R,2018-19,4,0,0,0,0.0,1,3,0.0,0,2557.0,10:39,0,0,0,0.0,1,3,2,0,2,0,0,0,69.0,0:17,0,0,0,360.0,1:30,700000
8476432,Boone,Jenner,1993-06-15,C,L,2018-19,77,16,22,38,0.49,6,170,9.41,42,78838.0,17:3,626,531,1157,54.11,158,70,42,21,21,1,2,3,7382.0,1:35,1,0,1,6742.0,1:27,3750000
8476436,Dmitrij,Jaskin,1993-03-23,RW,L,2018-19,37,2,6,8,0.22,-5,48,4.17,6,22387.0,10:5,0,3,3,0.0,87,14,13,6,7,0,0,0,40.0,0:1,0,0,0,521.0,0:14,1100000
8476437,Victor,Rask,1993-03-01,C,L,2018-19,49,3,6,9,0.18,-4,55,5.45,8,35585.0,12:6,204,226,430,47.44,40,12,13,18,-5,0,2,2,4476.0,1:31,0,0,0,128.0,0:2,4000000
8476438,Brandon,Saad,1992-10-27,LW,L,2018-19,80,23,24,47,0.59,-9,195,11.79,12,84905.0,17:41,24,38,62,38.71,52,25,35,36,-1,5,1,6,7075.0,1:28,3,0,3,8080.0,1:41,6000000
8476439,Brett,Ritchie,1993-07-01,RW,R,2018-19,53,4,2,6,0.11,-7,57,7.02,57,30543.0,9:36,2,7,9,22.22,126,13,7,12,-5,1,0,1,2076.0,0:39,0,0,0,73.0,0:1,1750000
8476440,Markus,Granlund,1993-04-16,C,L,2018-19,77,12,10,22,0.29,-4,123,9.76,20,69495.0,15:2,149,199,348,42.82,46,24,32,9,23,2,1,3,7296.0,1:34,0,1,1,11100.0,2:24,1475000
8476441,Joel,Edmundson,1993-06-28,D,L,2018-19,64,2,9,11,0.17,8,102,1.96,68,74446.0,19:23,0,1,1,0.0,128,106,9,41,-32,0,0,0,490.0,0:7,0,0,0,7974.0,2:4,3000000
8476442,Matt,Nieto,1992-11-05,LW,L,2018-19,64,4,19,23,0.36,2,86,4.65,8,52879.0,13:46,9,8,17,52.94,50,26,19,11,8,0,0,0,214.0,0:3,1,2,3,10094.0,2:37,1975000
8476443,Xavier,Ouellet,1993-07-29,D,L,2018-19,19,0,3,3,0.16,-3,32,0.0,13,19393.0,17:0,0,0,0,0.0,32,30,5,10,-5,0,0,0,85.0,0:4,0,0,0,1529.0,1:20,1250000
8476447,Miikka,Salomaki,1993-03-09,RW,L,2018-19,37,3,4,7,0.19,5,51,5.88,8,23212.0,10:27,2,5,7,28.57,72,20,6,5,1,0,0,0,66.0,0:1,0,0,0,254.0,0:6,750000
8476448,William,Karlsson,1993-01-08,C,L,2018-19,82,24,32,56,0.68,1,169,14.2,16,92727.0,18:50,588,646,1234,47.65,51,55,73,41,32,7,7,14,11980.0,2:26,1,2,3,7528.0,1:31,5250000
8476449,Scott,Harrington,1993-03-10,D,L,2018-19,73,2,15,17,0.23,6,54,3.7,23,57149.0,13:2,0,0,0,0.0,73,81,9,18,-9,0,0,0,54.0,0:0,0,0,0,4024.0,0:55,675000
8476453,Nikita,Kucherov,1993-06-17,RW,L,2018-19,82,41,87,128,1.56,24,246,16.67,62,98230.0,19:57,0,3,3,0.0,44,31,58,89,-31,15,33,48,18341.0,3:43,0,0,0,251.0,0:3,4766667
8476454,Ryan,Nugent-Hopkins,1993-04-12,C,L,2018-19,82,28,41,69,0.84,-13,208,13.46,26,98903.0,20:6,379,461,840,45.12,69,40,59,56,3,8,18,26,15949.0,3:14,1,2,3,8343.0,1:41,6000000
8476455,Gabriel,Landeskog,1992-11-23,LW,L,2018-19,73,34,41,75,1.03,17,243,13.99,51,92631.0,21:8,361,333,694,52.02,120,64,46,47,-1,10,17,27,17953.0,4:5,0,0,0,1313.0,0:17,5571429
8476456,Jonathan,Huberdeau,1993-06-04,LW,L,2018-19,82,30,62,92,1.12,-14,226,13.27,40,92759.0,18:51,12,7,19,63.16,57,45,43,84,-41,11,23,34,16798.0,3:24,0,0,0,840.0,0:10,5900000
8476457,Adam,Larsson,1992-11-12,D,R,2018-19,82,3,17,20,0.24,-28,117,2.56,44,106386.0,21:37,0,0,0,0.0,256,128,25,68,-43,0,0,0,355.0,0:4,0,1,1,9881.0,2:0,4166666
8476458,Ryan,Strome,1993-07-11,C,R,2018-19,81,19,16,35,0.43,-3,110,17.27,64,75673.0,15:34,365,402,767,47.59,76,36,37,53,-16,4,3,7,6489.0,1:20,0,0,0,5394.0,1:6,3100000
8476459,Mika,Zibanejad,1993-04-18,C,R,2018-19,82,30,44,74,0.9,-12,236,12.71,47,101148.0,20:33,831,842,1673,49.67,134,66,69,69,0,11,12,23,13999.0,2:50,2,0,2,9760.0,1:59,5350000
8476460,Mark,Scheifele,1993-03-15,C,R,2018-19,82,38,46,84,1.02,8,199,19.1,38,107562.0,21:51,803,933,1736,46.26,54,54,74,48,26,12,11,23,17708.0,3:35,0,3,3,5583.0,1:8,6125000
8476461,Sean,Couturier,1992-12-07,C,L,2018-19,80,33,43,76,0.95,2,223,14.8,34,106210.0,22:7,755,568,1323,57.07,40,60,47,48,-1,8,9,17,14916.0,3:6,1,0,1,11091.0,2:18,4333333
8476462,Dougie,Hamilton,1993-06-17,D,R,2018-19,82,18,21,39,0.48,0,259,6.95,54,96789.0,19:40,0,1,1,0.0,160,91,35,66,-31,2,5,7,9162.0,1:51,0,0,0,1241.0,0:15,5750000
8476463,Jonas,Brodin,1993-07-12,D,L,2018-19,82,4,14,18,0.22,-15,111,3.6,30,101073.0,20:32,0,0,0,0.0,61,135,29,20,9,0,1,1,1317.0,0:16,1,0,1,10373.0,2:6,4166667
8476465,Ryan,Murphy,1993-03-31,D,R,2018-19,3,0,1,1,0.33,1,1,0.0,0,2010.0,11:10,0,0,0,0.0,1,3,1,0,1,0,1,1,172.0,0:57,0,0,0,1.0,0:0,650000
8476466,Sven,Baertschi,1992-10-05,LW,L,2018-19,26,9,5,14,0.54,-9,43,20.93,6,23615.0,15:8,1,3,4,25.0,18,13,10,6,4,3,4,7,4656.0,2:59,0,0,0,26.0,0:1,3366666
8476467,Jamie,Oleksiak,1992-12-21,D,L,2018-19,57,4,8,12,0.21,5,55,7.27,45,50382.0,14:43,0,0,0,0.0,135,59,10,38,-28,0,0,0,273.0,0:4,0,0,0,1275.0,0:22,2137500
8476468,J.T.,Miller,1993-03-14,C,L,2018-19,75,13,34,47,0.63,8,108,12.04,32,65992.0,14:39,259,265,524,49.43,115,23,42,38,4,4,16,20,11599.0,2:34,0,0,0,131.0,0:1,5250000
8476469,Joel,Armia,1993-05-31,RW,R,2018-19,57,13,10,23,0.4,0,134,9.7,14,54014.0,15:47,5,24,29,17.24,113,21,46,32,14,2,4,6,5937.0,1:44,1,0,1,5350.0,1:33,1850000
8476470,Nathan,Beaulieu,1992-12-05,D,L,2018-19,48,3,9,12,0.25,6,60,5.0,39,44658.0,15:30,0,0,0,0.0,60,42,9,22,-13,0,1,1,686.0,0:14,0,0,0,1784.0,0:37,2400000
8476472,Oscar,Klefbom,1993-07-20,D,L,2018-19,61,5,23,28,0.46,-11,167,2.99,16,87762.0,23:58,0,0,0,0.0,44,102,26,51,-25,1,10,11,9713.0,2:39,0,0,0,6573.0,1:47,4167000
8476473,Connor,Murphy,1993-03-26,D,R,2018-19,52,5,8,13,0.25,12,84,5.95,40,60805.0,19:29,0,0,0,0.0,119,91,14,48,-34,0,0,0,91.0,0:1,0,0,0,6528.0,2:5,3850000
8476474,Stefan,Noesen,1993-02-12,RW,R,2018-19,41,3,5,8,0.2,-19,64,4.69,28,31321.0,12:43,23,33,56,41.07,95,21,17,9,8,0,0,0,1686.0,0:41,0,0,0,49.0,0:1,1725000
8476476,Joe,Morrow,1992-12-09,D,L,2018-19,41,1,6,7,0.17,0,40,2.5,20,34340.0,13:57,0,0,0,0.0,37,37,5,28,-23,0,0,0,39.0,0:0,0,0,0,532.0,0:12,1000000
8476477,Matt,Puempel,1993-01-24,LW,L,2018-19,8,1,0,1,0.12,-2,10,10.0,2,4993.0,10:24,0,2,2,0.0,4,5,0,2,-2,1,0,1,341.0,0:42,0,0,0,6.0,0:0,675000
8476479,Phillip,Danault,1993-02-24,C,L,2018-19,81,12,41,53,0.65,17,132,9.09,39,86398.0,17:46,882,706,1588,55.54,95,60,49,53,-4,0,4,4,2345.0,0:28,0,2,2,12152.0,2:30,3083333
8476480,Vladislav,Namestnikov,1992-11-22,C,L,2018-19,78,11,20,31,0.4,-7,119,9.24,44,73908.0,15:47,22,32,54,40.74,140,62,32,46,-14,1,2,3,6510.0,1:23,2,3,5,7697.0,1:38,4000000
8476483,Rickard,Rakell,1993-05-05,C,R,2018-19,69,18,25,43,0.62,-13,194,9.28,27,76477.0,18:28,17,31,48,35.42,82,38,41,60,-19,6,7,13,10142.0,2:26,0,0,0,1830.0,0:26,3789444
8476525,Colin,Miller,1992-10-29,D,R,2018-19,65,3,26,29,0.45,0,131,2.29,44,76619.0,19:38,0,0,0,0.0,122,64,22,46,-24,1,12,13,9273.0,2:22,0,0,0,2282.0,0:35,3875000
8476539,Jonathan,Marchessault,1990-12-27,C,R,2018-19,82,25,34,59,0.72,2,278,8.99,52,89281.0,18:8,92,155,247,37.25,98,22,51,68,-17,5,11,16,13236.0,2:41,0,0,0,83.0,0:1,5000000
8476545,Kurtis,Gabriel,1993-04-20,RW,R,2018-19,22,2,2,4,0.18,0,7,28.57,59,9732.0,7:22,0,0,0,0.0,78,8,2,4,-2,0,0,0,27.0,0:1,0,0,0,5.0,0:0,650000
8476617,Tomas,Hyka,1993-03-23,RW,R,2018-19,17,1,3,4,0.24,-2,22,4.55,2,12001.0,11:45,1,1,2,50.0,6,5,9,7,2,0,2,2,2035.0,1:59,0,0,0,0.0,0:0,650000
8476624,Barclay,Goodrow,1993-02-26,RW,L,2018-19,82,7,10,17,0.21,4,84,8.33,76,54164.0,11:0,296,255,551,53.72,125,68,35,17,18,0,0,0,234.0,0:2,1,0,1,7087.0,1:26,650000
8476779,Brad,Hunt,1988-08-24,D,L,2018-19,42,5,7,12,0.29,-2,75,6.67,8,37523.0,14:53,0,0,0,0.0,18,28,22,14,8,4,4,8,6075.0,2:24,0,0,0,31.0,0:0,650000
8476792,Torey,Krug,1991-04-12,D,L,2018-19,64,6,47,53,0.83,-2,151,3.97,33,81793.0,21:18,0,0,0,0.0,53,60,20,52,-32,2,28,30,14235.0,3:42,0,0,0,817.0,0:12,5250000
8476799,Cameron,Schilling,1988-10-07,D,L,2018-19,4,0,1,1,0.25,0,2,0.0,0,2903.0,12:5,0,0,0,0.0,3,5,0,3,-3,0,0,0,0.0,0:0,0,0,0,138.0,0:34,650000
8476806,J.T.,Brown,1990-07-02,RW,R,2018-19,56,3,5,8,0.14,0,56,5.36,29,30810.0,9:10,5,13,18,27.78,99,16,16,9,7,0,0,0,32.0,0:0,0,0,0,767.0,0:13,687500
8476807,Matt,Tennyson,1990-04-23,D,R,2018-19,4,0,0,0,0.0,-4,4,0.0,0,2579.0,10:44,0,0,0,0.0,10,2,0,3,-3,0,0,0,6.0,0:1,0,0,0,19.0,0:4,650000
8476822,Luke,Glendening,1989-04-28,RW,R,2018-19,78,10,13,23,0.29,2,102,9.8,15,73891.0,15:47,658,524,1182,55.67,198,102,23,25,-2,0,0,0,577.0,0:7,1,2,3,11831.0,2:31,1800000
8476826,Yanni,Gourde,1991-12-15,C,L,2018-19,80,22,26,48,0.6,9,130,16.92,66,76024.0,15:50,151,132,283,53.36,83,30,50,40,10,5,4,9,6790.0,1:24,1,1,2,8366.0,1:44,1000000
8476850,Ryan,Murray,1993-09-27,D,L,2018-19,56,1,28,29,0.52,20,71,1.41,10,72036.0,21:26,0,0,0,0.0,27,93,22,30,-8,0,1,1,2023.0,0:36,0,0,0,8495.0,2:31,2825000
8476851,Alex,Galchenyuk,1994-02-12,LW,L,2018-19,72,19,22,41,0.57,-19,159,11.95,34,67958.0,15:43,188,223,411,45.74,62,34,28,40,-12,9,12,21,13695.0,3:10,0,0,0,32.0,0:0,4900000
8476853,Morgan,Rielly,1994-03-09,D,L,2018-19,82,20,52,72,0.88,24,223,8.97,14,113761.0,23:7,0,1,1,0.0,61,114,60,94,-34,3,18,21,12815.0,2:36,0,0,0,5293.0,1:4,5000000
8476854,Hampus,Lindholm,1994-01-20,D,L,2018-19,76,6,22,28,0.37,-5,125,4.8,44,109416.0,23:59,0,0,0,0.0,81,133,23,85,-62,1,5,6,5570.0,1:13,0,1,1,14053.0,3:4,5205556
8476856,Matt,Dumba,1994-07-25,D,R,2018-19,32,12,10,22,0.69,-5,93,12.9,21,44882.0,23:22,0,0,0,0.0,60,43,10,17,-7,6,6,12,5218.0,2:43,0,0,0,2965.0,1:32,6000000
8476857,Pontus,Aberg,1993-09-23,LW,R,2018-19,59,12,13,25,0.42,-14,101,11.88,20,51658.0,14:35,2,17,19,10.53,45,11,15,36,-21,3,4,7,7337.0,2:4,0,0,0,21.0,0:0,650000
8476858,Phillip,Di Giuseppe,1993-10-09,LW,L,2018-19,24,1,3,4,0.17,-3,31,3.23,8,14595.0,10:8,3,2,5,60.0,54,9,9,6,3,0,0,0,553.0,0:23,0,0,0,54.0,0:2,750000
8476867,Brendan,Gaunce,1994-03-25,C,L,2018-19,3,1,2,3,1.0,3,2,50.0,0,1370.0,7:36,8,5,13,61.54,4,0,0,1,-1,0,0,0,0.0,0:0,0,0,0,0.0,0:0,750000
8476869,Brady,Skjei,1994-03-26,D,L,2018-19,78,8,17,25,0.32,-4,126,6.35,44,99376.0,21:14,1,0,1,100.0,178,119,32,69,-37,0,0,0,1128.0,0:14,0,1,1,10430.0,2:13,5250000
8476871,Tanner,Pearson,1992-08-10,LW,L,2018-19,80,18,9,27,0.34,-15,147,12.24,25,67445.0,14:3,5,12,17,29.41,128,41,21,23,-2,3,2,5,5945.0,1:14,0,0,0,1285.0,0:16,3750000
8476872,Scott,Laughton,1994-05-30,C,L,2018-19,82,12,20,32,0.39,-11,130,9.23,53,73068.0,14:51,344,291,635,54.17,146,46,42,42,0,0,0,0,752.0,0:9,0,2,2,11032.0,2:14,962500
8476873,Mark,Jankowski,1994-09-13,C,L,2018-19,79,14,18,32,0.41,6,99,14.14,12,60235.0,12:42,426,394,820,51.95,30,56,49,36,13,0,0,0,1120.0,0:14,5,3,8,9217.0,1:56,1675000
8476874,Olli,Maatta,1994-08-22,D,L,2018-19,60,1,13,14,0.23,9,74,1.35,12,66924.0,18:35,0,0,0,0.0,97,116,16,42,-26,1,3,4,2935.0,0:48,0,0,0,7279.0,2:1,4083333
8476875,Mike,Matheson,1994-02-27,D,L,2018-19,75,8,19,27,0.36,-24,129,6.2,44,100431.0,22:19,0,1,1,0.0,63,132,64,135,-71,0,6,6,3596.0,0:47,0,2,2,10783.0,2:23,4875000
8476877,Jordan,Schmaltz,1993-10-08,D,R,2018-19,20,0,2,2,0.1,-7,11,0.0,2,13783.0,11:29,0,0,0,0.0,10,22,1,3,-2,0,0,0,78.0,0:3,0,0,0,480.0,0:24,700000
8476878,Zemgus,Girgensons,1994-01-05,C,L,2018-19,72,5,13,18,0.25,-11,78,6.41,17,58801.0,13:36,28,41,69,40.58,144,29,21,11,10,0,0,0,344.0,0:4,0,0,0,10378.0,2:24,1600000
8476879,Cody,Ceci,1993-12-21,D,R,2018-19,74,7,19,26,0.35,-22,132,5.3,18,100171.0,22:33,0,0,0,0.0,120,142,20,59,-39,0,1,1,2090.0,0:28,0,0,0,11078.0,2:29,4300000
8476880,Tom,Wilson,1994-03-29,RW,R,2018-19,63,22,18,40,0.63,11,130,16.92,128,68579.0,18:8,29,24,53,54.72,200,52,43,44,-1,3,2,5,5284.0,1:23,2,0,2,8458.0,2:14,5166666
8476881,Tomas,Hertl,1993-11-12,C,L,2018-19,77,35,39,74,0.96,5,176,19.89,18,87871.0,19:1,609,574,1183,51.48,53,64,57,44,13,11,4,15,13250.0,2:52,1,1,2,7634.0,1:39,5625000
8476882,Teuvo,Teravainen,1994-09-11,LW,L,2018-19,82,21,55,76,0.93,30,167,12.57,12,88153.0,17:55,18,25,43,41.86,35,23,55,64,-9,8,16,24,13423.0,2:43,1,4,5,4382.0,0:53,2860000
8476884,Derrick,Pouliot,1994-01-16,D,L,2018-19,62,3,9,12,0.19,-1,58,5.17,30,63829.0,17:9,0,0,0,0.0,76,71,19,39,-20,1,0,1,4328.0,1:9,0,0,0,393.0,0:6,1100000
8476885,Jacob,Trouba,1994-02-26,D,R,2018-19,82,8,42,50,0.61,8,162,4.94,58,112560.0,22:52,0,0,0,0.0,112,171,48,86,-38,3,15,18,10132.0,2:3,1,2,3,12117.0,2:27,5500000
8476886,Slater,Koekkoek,1994-02-18,D,L,2018-19,31,2,4,6,0.19,4,36,5.56,14,29447.0,15:49,0,0,0,0.0,54,48,4,7,-3,0,0,0,108.0,0:3,0,0,0,2445.0,1:18,865000
8476887,Filip,Forsberg,1994-08-13,LW,R,2018-19,64,28,22,50,0.78,8,217,12.9,26,71487.0,18:36,1,6,7,14.29,100,29,69,67,2,7,3,10,11619.0,3:1,2,0,2,4014.0,1:2,6000000
8476889,Radek,Faksa,1994-01-09,C,L,2018-19,81,15,15,30,0.37,-3,114,13.16,54,79849.0,16:25,570,562,1132,50.35,103,65,42,29,13,1,2,3,4327.0,0:53,1,1,2,7857.0,1:37,2200000
8476891,Matt,Grzelcyk,1994-01-05,D,L,2018-19,66,3,15,18,0.27,9,90,3.33,68,75759.0,19:7,0,0,0,0.0,46,60,28,39,-11,1,5,6,6196.0,1:33,0,0,0,2849.0,0:43,1400000
8476892,Colton,Parayko,1993-05-12,D,R,2018-19,80,10,18,28,0.35,20,176,5.68,15,109361.0,22:47,0,0,0,0.0,127,157,33,43,-10,4,4,8,6269.0,1:18,0,1,1,6776.0,1:24,5500000
8476894,Brendan,Leipsic,1994-05-19,LW,L,2018-19,62,7,16,23,0.37,-14,92,7.61,24,51276.0,13:47,7,6,13,53.85,56,28,22,21,1,1,3,4,6637.0,1:47,0,0,0,0.0,0:0,650000
8476897,Oskar,Sundqvist,1994-03-23,C,R,2018-19,74,14,17,31,0.42,-1,113,12.39,22,61355.0,13:49,227,314,541,41.96,101,31,41,10,31,0,1,1,1672.0,0:22,1,1,2,7334.0,1:39,700000
8476902,Esa,Lindell,1994-05-23,D,L,2018-19,82,11,21,32,0.39,14,132,8.33,33,119687.0,24:19,0,0,0,0.0,143,161,30,92,-62,4,3,7,5727.0,1:9,2,0,2,15944.0,3:14,2200000
8476905,Chandler,Stephenson,1994-04-22,C,L,2018-19,64,5,6,11,0.17,-13,36,13.89,0,46527.0,12:6,47,48,95,49.47,38,33,18,11,7,0,0,0,52.0,0:0,1,0,1,6760.0,1:45,650000
8476906,Shayne,Gostisbehere,1993-04-20,D,L,2018-19,78,9,28,37,0.47,-20,180,5.0,22,92005.0,19:39,0,0,0,0.0,46,102,20,53,-33,4,10,14,16276.0,3:28,0,0,0,414.0,0:5,4500000
8476907,Mackenzie,MacEachern,1994-03-09,LW,L,2018-19,29,3,2,5,0.17,0,33,9.09,10,13976.0,8:1,0,0,0,0.0,49,4,6,0,6,0,0,0,6.0,0:0,0,0,0,16.0,0:0,650000
8476913,Devin,Shore,1994-07-19,C,L,2018-19,76,10,19,29,0.38,-12,82,12.2,13,65026.0,14:15,86,123,209,41.15,94,64,29,22,7,2,3,5,5717.0,1:15,2,0,2,5848.0,1:16,2300000
8476915,Jujhar,Khaira,1994-08-13,LW,L,2018-19,60,3,15,18,0.3,-12,64,4.69,43,45241.0,12:34,55,71,126,43.65,123,33,22,26,-4,0,0,0,1406.0,0:23,1,1,2,4151.0,1:9,675000
8476917,Adam,Pelech,1994-08-16,D,L,2018-19,78,5,16,21,0.27,22,110,4.55,24,87186.0,18:37,0,0,0,0.0,149,116,37,41,-4,0,0,0,424.0,0:5,0,0,0,7538.0,1:36,1600000
8476918,Jimmy,Vesey,1993-05-26,LW,L,2018-19,81,17,18,35,0.43,-6,154,11.04,21,78039.0,16:3,8,24,32,25.0,79,34,50,42,8,1,3,4,8176.0,1:40,0,0,0,6292.0,1:17,2275000
8476919,Chris,Tierney,1994-07-01,C,L,2018-19,81,9,39,48,0.59,-22,116,7.76,26,82769.0,17:1,531,512,1043,50.91,30,54,53,61,-8,0,10,10,8368.0,1:43,0,0,0,8223.0,1:41,2937500
8476921,Jordan,Martinook,1992-07-25,LW,L,2018-19,82,15,10,25,0.3,1,146,10.27,38,71270.0,14:29,150,191,341,43.99,199,46,53,30,23,0,0,0,480.0,0:5,1,0,1,7955.0,1:37,1800000
8476922,Boo,Nieves,1994-01-23,C,L,2018-19,43,4,6,10,0.23,-4,34,11.76,8,24911.0,9:39,88,139,227,38.77,33,18,12,20,-8,0,0,0,79.0,0:1,0,0,0,1444.0,0:33,-111
8476923,Damon,Severson,1994-08-07,D,R,2018-19,82,11,28,39,0.48,-27,146,7.53,58,108451.0,22:2,0,0,0,0.0,83,87,25,61,-36,3,9,12,12111.0,2:27,0,1,1,7357.0,1:29,4166666
8476924,Martin,Frk,1993-10-05,RW,R,2018-19,30,1,5,6,0.2,-9,28,3.57,4,16534.0,9:11,0,0,0,0.0,35,4,3,10,-7,1,0,1,1899.0,1:3,0,0,0,0.0,0:0,1050000
8476925,Colton,Sissons,1993-11-05,C,R,2018-19,75,15,15,30,0.4,20,111,13.51,23,72199.0,16:2,421,372,793,53.09,109,52,35,25,10,1,1,2,5251.0,1:10,0,1,1,8894.0,1:58,625000
8476927,Teddy,Blueger,1994-08-15,C,L,2018-19,28,6,4,10,0.36,7,33,18.18,15,18576.0,11:3,41,51,92,44.57,52,14,6,7,-1,0,0,0,33.0,0:1,1,2,3,2149.0,1:16,650000
8476931,Jake,McCabe,1993-10-12,D,L,2018-19,59,4,10,14,0.24,-4,64,6.25,35,67065.0,18:56,0,1,1,0.0,103,99,20,32,-12,0,0,0,360.0,0:6,1,0,1,7591.0,2:8,1600000
8476934,Brock,McGinn,1994-02-02,LW,L,2018-19,82,10,16,26,0.32,10,123,8.13,20,70403.0,14:18,26,35,61,42.62,137,38,54,30,24,0,0,0,1263.0,0:15,1,0,1,10945.0,2:13,887500
8476941,Connor,Carrick,1994-04-13,D,R,2018-19,34,2,9,11,0.32,-13,42,4.76,19,34269.0,16:47,0,0,0,0.0,25,37,15,17,-2,0,1,1,1756.0,0:51,0,0,0,839.0,0:24,1300000
8476948,Charles,Hudon,1994-06-23,LW,L,2018-19,32,3,2,5,0.16,-9,50,6.0,16,22412.0,11:40,4,5,9,44.44,73,9,9,14,-5,0,1,1,3056.0,1:35,0,0,0,0.0,0:0,650000
8476952,Dominic,Toninato,1994-03-09,C,L,2018-19,2,1,0,1,0.5,0,1,100.0,0,804.0,6:42,0,4,4,0.0,0,1,0,1,-1,0,0,0,0.0,0:0,0,0,0,28.0,0:14,925000
8476958,Jaccob,Slavin,1994-05-01,D,L,2018-19,82,8,23,31,0.38,0,146,5.48,18,113346.0,23:2,0,1,1,0.0,70,133,86,60,26,5,2,7,8893.0,1:48,1,1,2,11779.0,2:23,5300000
8476960,Andreas,Athanasiou,1994-08-06,LW,L,2018-19,76,30,24,54,0.71,-9,216,13.89,38,77404.0,16:58,171,228,399,42.86,33,26,26,47,-21,3,8,11,10175.0,2:13,0,0,0,390.0,0:5,3000000
8476966,Gemel,Smith,1994-04-16,C,L,2018-19,17,2,1,3,0.18,-4,14,14.29,0,8535.0,8:22,2,2,4,50.0,13,3,5,2,3,0,0,0,0.0,0:0,0,0,0,35.0,0:2,720000
8476967,Brett,Kulak,1994-01-06,D,L,2018-19,57,6,11,17,0.3,12,102,5.88,31,61023.0,17:50,0,0,0,0.0,107,64,15,43,-28,0,0,0,161.0,0:2,1,0,1,1525.0,0:26,900000
8476971,Kevin,Roy,1993-05-20,LW,L,2018-19,3,0,0,0,0.0,-1,2,0.0,0,2348.0,13:2,0,0,0,0.0,0,2,1,2,-1,0,0,0,33.0,0:11,0,0,0,0.0,0:0,874125
8476975,Cedric,Paquette,1993-08-13,C,L,2018-19,80,13,4,17,0.21,7,87,14.94,80,57616.0,12:0,404,364,768,52.6,269,61,21,12,9,0,0,0,224.0,0:2,2,0,2,9618.0,2:0,1000000
8476979,Erik,Gustafsson,1992-03-14,D,L,2018-19,79,17,43,60,0.76,-6,160,10.62,34,107051.0,22:35,0,0,0,0.0,100,115,34,77,-43,4,14,18,14378.0,3:2,0,0,0,546.0,0:6,1200000
8476981,Josh,Anderson,1994-05-07,RW,R,2018-19,82,27,20,47,0.57,25,230,11.74,60,83756.0,17:1,12,26,38,31.58,214,40,46,19,27,3,4,7,6740.0,1:22,2,1,3,6590.0,1:20,1850000
8476982,Danny,O'Regan,1994-01-30,C,R,2018-19,1,0,0,0,0.0,0,2,0.0,0,716.0,11:56,1,0,1,100.0,0,0,0,0,0,0,0,0,53.0,0:53,0,0,0,0.0,0:0,874125
8476983,Paul,LaDue,1992-09-06,D,R,2018-19,33,2,3,5,0.15,0,33,6.06,12,26178.0,13:13,0,0,0,0.0,51,25,2,9,-7,0,0,0,127.0,0:3,0,0,0,212.0,0:6,825000
8476988,Matt,Benning,1994-05-25,D,R,2018-19,70,5,12,17,0.24,11,94,5.32,33,62770.0,14:56,0,0,0,0.0,109,59,10,49,-39,0,1,1,2364.0,0:33,0,1,1,5210.0,1:14,1900000
8476994,Vinnie,Hinostroza,1994-04-03,LW,R,2018-19,72,16,23,39,0.54,-4,152,10.53,14,65956.0,15:16,39,64,103,37.86,69,41,28,34,-6,3,2,5,5673.0,1:18,0,0,0,701.0,0:9,1500000
8477009,Jake,Dotchin,1994-03-24,D,R,2018-19,20,0,1,1,0.05,-4,7,0.0,39,14171.0,11:48,0,0,0,0.0,54,16,4,7,-3,0,0,0,0.0,0:0,0,1,1,821.0,0:41,812500
8477010,Joseph,Blandisi,1994-07-18,LW,L,2018-19,9,0,0,0,0.0,-1,8,0.0,6,4020.0,7:26,0,0,0,0.0,10,1,3,0,3,0,0,0,16.0,0:1,0,0,0,107.0,0:11,680000
8477015,Connor,Brown,1994-01-14,RW,R,2018-19,82,8,21,29,0.35,11,85,9.41,16,67857.0,13:47,20,31,51,39.22,35,37,31,17,14,0,1,1,1206.0,0:14,0,3,3,9639.0,1:57,2100000
8477018,Ben,Hutton,1993-04-20,D,L,2018-19,69,5,15,20,0.29,-23,114,4.39,43,92553.0,22:21,0,0,0,0.0,55,102,27,30,-3,1,7,8,7674.0,1:51,0,1,1,9488.0,2:17,2800000
8477021,Alexander,Kerfoot,1994-08-11,C,L,2018-19,78,15,27,42,0.54,-9,116,12.93,38,69650.0,14:52,274,215,489,56.03,22,29,22,30,-8,4,12,16,9718.0,2:4,0,0,0,277.0,0:3,925000
8477034,Jaycob,Megna,1992-12-10,D,L,2018-19,28,1,3,4,0.14,-1,31,3.23,12,24414.0,14:31,0,0,0,0.0,32,29,11,30,-19,0,0,0,12.0,0:0,0,0,0,3368.0,2:0,650000
8477043,Christian,Djoos,1994-08-06,D,L,2018-19,45,1,9,10,0.22,9,33,3.03,4,36643.0,13:34,0,0,0,0.0,18,28,10,22,-12,0,0,0,195.0,0:4,0,0,0,65.0,0:1,650000
8477046,Joakim,Ryan,1993-06-17,D,L,2018-19,44,0,7,7,0.16,-1,35,0.0,15,33724.0,12:46,0,0,0,0.0,43,39,11,9,2,0,0,0,96.0,0:2,0,0,0,660.0,0:15,650000
8477073,Kurtis,MacDermid,1994-03-25,D,L,2018-19,11,0,1,1,0.09,-1,5,0.0,11,6169.0,9:20,0,0,0,0.0,26,4,0,12,-12,0,0,0,32.0,0:2,0,0,0,273.0,0:24,675000
8477085,Ashton,Sautner,1994-05-27,D,L,2018-19,17,0,1,1,0.06,-2,21,0.0,2,14835.0,14:32,0,0,0,0.0,25,17,3,10,-7,0,0,0,6.0,0:0,0,0,0,228.0,0:13,675000
8477205,Andrej,Sustr,1990-11-29,D,R,2018-19,5,0,0,0,0.0,0,6,0.0,6,3612.0,12:2,0,0,0,0.0,3,7,0,0,0,0,0,0,43.0,0:8,0,0,0,48.0,0:9,1300000
8477213,Tim,Schaller,1990-11-16,C,L,2018-19,47,3,7,10,0.21,-2,44,6.82,9,30069.0,10:39,1,1,2,50.0,66,18,14,8,6,0,0,0,58.0,0:1,0,0,0,3761.0,1:20,1900000
8477215,Danny,DeKeyser,1990-03-07,D,L,2018-19,52,5,15,20,0.38,2,59,8.47,39,68538.0,21:58,0,0,0,0.0,79,94,14,30,-16,0,0,0,725.0,0:13,0,0,0,7826.0,2:30,5000000
8477220,Nate,Schmidt,1991-07-16,D,L,2018-19,61,9,21,30,0.49,22,112,8.04,8,80340.0,21:57,0,0,0,0.0,37,100,45,39,6,1,7,8,6700.0,1:49,0,0,0,5453.0,1:29,2225000
8477240,Carter,Rowney,1989-05-10,RW,R,2018-19,62,7,13,20,0.32,0,53,13.21,12,46690.0,12:33,171,176,347,49.28,178,35,22,26,-4,0,0,0,251.0,0:4,1,0,1,7072.0,1:54,1133333
8477244,Chad,Ruhwedel,1990-05-07,D,R,2018-19,18,1,1,2,0.11,-9,22,4.55,4,17578.0,16:16,0,0,0,0.0,40,16,7,10,-3,0,0,0,94.0,0:5,0,0,0,1385.0,1:16,650000
8477290,Michael,Raffl,1988-12-01,LW,L,2018-19,67,6,12,18,0.27,-1,65,9.23,32,45890.0,11:24,14,20,34,41.18,96,29,28,20,8,0,0,0,260.0,0:3,1,0,1,3720.0,0:55,2350000
8477337,John,Gilmour,1993-05-17,D,L,2018-19,5,0,0,0,0.0,-3,9,0.0,4,4823.0,16:4,0,0,0,0.0,3,13,1,3,-2,0,0,0,38.0,0:7,0,0,0,4.0,0:0,650000
8477341,Andreas,Johnsson,1994-11-21,LW,L,2018-19,73,20,23,43,0.59,14,130,15.38,32,59868.0,13:40,7,12,19,36.84,60,36,25,20,5,3,3,6,6908.0,1:34,0,0,0,63.0,0:0,787500
8477343,Tyler,Lewington,1994-12-05,D,R,2018-19,2,1,1,2,1.0,3,3,33.33,7,1655.0,13:47,0,0,0,0.0,4,1,0,3,-3,0,0,0,0.0,0:0,0,0,0,66.0,0:33,675000
8477346,MacKenzie,Weegar,1994-01-07,D,R,2018-19,64,4,11,15,0.23,-3,79,5.06,64,65151.0,16:57,1,0,1,100.0,127,103,34,59,-25,0,1,1,1117.0,0:17,0,0,0,5544.0,1:26,900000
8477353,Tyler,Motte,1995-03-10,C,L,2018-19,74,9,7,16,0.22,-12,114,7.89,10,56720.0,12:46,15,33,48,31.25,200,52,34,15,19,0,0,0,174.0,0:2,2,0,2,7587.0,1:42,925000
8477355,Will,Butcher,1995-01-06,D,L,2018-19,78,4,26,30,0.38,-17,108,3.7,18,90205.0,19:16,0,0,0,0.0,38,74,17,32,-15,1,13,14,12964.0,2:46,0,0,0,614.0,0:7,925000
8477357,Saku,Maenalanen,1994-05-29,RW,L,2018-19,34,4,4,8,0.24,0,36,11.11,20,19239.0,9:25,6,15,21,28.57,45,10,12,8,4,0,0,0,191.0,0:5,0,0,0,712.0,0:20,925000
8477365,Connor,Clifton,1995-04-28,D,R,2018-19,19,0,1,1,0.05,5,22,0.0,15,20184.0,17:42,0,0,0,0.0,40,13,10,9,1,0,0,0,56.0,0:2,0,0,0,729.0,0:38,725000
8477366,Luke,Johnson,1994-09-19,C,R,2018-19,15,0,1,1,0.07,-8,19,0.0,8,9731.0,10:48,51,55,106,48.11,31,9,6,1,5,0,1,1,297.0,0:19,0,0,0,1201.0,1:20,717500
8477380,Jonny,Brodzinski,1993-06-19,C,L,2018-19,13,2,1,3,0.23,0,17,11.76,2,7740.0,9:55,1,1,2,50.0,23,7,3,0,3,0,0,0,230.0,0:17,0,0,0,3.0,0:0,650000
8477384,Josh,Brown,1994-01-21,D,R,2018-19,37,1,1,2,0.05,-3,28,3.57,28,29527.0,13:18,0,0,0,0.0,80,31,12,17,-5,0,0,0,68.0,0:1,0,0,0,1813.0,0:49,675000
8477399,Tyrell,Goulbourne,1994-01-26,LW,L,2018-19,2,0,0,0,0.0,0,3,0.0,0,889.0,7:24,0,0,0,0.0,6,0,1,0,1,0,0,0,0.0,0:0,0,0,0,0.0,0:0,715000
8477401,John,Hayden,1995-02-14,RW,R,2018-19,54,3,2,5,0.09,-12,42,7.14,27,29682.0,9:9,7,22,29,24.14,97,23,15,9,6,0,0,0,1294.0,0:23,0,0,0,669.0,0:12,750000
8477402,Pavel,Buchnevich,1995-04-17,RW,L,2018-19,64,21,17,38,0.59,-10,119,17.65,13,58271.0,15:10,7,18,25,28.0,60,20,29,43,-14,7,5,12,7503.0,1:57,0,0,0,7.0,0:0,925000
8477404,Jake,Guentzel,1994-10-06,C,L,2018-19,82,40,36,76,0.93,13,227,17.62,26,95205.0,19:21,10,20,30,33.33,105,47,45,42,3,6,5,11,10445.0,2:7,1,0,1,2405.0,0:29,734167
8477406,Mattias,Janmark,1992-12-08,C,L,2018-19,81,6,19,25,0.31,-4,105,5.71,24,73952.0,15:12,10,16,26,38.46,28,44,30,36,-6,0,1,1,1580.0,0:19,0,1,1,7259.0,1:29,2300000
8477407,Anthony,Duclair,1995-08-26,LW,L,2018-19,74,19,14,33,0.45,-2,132,14.39,14,56392.0,12:42,2,13,15,13.33,32,33,33,29,4,7,1,8,7180.0,1:37,0,0,0,129.0,0:1,650000
8477413,Sven,Andrighetto,1993-03-21,RW,L,2018-19,64,7,10,17,0.27,10,95,7.37,14,42503.0,11:4,3,8,11,27.27,29,32,22,18,4,0,0,0,4858.0,1:15,0,0,0,426.0,0:6,1400000
8477416,Oliver,Bjorkstrand,1995-04-10,RW,R,2018-19,77,23,13,36,0.47,8,161,14.29,8,57003.0,12:20,5,8,13,38.46,43,34,31,14,17,3,0,3,5723.0,1:14,0,0,0,35.0,0:0,2500000
8477417,Peter,Cehlarik,1995-08-02,LW,L,2018-19,20,4,2,6,0.3,3,30,13.33,6,15112.0,12:35,0,5,5,0.0,5,7,13,6,7,1,0,1,1472.0,1:13,0,0,0,4.0,0:0,742500
8477425,Miles,Wood,1995-09-13,LW,L,2018-19,63,10,14,24,0.38,-10,159,6.29,91,51764.0,13:41,0,2,2,0.0,97,27,19,33,-14,1,2,3,4571.0,1:12,0,0,0,16.0,0:0,2750000
8477426,Nick,Paul,1995-03-20,LW,L,2018-19,20,1,1,2,0.1,-10,30,3.33,4,10169.0,8:28,16,19,35,45.71,28,4,5,3,2,0,0,0,32.0,0:1,0,0,0,0.0,0:0,650000
8477429,Andrew,Copp,1994-07-08,C,L,2018-19,69,11,14,25,0.36,20,82,13.41,6,50344.0,12:9,198,160,358,55.31,71,34,22,27,-5,0,0,0,229.0,0:3,1,0,1,5664.0,1:22,1000000
8477433,Ben,Harpur,1995-01-12,D,L,2018-19,51,1,4,5,0.1,-13,50,2.0,56,53919.0,17:37,0,0,0,0.0,89,69,16,60,-44,0,0,0,86.0,0:1,0,0,0,7510.0,2:27,725000
8477435,Ryan,Graves,1995-05-21,D,L,2018-19,26,3,2,5,0.19,4,26,11.54,2,17322.0,11:6,0,0,0,0.0,32,51,5,12,-7,0,0,0,3.0,0:0,0,0,0,1897.0,1:12,650000
8477444,Andre,Burakovsky,1995-02-09,LW,L,2018-19,76,12,13,25,0.33,2,100,12.0,14,50732.0,11:7,7,13,20,35.0,35,29,28,29,-1,1,0,1,1106.0,0:14,0,0,0,223.0,0:2,3000000
8477447,Shea,Theodore,1995-08-03,D,L,2018-19,79,12,25,37,0.47,-4,202,5.94,20,95290.0,20:6,1,0,1,100.0,27,91,82,59,23,4,5,9,11487.0,2:25,0,1,1,801.0,0:10,5200000
8477448,Marko,Dano,1994-11-30,C,L,2018-19,8,0,0,0,0.0,-1,3,0.0,7,3304.0,6:53,0,5,5,0.0,16,3,3,2,1,0,0,0,0.0,0:0,0,0,0,18.0,0:2,800000
8477450,Jason,Dickinson,1995-07-04,C,L,2018-19,67,6,16,22,0.33,9,94,6.38,23,53761.0,13:22,201,268,469,42.86,106,50,30,26,4,0,0,0,408.0,0:6,0,0,0,5909.0,1:28,875000
8477451,Ryan,Hartman,1994-09-20,RW,R,2018-19,83,12,14,26,0.31,1,145,8.28,74,65327.0,13:7,4,12,16,25.0,107,39,35,38,-3,0,0,0,1309.0,0:15,0,0,0,2075.0,0:25,875000
8477452,Ian,McCoshen,1995-08-05,D,L,2018-19,19,1,1,2,0.11,-2,15,6.67,8,15184.0,13:19,0,0,0,0.0,41,13,5,11,-6,0,0,0,9.0,0:0,0,0,0,1129.0,0:59,925000
8477454,Adam,Erne,1995-04-20,LW,L,2018-19,65,7,13,20,0.31,10,70,10.0,40,41138.0,10:32,11,12,23,47.83,159,26,16,8,8,2,0,2,1981.0,0:30,0,0,0,1155.0,0:17,800000
8477455,Jacob,de la Rose,1995-05-20,LW,L,2018-19,60,3,6,9,0.15,-13,55,5.45,16,41177.0,11:26,161,219,380,42.37,72,29,17,11,6,0,0,0,290.0,0:4,0,0,0,5194.0,1:26,900000
8477456,J.T.,Compher,1995-04-08,LW,R,2018-19,66,16,16,32,0.48,-8,118,13.56,31,69204.0,17:28,301,311,612,49.18,33,59,23,23,0,4,5,9,12351.0,3:7,3,0,3,7488.0,1:53,925000
8477458,Valentin,Zykov,1995-05-15,LW,R,2018-19,28,2,3,5,0.18,-5,29,6.9,2,16718.0,9:57,2,7,9,22.22,26,6,9,15,-6,0,2,2,2486.0,1:28,0,0,0,0.0,0:0,675000
8477460,Laurent,Dauphin,1995-03-27,C,L,2018-19,1,0,0,0,0.0,-1,2,0.0,0,739.0,12:19,0,1,1,0.0,0,1,0,0,0,0,0,0,0.0,0:0,0,0,0,0.0,0:0,787500
8477461,Remi,Elie,1995-04-16,LW,L,2018-19,16,0,1,1,0.06,-3,9,0.0,2,9936.0,10:21,1,0,1,100.0,30,3,3,4,-1,0,0,0,65.0,0:4,0,0,0,1032.0,1:4,735000
8477462,Robert,Hagg,1995-02-08,D,L,2018-19,82,5,15,20,0.24,-3,86,5.81,63,83371.0,16:56,0,0,0,0.0,258,158,4,39,-35,0,0,0,219.0,0:2,0,0,0,8695.0,1:46,1150000
8477463,Steven,Santini,1995-03-07,D,R,2018-19,39,1,3,4,0.1,-6,41,2.44,16,38976.0,16:39,0,0,0,0.0,80,43,9,9,0,0,0,0,159.0,0:4,0,0,0,1900.0,0:48,1416667
8477464,Nic,Petan,1995-03-22,LW,L,2018-19,18,1,2,3,0.17,-5,15,6.67,2,8247.0,7:38,11,13,24,45.83,2,4,4,3,1,0,0,0,505.0,0:28,0,0,0,9.0,0:0,874125
8477471,Dillon,Heatherington,1995-05-09,D,L,2018-19,5,0,1,1,0.2,4,5,0.0,0,3056.0,10:11,0,0,0,0.0,6,2,0,3,-3,0,0,0,15.0,0:3,0,0,0,0.0,0:0,650000
8477472,Carl,Dahlstrom,1995-01-28,D,L,2018-19,38,0,6,6,0.16,9,42,0.0,6,42418.0,18:36,0,0,0,0.0,33,35,9,29,-20,0,0,0,44.0,0:1,0,1,1,4295.0,1:53,750833
8477473,Justin,Bailey,1995-07-01,RW,R,2018-19,11,0,1,1,0.09,0,5,0.0,2,3785.0,5:44,0,0,0,0.0,9,5,3,2,1,0,0,0,0.0,0:0,0,0,0,0.0,0:0,715000
8477474,Madison,Bowey,1995-04-22,D,R,2018-19,50,2,8,10,0.2,-1,48,4.17,46,45775.0,15:15,0,0,0,0.0,72,63,9,34,-25,0,0,0,123.0,0:2,0,0,0,2869.0,0:57,1000000
8477476,Artturi,Lehkonen,1995-07-04,LW,L,2018-19,82,11,20,31,0.38,10,176,6.25,32,76543.0,15:33,5,14,19,26.32,120,39,46,28,18,0,0,0,2688.0,0:32,0,0,0,11149.0,2:15,839166
8477478,William,Carrier,1994-12-20,LW,L,2018-19,54,8,1,9,0.17,-4,85,9.41,29,32220.0,9:56,0,0,0,0.0,277,13,31,10,21,0,0,0,205.0,0:3,0,0,0,6.0,0:0,725000
8477479,Tyler,Bertuzzi,1995-02-24,LW,L,2018-19,73,21,26,47,0.64,11,131,16.03,36,72341.0,16:30,10,20,30,33.33,76,39,34,43,-9,3,3,6,7544.0,1:43,0,0,0,71.0,0:0,1400000
8477482,Zach,Sanford,1994-11-09,LW,L,2018-19,60,8,12,20,0.33,8,77,10.39,21,45284.0,12:34,8,5,13,61.54,48,37,31,14,17,0,1,1,612.0,0:10,0,0,0,1962.0,0:32,875000
8477488,Brett,Pesce,1994-11-15,D,R,2018-19,73,7,22,29,0.4,35,98,7.14,24,89751.0,20:29,1,0,1,100.0,53,131,54,30,24,0,0,0,632.0,0:8,0,2,2,10938.0,2:29,4025000
8477492,Nathan,MacKinnon,1995-09-01,C,R,2018-19,82,41,58,99,1.21,20,365,11.23,34,108690.0,22:5,517,666,1183,43.7,54,31,48,64,-16,12,25,37,20126.0,4:5,0,0,0,524.0,0:6,6300000
8477493,Aleksander,Barkov,1995-09-02,C,L,2018-19,82,35,61,96,1.17,-3,206,16.99,8,109981.0,22:21,1041,898,1939,53.69,28,61,100,69,31,13,18,31,17299.0,3:30,0,1,1,10176.0,2:4,5900000
8477494,Jonathan,Drouin,1995-03-28,LW,L,2018-19,81,18,35,53,0.65,-8,190,9.47,26,82286.0,16:55,37,51,88,42.05,55,23,50,48,2,3,13,16,13887.0,2:51,0,0,0,312.0,0:3,5500000
8477495,Seth,Jones,1994-10-03,D,R,2018-19,75,9,37,46,0.61,1,184,4.89,28,116202.0,25:49,0,0,0,0.0,106,133,59,69,-10,0,10,10,10524.0,2:20,0,3,3,10274.0,2:16,5400000
8477496,Elias,Lindholm,1994-12-02,C,R,2018-19,81,27,51,78,0.96,30,182,14.84,20,97387.0,20:2,509,428,937,54.32,82,39,50,46,4,9,17,26,15547.0,3:11,1,3,4,11138.0,2:17,4850000
8477497,Sean,Monahan,1994-10-12,C,L,2018-19,78,34,48,82,1.05,7,211,16.11,12,89176.0,19:3,454,434,888,51.13,36,24,78,58,20,12,11,23,15404.0,3:17,0,0,0,285.0,0:3,6375000
8477498,Darnell,Nurse,1995-02-04,D,L,2018-19,82,10,31,41,0.5,-5,196,5.1,87,117196.0,23:49,0,0,0,0.0,162,146,30,73,-43,1,8,9,9076.0,1:50,0,1,1,9464.0,1:55,3200000
8477499,Rasmus,Ristolainen,1994-10-27,D,R,2018-19,78,5,38,43,0.55,-41,182,2.75,38,115322.0,24:38,0,0,0,0.0,235,121,23,44,-21,1,16,17,14049.0,3:0,0,0,0,10166.0,2:10,5400000
8477500,Bo,Horvat,1995-04-05,C,L,2018-19,82,27,34,61,0.74,-4,227,11.89,33,102511.0,20:50,1083,935,2018,53.67,62,63,28,38,-10,7,11,18,16918.0,3:26,2,1,3,2224.0,0:27,5500000
8477501,Valeri,Nichushkin,1995-03-04,RW,L,2018-19,57,0,10,10,0.18,-4,65,0.0,0,40756.0,11:55,3,3,6,50.0,71,32,24,30,-6,0,0,0,1158.0,0:20,0,0,0,1029.0,0:18,2950000
8477502,Samuel,Morin,1995-07-12,D,L,2018-19,5,0,0,0,0.0,-3,5,0.0,4,3711.0,12:22,0,0,0,0.0,9,7,1,5,-4,0,0,0,1.0,0:0,0,0,0,273.0,0:54,700000
8477503,Max,Domi,1995-03-02,LW,L,2018-19,82,28,44,72,0.88,20,203,13.79,80,85519.0,17:22,447,549,996,44.88,53,39,47,70,-23,4,7,11,12634.0,2:34,0,0,0,272.0,0:3,3150000
8477504,Josh,Morrissey,1995-03-28,D,L,2018-19,59,6,25,31,0.53,9,95,6.32,14,79314.0,22:24,0,0,0,0.0,55,107,33,32,1,3,7,10,6204.0,1:45,1,1,2,9949.0,2:48,3150000
8477505,Alexander,Wennberg,1994-09-22,C,L,2018-19,75,2,23,25,0.33,-1,64,3.12,12,67848.0,15:4,342,364,706,48.44,34,32,34,29,5,1,5,6,8422.0,1:52,1,2,3,5748.0,1:16,4900000
8477506,Ryan,Pulock,1994-10-06,D,R,2018-19,82,9,28,37,0.45,21,180,5.0,22,110029.0,22:21,0,0,0,0.0,143,148,35,68,-33,3,6,9,9237.0,1:52,0,0,0,8691.0,1:45,2000000
8477507,Nikita,Zadorov,1995-04-16,D,L,2018-19,70,7,7,14,0.2,19,100,7.0,75,72256.0,17:12,0,0,0,0.0,228,67,21,32,-11,0,0,0,294.0,0:4,0,0,0,7067.0,1:40,2150000
8477509,Mirco,Mueller,1995-03-21,D,L,2018-19,53,1,10,11,0.21,-3,39,2.56,17,57469.0,18:4,0,0,0,0.0,75,61,22,35,-13,0,0,0,368.0,0:6,0,0,0,4955.0,1:33,850000
8477510,Kerby,Rychel,1994-10-07,LW,L,2018-19,2,0,0,0,0.0,-1,1,0.0,0,1101.0,9:10,0,1,1,0.0,3,1,0,0,0,0,0,0,30.0,0:15,0,0,0,0.0,0:0,725000
8477511,Anthony,Mantha,1994-09-16,RW,L,2018-19,67,25,23,48,0.72,-8,198,12.63,30,71665.0,17:49,22,28,50,44.0,67,23,37,60,-23,7,6,13,9476.0,2:21,0,0,0,18.0,0:0,3300000
8477512,Frederik,Gauthier,1995-04-26,C,L,2018-19,70,3,11,14,0.2,3,46,6.52,12,35134.0,8:21,240,207,447,53.69,98,28,12,12,0,0,0,0,127.0,0:1,0,0,0,782.0,0:11,675000
8477520,Jean-Sebastien,Dea,1994-02-08,C,R,2018-19,23,4,2,6,0.26,0,29,13.79,8,14153.0,10:15,53,51,104,50.96,21,12,13,7,6,0,0,0,493.0,0:21,0,0,0,869.0,0:37,-111
8477527,Ross,Johnston,1994-02-18,LW,L,2018-19,17,1,3,4,0.24,3,12,8.33,23,8073.0,7:54,0,1,1,0.0,43,1,2,5,-3,0,0,0,5.0,0:0,0,0,0,35.0,0:2,1000000
8477529,Colby,Cave,1994-12-26,C,L,2018-19,53,3,5,8,0.15,-5,58,5.17,16,39155.0,12:18,200,199,399,50.13,73,18,22,12,10,0,0,0,1455.0,0:27,0,0,0,3062.0,0:57,675000
8477573,Nathan,Walker,1994-02-07,LW,L,2018-19,3,0,1,1,0.33,1,2,0.0,2,1466.0,8:8,0,0,0,0.0,5,0,0,1,-1,0,0,0,73.0,0:24,0,0,0,77.0,0:25,650000
8477680,Josh,Currie,1992-10-29,RW,R,2018-19,21,2,3,5,0.24,2,19,10.53,2,10973.0,8:42,2,3,5,40.0,39,17,3,2,1,0,0,0,63.0,0:3,0,0,0,0.0,0:0,687500
8477810,Joel,Hanley,1991-06-08,D,L,2018-19,16,0,0,0,0.0,0,9,0.0,2,13145.0,13:41,0,0,0,0.0,16,16,3,9,-6,0,0,0,165.0,0:10,0,0,0,461.0,0:28,650000
8477839,Conor,Sheary,1992-06-08,LW,L,2018-19,78,14,20,34,0.44,-18,147,9.52,12,68424.0,14:37,19,15,34,55.88,29,29,35,31,4,4,2,6,7959.0,1:42,0,0,0,129.0,0:1,3000000
8477845,Trevor,van Riemsdyk,1991-07-24,D,R,2018-19,78,3,11,14,0.18,-4,102,2.94,10,70474.0,15:3,0,0,0,0.0,42,84,28,35,-7,0,0,0,272.0,0:3,0,0,0,4831.0,1:1,2300000
8477846,Ryan,Carpenter,1991-01-18,C,R,2018-19,68,5,13,18,0.26,-6,102,4.9,8,51472.0,12:36,161,145,306,52.61,126,17,30,17,13,0,0,0,823.0,0:12,1,1,2,5107.0,1:15,650000
8477850,Christian,Folin,1991-02-09,D,R,2018-19,45,0,6,6,0.13,6,47,0.0,27,42280.0,15:39,1,0,1,100.0,125,78,4,21,-17,0,0,0,69.0,0:1,0,0,0,2691.0,0:59,800000
8477851,Jordan,Oesterle,1992-06-25,D,L,2018-19,71,6,14,20,0.28,-3,77,7.79,12,80497.0,18:53,0,0,0,0.0,58,139,23,50,-27,3,4,7,7545.0,1:46,0,0,0,4444.0,1:2,650000
8477865,Jake,Chelios,1991-03-08,D,L,2018-19,5,0,0,0,0.0,0,5,0.0,2,5162.0,17:12,0,0,0,0.0,7,5,2,4,-2,0,0,0,0.0,0:0,0,0,0,222.0,0:44,650000
8477901,Daniel,Carr,1991-11-01,LW,L,2018-19,6,1,0,1,0.17,-1,11,9.09,0,3537.0,9:49,0,0,0,0.0,9,3,3,2,1,0,0,0,50.0,0:8,0,0,0,0.0,0:0,750000
8477903,Garnet,Hathaway,1991-11-23,RW,R,2018-19,76,11,8,19,0.25,14,77,14.29,56,48001.0,10:31,7,8,15,46.67,200,36,23,29,-6,0,0,0,837.0,0:11,2,0,2,7773.0,1:42,850000
8477919,Frederick,Gaudreau,1993-05-01,C,R,2018-19,55,3,1,4,0.07,1,43,6.98,2,29747.0,9:0,156,167,323,48.3,25,18,13,9,4,0,0,0,75.0,0:1,0,0,0,25.0,0:0,666666
8477922,Melker,Karlsson,1990-07-18,C,R,2018-19,79,12,4,16,0.2,-1,79,15.19,26,54508.0,11:29,15,12,27,55.56,67,39,30,19,11,0,0,0,220.0,0:2,0,0,0,6982.0,1:28,2000000
8477930,Pierre-Edouard,Bellemare,1985-03-06,LW,L,2018-19,76,6,9,15,0.2,2,108,5.56,6,56680.0,12:25,394,326,720,54.72,71,51,38,23,15,0,0,0,353.0,0:4,2,0,2,8874.0,1:56,1450000
8477931,Tomas,Nosek,1992-09-01,LW,L,2018-19,68,8,9,17,0.25,-10,116,6.9,18,50881.0,12:28,82,50,132,62.12,75,23,32,14,18,0,0,0,1618.0,0:23,1,0,1,6968.0,1:42,962500
8477932,Aaron,Ekblad,1996-02-07,D,R,2018-19,82,13,24,37,0.45,1,180,7.22,47,116329.0,23:38,0,0,0,0.0,114,88,47,122,-75,5,5,10,8357.0,1:41,0,0,0,11324.0,2:18,7500000
8477933,Sam,Reinhart,1995-11-06,C,R,2018-19,82,22,43,65,0.79,-10,180,12.22,16,93272.0,18:57,31,56,87,35.63,38,47,39,46,-7,2,13,15,15729.0,3:11,0,0,0,354.0,0:4,3650000
8477934,Leon,Draisaitl,1995-10-27,C,L,2018-19,82,50,55,105,1.28,2,231,21.65,52,111147.0,22:35,677,663,1340,50.52,57,26,71,116,-45,16,13,29,16460.0,3:20,3,0,3,5680.0,1:9,8500000
8477935,Sam,Bennett,1996-06-20,C,L,2018-19,71,13,14,27,0.38,-6,115,11.3,93,56615.0,13:17,50,40,90,55.56,121,27,25,38,-13,4,2,6,6513.0,1:31,0,0,0,817.0,0:11,1950000
8477936,Michael,Dal Colle,1996-06-20,LW,L,2018-19,28,3,4,7,0.25,3,34,8.82,2,20342.0,12:6,0,1,1,0.0,10,8,7,11,-4,0,0,0,353.0,0:12,0,0,0,0.0,0:0,863333
8477937,Jake,Virtanen,1996-08-17,RW,R,2018-19,70,15,10,25,0.36,-4,154,9.74,44,62240.0,14:49,5,10,15,33.33,154,37,46,22,24,2,0,2,5216.0,1:14,0,0,0,104.0,0:1,1250000
8477938,Haydn,Fleury,1996-07-08,D,L,2018-19,20,0,1,1,0.05,4,17,0.0,2,15040.0,12:32,0,0,0,0.0,25,21,3,6,-3,0,0,0,50.0,0:2,0,0,0,412.0,0:20,863333
8477939,William,Nylander,1996-05-01,C,R,2018-19,54,7,20,27,0.5,-4,130,5.38,16,50271.0,15:30,203,165,368,55.16,16,14,28,25,3,1,5,6,6016.0,1:51,0,0,0,151.0,0:2,10277778
8477940,Nikolaj,Ehlers,1996-02-14,LW,L,2018-19,62,21,16,37,0.6,2,158,13.29,15,58632.0,15:45,1,1,2,50.0,27,16,28,17,11,2,5,7,4894.0,1:18,0,0,0,22.0,0:0,6000000
8477941,Nick,Ritchie,1995-12-05,LW,L,2018-19,60,9,22,31,0.52,6,96,9.38,82,54005.0,15:0,4,8,12,33.33,123,31,20,34,-14,2,7,9,6536.0,1:48,0,0,0,1923.0,0:32,1640000
8477942,Kevin,Fiala,1996-07-22,LW,L,2018-19,83,13,26,39,0.47,-23,174,7.47,36,77882.0,15:38,3,5,8,37.5,42,20,44,68,-24,2,9,11,11077.0,2:13,0,0,0,61.0,0:0,863333
8477943,Brendan,Perlini,1996-04-27,LW,L,2018-19,68,14,7,21,0.31,-17,117,11.97,28,47335.0,11:36,1,6,7,14.29,51,22,11,14,-3,2,2,4,3008.0,0:44,0,0,0,422.0,0:6,863333
8477944,Jakub,Vrana,1996-02-28,LW,L,2018-19,82,24,23,47,0.57,20,161,14.91,27,69078.0,14:2,4,6,10,40.0,47,32,41,50,-9,1,3,4,5597.0,1:8,0,0,0,30.0,0:0,863333
8477945,Julius,Honka,1995-12-03,D,R,2018-19,29,0,4,4,0.14,-2,38,0.0,10,23861.0,13:42,0,1,1,0.0,16,31,4,27,-23,0,0,0,730.0,0:25,0,0,0,422.0,0:14,863333
8477946,Dylan,Larkin,1996-07-30,C,L,2018-19,76,32,41,73,0.96,-6,287,11.15,75,99600.0,21:50,865,722,1587,54.51,80,38,69,100,-31,7,8,15,11218.0,2:27,2,1,3,5982.0,1:18,6100000
8477947,Sonny,Milano,1996-05-12,LW,L,2018-19,8,1,0,1,0.12,0,5,20.0,0,3994.0,8:19,0,0,0,0.0,5,0,0,1,-1,0,0,0,96.0,0:12,0,0,0,0.0,0:0,863333
8477948,Travis,Sanheim,1996-03-29,D,L,2018-19,82,9,26,35,0.43,-4,121,7.44,22,96228.0,19:33,0,0,0,0.0,45,133,20,65,-45,2,3,5,5061.0,1:1,0,0,0,2943.0,0:35,863333
8477949,Alex,Tuch,1996-05-10,RW,R,2018-19,74,20,32,52,0.7,13,180,11.11,8,74267.0,16:43,43,69,112,38.39,92,40,69,51,18,3,3,6,11071.0,2:29,0,0,0,27.0,0:0,925000
8477950,Tony,DeAngelo,1995-10-24,D,R,2018-19,61,4,26,30,0.49,6,111,3.6,77,70739.0,19:19,0,0,0,0.0,54,82,21,74,-53,0,10,10,7019.0,1:55,0,0,0,623.0,0:10,-111
8477951,Nick,Schmaltz,1996-02-23,C,R,2018-19,40,7,18,25,0.62,-12,62,11.29,8,42794.0,17:49,104,177,281,37.01,5,12,35,25,10,5,3,8,7351.0,3:3,0,0,0,789.0,0:19,925000
8477952,Robby,Fabbri,1996-01-22,C,L,2018-19,32,2,4,6,0.19,-4,43,4.65,6,24295.0,12:39,4,10,14,28.57,30,8,5,4,1,0,0,0,1721.0,0:53,0,0,0,41.0,0:1,925000
8477953,Kasperi,Kapanen,1996-07-23,RW,R,2018-19,78,20,24,44,0.56,12,174,11.49,27,77741.0,16:36,5,5,10,50.0,92,19,44,38,6,1,2,3,3714.0,0:47,2,0,2,7547.0,1:36,863333
8477955,Jared,McCann,1996-05-31,C,L,2018-19,78,19,16,35,0.45,-1,150,12.67,31,67980.0,14:31,275,320,595,46.22,77,51,35,44,-9,1,2,3,3810.0,0:48,4,0,4,5519.0,1:10,1250000
8477956,David,Pastrnak,1996-05-25,RW,R,2018-19,66,38,43,81,1.23,6,235,16.17,32,74265.0,18:45,1,2,3,33.33,57,25,36,90,-54,17,16,33,13338.0,3:22,0,0,0,159.0,0:2,6666667
8477957,Nikita,Scherbak,1995-12-30,RW,L,2018-19,8,1,0,1,0.12,-4,12,8.33,2,4885.0,10:10,0,0,0,0.0,9,1,0,1,-1,0,0,0,35.0,0:4,0,0,0,0.0,0:0,863333
8477958,Nikolay,Goldobin,1995-10-07,RW,L,2018-19,63,7,20,27,0.43,-10,105,6.67,18,56661.0,14:59,0,0,0,0.0,15,21,20,33,-13,1,8,9,9669.0,2:33,0,1,1,172.0,0:2,863333
8477959,Joshua,Ho-Sang,1996-01-22,RW,R,2018-19,10,1,1,2,0.2,2,10,10.0,6,8714.0,14:31,0,1,1,0.0,0,3,3,6,-3,0,0,0,1150.0,1:55,0,0,0,0.0,0:0,863333
8477960,Adrian,Kempe,1996-09-13,LW,L,2018-19,81,12,16,28,0.35,-10,118,10.17,50,70471.0,14:30,315,424,739,42.63,86,21,20,24,-4,0,4,4,6564.0,1:21,0,0,0,2654.0,0:32,894167
8477961,John,Quenneville,1996-04-16,C,L,2018-19,19,1,0,1,0.05,-1,16,6.25,4,12899.0,11:18,4,7,11,36.36,21,7,5,4,1,0,0,0,1153.0,1:0,0,0,0,7.0,0:0,811667
8477962,Brendan,Lemieux,1996-03-15,LW,L,2018-19,63,12,5,17,0.27,6,67,17.91,108,34200.0,9:2,7,13,20,35.0,129,31,13,14,-1,0,0,0,1156.0,0:18,0,0,0,189.0,0:3,839167
8477963,Jayce,Hawryluk,1996-01-01,C,R,2018-19,42,7,5,12,0.29,-8,35,20.0,16,23766.0,9:25,14,5,19,73.68,101,25,10,21,-11,0,1,1,353.0,0:8,0,0,0,0.0,0:0,925000
8477964,Ivan,Barbashev,1995-12-14,C,L,2018-19,80,14,12,26,0.32,-4,60,23.33,17,55268.0,11:30,201,240,441,45.58,86,31,36,14,22,0,0,0,241.0,0:3,2,0,2,7581.0,1:34,741667
8477969,Marcus,Pettersson,1996-05-08,D,L,2018-19,84,2,23,25,0.3,17,87,2.3,66,84077.0,16:40,1,0,1,100.0,101,108,24,43,-19,1,4,5,4321.0,0:51,0,1,1,4130.0,0:49,794167
8477971,Andreas,Englund,1996-01-21,D,L,2018-19,3,0,0,0,0.0,-2,2,0.0,10,2400.0,13:20,0,0,0,0.0,5,2,0,2,-2,0,0,0,6.0,0:2,0,0,0,123.0,0:41,775833
8477972,Josh,Jacobs,1996-02-15,D,R,2018-19,1,0,0,0,0.0,-1,1,0.0,0,894.0,14:54,0,0,0,0.0,2,1,0,3,-3,0,0,0,0.0,0:0,0,0,0,0.0,0:0,725833
8477973,Vladislav,Kamenev,1996-08-12,C,L,2018-19,23,2,3,5,0.22,-2,22,9.09,10,12474.0,9:2,59,59,118,50.0,20,4,2,5,-3,1,0,1,1378.0,0:59,1,0,1,940.0,0:40,833333
8477979,Nicolas,Aube-Kubel,1996-05-10,RW,R,2018-19,9,0,0,0,0.0,1,2,0.0,0,3018.0,5:35,0,0,0,0.0,14,0,2,0,2,0,0,0,26.0,0:2,0,0,0,0.0,0:0,680833
8477986,Brandon,Montour,1994-04-11,D,R,2018-19,82,8,27,35,0.43,-20,181,4.42,56,110447.0,22:26,0,0,0,0.0,99,121,31,74,-43,1,5,6,8932.0,1:48,0,0,0,8203.0,1:40,3387500
8477987,Ryan,Donato,1996-04-09,C,L,2018-19,56,10,15,25,0.45,-15,139,7.19,6,46028.0,13:41,11,17,28,39.29,24,21,30,22,8,3,5,8,6963.0,2:4,0,0,0,20.0,0:0,900000
8477989,Christian,Dvorak,1996-02-02,C,L,2018-19,20,2,5,7,0.35,-2,25,8.0,2,17262.0,14:23,125,101,226,55.31,16,7,12,14,-2,1,0,1,1598.0,1:19,0,0,0,56.0,0:2,839167
8477994,Dominic,Turgeon,1996-02-25,C,L,2018-19,4,0,0,0,0.0,-3,2,0.0,0,3021.0,12:35,8,13,21,38.1,3,3,1,0,1,0,0,0,0.0,0:0,0,0,0,405.0,1:41,686667
8477996,Juho,Lammikko,1996-01-29,RW,L,2018-19,40,0,6,6,0.15,-7,39,0.0,6,26236.0,10:55,142,190,332,42.77,45,21,12,12,0,0,0,0,182.0,0:4,0,1,1,4143.0,1:43,717500
8477998,Warren,Foegele,1996-04-01,LW,L,2018-19,77,10,5,15,0.19,-17,106,9.43,20,57721.0,12:29,10,11,21,47.62,126,19,36,31,5,0,0,0,465.0,0:6,0,0,0,5977.0,1:17,746667
8478010,Brayden,Point,1996-03-13,C,R,2018-19,79,41,51,92,1.16,27,191,21.47,28,89676.0,18:55,435,421,856,50.82,31,43,35,25,10,20,15,35,15958.0,3:22,0,0,0,455.0,0:5,686667
8478017,Mark,Friedman,1995-12-25,D,R,2018-19,1,0,0,0,0.0,-1,1,0.0,0,753.0,12:33,0,0,0,0.0,1,0,0,0,0,0,0,0,0.0,0:0,0,0,0,0.0,0:0,749167
8478020,Michael,Amadio,1996-05-13,C,R,2018-19,43,6,7,13,0.3,-1,37,16.22,6,26332.0,10:12,96,127,223,43.05,16,13,19,13,6,0,0,0,1664.0,0:38,0,0,0,9.0,0:0,717500
8478027,Lucas,Wallmark,1995-09-05,C,L,2018-19,81,10,18,28,0.35,-8,131,7.63,36,71889.0,14:47,575,554,1129,50.93,82,39,33,32,1,2,5,7,6038.0,1:14,0,0,0,4261.0,0:52,675000
8478029,Chase,De Leo,1995-10-25,C,L,2018-19,1,0,0,0,0.0,1,4,0.0,0,752.0,12:32,0,0,0,0.0,1,0,0,0,0,0,0,0,0.0,0:0,0,0,0,31.0,0:31,650000
8478031,Nelson,Nogier,1996-05-27,D,R,2018-19,1,0,0,0,0.0,0,1,0.0,0,606.0,10:6,0,0,0,0.0,0,1,0,0,0,0,0,0,0.0,0:0,0,0,0,0.0,0:0,713333
8478036,Christoffer,Ehn,1996-04-05,C,L,2018-19,60,3,6,9,0.15,-5,49,6.12,6,38211.0,10:36,84,93,177,47.46,70,39,10,15,-5,0,0,0,44.0,0:0,1,0,1,2768.0,0:46,759167
8478038,Devon,Toews,1994-02-21,D,L,2018-19,48,5,13,18,0.38,7,81,6.17,4,51539.0,17:53,0,1,1,0.0,24,30,14,28,-14,1,3,4,5107.0,1:46,0,0,0,195.0,0:4,700000
8478042,Viktor,Arvidsson,1993-04-08,LW,R,2018-19,58,34,14,48,0.83,12,195,17.44,26,66627.0,19:8,2,15,17,11.76,18,23,41,37,4,3,1,4,10121.0,2:54,2,1,3,4451.0,1:16,4250000
8478046,Danton,Heinen,1995-07-05,C,L,2018-19,77,11,23,34,0.44,13,114,9.65,16,64544.0,13:58,2,10,12,16.67,54,36,43,32,11,1,6,7,6336.0,1:22,0,0,0,594.0,0:7,872500
8478047,Michael,Bunting,1995-09-17,LW,L,2018-19,5,1,0,1,0.2,0,5,20.0,2,2867.0,9:33,0,0,0,0.0,6,1,0,0,0,0,0,0,0.0,0:0,0,0,0,0.0,0:0,715000
8478055,Gustav,Forsling,1996-06-12,D,L,2018-19,43,3,6,9,0.21,-9,57,5.26,30,44075.0,17:5,0,0,0,0.0,38,38,15,23,-8,0,0,0,558.0,0:12,0,0,0,2803.0,1:5,872500
8478056,Clark,Bishop,1996-03-29,C,L,2018-19,20,1,2,3,0.15,-3,16,6.25,6,11348.0,9:27,69,78,147,46.94,39,5,5,5,0,0,0,0,176.0,0:8,0,0,0,245.0,0:12,695000
8478067,Oskar,Lindblom,1996-08-15,LW,L,2018-19,81,17,16,33,0.41,-9,162,10.49,20,66795.0,13:44,3,7,10,30.0,68,52,26,28,-2,2,1,3,5256.0,1:4,0,0,0,3958.0,0:48,925000
8478075,Anders,Bjork,1996-08-05,LW,L,2018-19,20,1,2,3,0.15,-1,18,5.56,2,14159.0,11:47,1,0,1,100.0,9,12,11,9,2,0,0,0,1012.0,0:50,0,0,0,81.0,0:4,925000
8478078,Rourke,Chartier,1996-04-03,C,L,2018-19,13,1,0,1,0.08,-5,19,5.26,2,7334.0,9:24,34,51,85,40.0,14,3,0,1,-1,0,0,0,24.0,0:1,0,0,0,311.0,0:23,672500
8478099,Kevin,Labanc,1995-12-12,RW,R,2018-19,82,17,39,56,0.68,-1,130,13.08,36,68977.0,14:1,9,14,23,39.13,66,16,22,51,-29,2,18,20,11431.0,2:19,0,0,0,59.0,0:0,717500
8478104,Sammy,Blais,1996-06-17,LW,L,2018-19,32,2,2,4,0.12,-1,27,7.41,6,18918.0,9:51,1,1,2,50.0,93,12,11,11,0,0,0,0,374.0,0:11,0,0,0,0.0,0:0,673333
8478106,Dylan,Sikura,1995-06-01,RW,L,2018-19,33,0,8,8,0.24,2,52,0.0,0,22339.0,11:16,0,5,5,0.0,3,10,23,7,16,0,0,0,26.0,0:0,0,0,0,0.0,0:0,925000
8478109,Victor,Olofsson,1995-07-18,RW,L,2018-19,6,2,2,4,0.67,1,21,9.52,2,6486.0,18:1,0,0,0,0.0,2,3,1,3,-2,2,0,2,675.0,1:52,0,0,0,18.0,0:3,767500
8478131,Ondrej,Kase,1995-11-08,RW,R,2018-19,30,11,9,20,0.67,0,94,11.7,2,28184.0,15:39,9,18,27,33.33,17,11,15,18,-3,1,3,4,3947.0,2:11,0,0,0,46.0,0:1,2600000
8478176,Joe,Hicketts,1996-05-04,D,L,2018-19,11,0,0,0,0.0,-9,16,0.0,0,12269.0,18:35,0,0,0,0.0,17,27,2,7,-5,0,0,0,31.0,0:2,0,0,0,1724.0,2:36,636111
8478211,Dryden,Hunt,1995-11-24,LW,L,2018-19,31,3,7,10,0.32,0,53,5.66,8,20576.0,11:3,0,3,3,0.0,65,9,10,8,2,0,0,0,120.0,0:3,0,0,0,29.0,0:0,809167
8478233,Andrew,Mangiapane,1996-04-04,LW,L,2018-19,44,8,5,13,0.3,11,65,12.31,12,27836.0,10:32,6,3,9,66.67,43,17,16,11,5,0,0,0,1192.0,0:27,0,0,0,154.0,0:3,705000
8478268,Jack,Rodewald,1994-02-14,RW,R,2018-19,6,0,0,0,0.0,0,2,0.0,0,2542.0,7:3,0,0,0,0.0,8,3,0,0,0,0,0,0,2.0,0:0,0,0,0,0.0,0:0,706250
8478365,Danick,Martel,1994-12-12,LW,L,2018-19,9,0,2,2,0.22,3,16,0.0,8,5496.0,10:10,1,1,2,50.0,12,1,3,1,2,0,0,0,9.0,0:1,0,0,0,82.0,0:9,715000
8478366,Frank,Vatrano,1994-03-14,C,L,2018-19,81,24,15,39,0.48,-10,208,11.54,38,71259.0,14:39,15,23,38,39.47,139,74,33,30,3,2,6,8,8088.0,1:39,0,0,0,110.0,0:1,925000
8478373,Nikita,Soshnikov,1993-10-14,RW,L,2018-19,5,0,0,0,0.0,-1,1,0.0,0,2150.0,7:10,0,0,0,0.0,5,2,0,1,-1,0,0,0,8.0,0:1,0,0,0,0.0,0:0,800000
8478396,Noah,Hanifin,1997-01-25,D,L,2018-19,80,5,28,33,0.41,18,116,4.31,12,99712.0,20:46,0,0,0,0.0,87,83,50,87,-37,1,4,5,5285.0,1:6,1,1,2,8212.0,1:42,4950000
8478397,Rasmus,Andersson,1996-10-27,D,R,2018-19,79,2,17,19,0.24,17,115,1.74,23,76027.0,16:2,0,0,0,0.0,52,83,24,45,-21,0,2,2,4750.0,1:0,0,0,0,1751.0,0:22,755833
8478398,Kyle,Connor,1996-12-09,LW,L,2018-19,82,34,32,66,0.8,-7,227,14.98,18,94723.0,19:15,8,5,13,61.54,9,21,56,33,23,11,8,19,17134.0,3:28,1,0,1,3355.0,0:40,925000
8478399,Jonas,Siegenthaler,1997-05-06,D,L,2018-19,26,0,4,4,0.15,6,12,0.0,10,22079.0,14:9,0,0,0,0.0,31,44,3,20,-17,0,0,0,13.0,0:0,0,0,0,1642.0,1:3,714166
8478400,Colin,White,1997-01-30,C,R,2018-19,71,14,27,41,0.58,-24,123,11.38,24,69006.0,16:11,379,420,799,47.43,23,35,21,38,-17,5,3,8,9029.0,2:7,0,0,0,912.0,0:12,925000
8478401,Pavel,Zacha,1997-04-06,C,L,2018-19,61,13,12,25,0.41,-6,99,13.13,15,58851.0,16:4,348,364,712,48.88,68,24,28,31,-3,4,2,6,6181.0,1:41,2,1,3,7987.0,2:10,894167
8478402,Connor,McDavid,1997-01-13,C,L,2018-19,78,41,75,116,1.49,3,240,17.08,20,106878.0,22:50,428,490,918,46.62,39,30,99,89,10,9,24,33,16013.0,3:25,1,1,2,2928.0,0:37,12500000
8478403,Jack,Eichel,1996-10-28,C,R,2018-19,77,28,54,82,1.06,-11,303,9.24,26,94439.0,20:26,597,673,1270,47.01,70,51,38,76,-38,8,18,26,16283.0,3:31,0,0,0,2455.0,0:31,10000000
8478407,Vince,Dunn,1996-10-29,D,L,2018-19,78,12,23,35,0.45,14,150,8.0,45,82052.0,17:31,0,1,1,0.0,48,68,18,49,-31,3,5,8,9899.0,2:6,0,0,0,501.0,0:6,722500
8478408,Travis,Dermott,1996-12-22,D,L,2018-19,64,4,13,17,0.27,-5,98,4.08,22,66458.0,17:18,0,0,0,0.0,100,57,26,55,-29,0,0,0,504.0,0:7,0,0,0,4043.0,1:3,863333
8478413,Jordan,Greenway,1997-02-16,LW,L,2018-19,81,12,12,24,0.3,-12,109,11.01,29,66235.0,13:37,31,50,81,38.27,57,40,34,20,14,0,0,0,3203.0,0:39,0,0,0,129.0,0:1,916666
8478414,Timo,Meier,1996-10-08,RW,L,2018-19,78,30,36,66,0.85,9,250,12.0,55,79432.0,16:58,12,26,38,31.58,99,40,49,38,11,6,4,10,8452.0,1:48,0,1,1,2408.0,0:30,894167
8478415,Jakub,Zboril,1997-02-21,D,L,2018-19,2,0,0,0,0.0,0,1,0.0,0,1312.0,10:56,0,0,0,0.0,3,0,0,2,-2,0,0,0,0.0,0:0,0,0,0,4.0,0:2,863333
8478416,Erik,Cernak,1997-05-28,D,R,2018-19,58,5,11,16,0.28,25,107,4.67,58,66993.0,19:15,0,0,0,0.0,198,79,11,19,-8,1,0,1,295.0,0:5,0,0,0,8272.0,2:22,697500
8478417,Jakob,Forsbacka Karlsson,1996-10-31,C,R,2018-19,28,3,6,9,0.32,1,21,14.29,2,19813.0,11:47,95,131,226,42.04,14,9,9,4,5,0,1,1,601.0,0:21,0,0,0,465.0,0:16,916667
8478420,Mikko,Rantanen,1996-10-29,RW,L,2018-19,74,31,56,87,1.18,13,193,16.06,54,92538.0,20:50,17,29,46,36.96,59,41,39,35,4,16,17,33,18162.0,4:5,0,0,0,91.0,0:1,894167
8478421,A.J.,Greer,1996-12-14,LW,L,2018-19,15,1,1,2,0.13,-2,9,11.11,14,5641.0,6:16,2,3,5,40.0,20,5,4,1,3,0,0,0,0.0,0:0,0,0,0,0.0,0:0,741666
8478425,Brendan,Guhle,1997-07-29,D,L,2018-19,8,0,1,1,0.12,-2,15,0.0,4,7207.0,15:0,0,0,0,0.0,9,7,1,1,0,0,0,0,492.0,1:1,0,0,0,4.0,0:0,697500
8478427,Sebastian,Aho,1997-07-26,RW,L,2018-19,82,30,53,83,1.01,25,243,12.35,26,99142.0,20:9,585,619,1204,48.59,65,34,81,64,17,3,21,24,14765.0,3:0,4,1,5,5484.0,1:6,925000
8478430,Oliver,Kylington,1997-05-19,D,L,2018-19,38,3,5,8,0.21,3,21,14.29,10,28322.0,12:25,0,0,0,0.0,11,41,13,32,-19,0,0,0,44.0,0:1,0,0,0,79.0,0:2,730833
8478432,Christian,Fischer,1997-04-15,RW,R,2018-19,71,11,7,18,0.25,-13,116,9.48,27,56102.0,13:10,2,5,7,28.57,124,19,12,12,0,0,0,0,7013.0,1:38,0,0,0,47.0,0:0,821666
8478439,Travis,Konecny,1997-03-11,C,R,2018-19,82,24,25,49,0.6,-4,182,13.19,40,75080.0,15:15,7,15,22,31.82,65,45,38,49,-11,4,4,8,7966.0,1:37,0,0,0,60.0,0:0,894167
8478440,Dylan,Strome,1997-03-07,C,L,2018-19,78,20,37,57,0.73,-8,145,13.79,20,75602.0,16:9,434,463,897,48.38,13,46,47,34,13,6,10,16,14018.0,2:59,0,0,0,110.0,0:1,863333
8478442,Cooper,Marody,1996-12-20,C,R,2018-19,6,0,0,0,0.0,-1,6,0.0,0,2488.0,6:54,9,17,26,34.62,0,0,5,0,5,0,0,0,33.0,0:5,0,0,0,0.0,0:0,925000
8478443,Brandon,Carlo,1996-11-26,D,R,2018-19,72,2,8,10,0.14,22,116,1.72,47,90386.0,20:55,1,0,1,100.0,134,88,43,42,1,0,0,0,242.0,0:3,0,2,2,11997.0,2:46,789167
8478444,Brock,Boeser,1997-02-25,RW,R,2018-19,69,26,30,56,0.81,-2,209,12.44,22,79338.0,19:9,39,51,90,43.33,14,22,40,33,7,6,9,15,14650.0,3:32,0,0,0,111.0,0:1,925000
8478445,Mathew,Barzal,1997-05-26,C,R,2018-19,82,18,44,62,0.76,-5,179,10.06,46,88181.0,17:55,241,339,580,41.55,25,56,66,117,-51,3,15,18,14462.0,2:56,0,0,0,330.0,0:4,863333
8478449,Roope,Hintz,1996-11-17,LW,L,2018-19,58,9,13,22,0.38,-11,99,9.09,24,48916.0,14:3,217,183,400,54.25,87,36,33,23,10,3,3,6,6138.0,1:45,0,0,0,955.0,0:16,811667
8478452,Caleb,Jones,1997-06-06,D,L,2018-19,17,1,5,6,0.35,-9,21,4.76,6,20193.0,19:47,0,0,0,0.0,20,18,13,17,-4,0,1,1,700.0,0:41,0,0,0,1144.0,1:7,720000
8478454,Noah,Juulsen,1997-04-02,D,R,2018-19,21,1,4,5,0.24,5,22,4.55,6,21565.0,17:6,0,0,0,0.0,60,39,6,17,-11,0,0,0,39.0,0:1,0,0,0,2677.0,2:7,863333
8478455,Austin,Wagner,1997-06-23,LW,L,2018-19,62,12,9,21,0.34,2,67,17.91,16,33216.0,8:55,2,4,6,33.33,142,9,8,18,-10,0,0,0,198.0,0:3,0,0,0,0.0,0:0,759167
8478458,Jack,Roslovic,1997-01-29,C,R,2018-19,77,9,15,24,0.31,-2,74,12.16,4,45014.0,9:44,91,118,209,43.54,32,21,25,18,7,5,2,7,2826.0,0:36,0,0,0,21.0,0:0,894166
8478460,Zach,Werenski,1997-07-19,D,L,2018-19,82,11,33,44,0.54,-12,168,6.55,18,112666.0,22:53,0,0,0,0.0,67,89,40,46,-6,2,13,15,12072.0,2:27,0,0,0,6345.0,1:17,925000
8478462,Nicolas,Roy,1997-02-05,C,R,2018-19,6,0,0,0,0.0,0,1,0.0,2,2502.0,6:57,21,18,39,53.85,7,1,3,1,2,0,0,0,0.0,0:0,0,0,0,35.0,0:5,720000
8478463,Anthony,Beauvillier,1997-06-08,C,L,2018-19,81,18,10,28,0.35,1,156,11.54,8,71161.0,14:38,26,31,57,45.61,87,35,34,30,4,1,1,2,8038.0,1:39,0,0,0,22.0,0:0,894167
8478465,Guillaume,Brisebois,1997-07-21,D,L,2018-19,8,0,0,0,0.0,-4,5,0.0,0,5284.0,11:0,0,0,0,0.0,3,7,2,7,-5,0,0,0,17.0,0:2,0,0,0,0.0,0:0,697500
8478466,Daniel,Sprong,1997-03-17,RW,R,2018-19,63,14,9,23,0.37,-16,125,11.2,10,45187.0,11:57,4,10,14,28.57,35,14,18,32,-14,2,3,5,4767.0,1:15,0,0,0,15.0,0:0,750000
8478468,Jeremy,Lauzon,1997-04-28,D,L,2018-19,16,1,0,1,0.06,-1,11,9.09,2,14917.0,15:32,0,0,0,0.0,15,15,4,5,-1,0,0,0,31.0,0:1,0,0,0,2059.0,2:8,747500
8478469,Thomas,Chabot,1997-01-30,D,L,2018-19,70,14,41,55,0.79,-12,185,7.57,32,102013.0,24:17,0,0,0,0.0,71,112,31,72,-41,1,15,16,12341.0,2:56,1,0,1,2501.0,0:35,863333
8478472,Mathieu,Joseph,1997-02-09,RW,L,2018-19,70,13,13,26,0.37,5,95,13.68,26,47706.0,11:21,10,24,34,29.41,129,14,28,24,4,0,0,0,895.0,0:12,0,2,2,2902.0,0:41,728333
8478474,Lawson,Crouse,1997-06-23,LW,L,2018-19,81,11,14,25,0.31,5,131,8.4,67,62925.0,12:56,24,34,58,41.38,288,44,25,23,2,0,0,0,402.0,0:4,2,0,2,6287.0,1:17,894167
8478476,Kyle,Capobianco,1997-08-13,D,L,2018-19,2,0,0,0,0.0,-2,1,0.0,0,1929.0,16:4,0,0,0,0.0,2,2,0,0,0,0,0,0,195.0,1:37,0,0,0,0.0,0:0,745000
8478483,Mitchell,Marner,1997-05-05,C,R,2018-19,82,26,68,94,1.15,22,233,11.16,22,97526.0,19:49,7,4,11,63.64,29,43,78,67,11,3,18,21,12737.0,2:35,1,2,3,6669.0,1:21,894167
8478485,Zach,Senyshyn,1997-03-30,RW,R,2018-19,2,1,0,1,0.5,0,4,25.0,0,1391.0,11:35,0,0,0,0.0,1,0,0,1,-1,0,0,0,0.0,0:0,0,0,0,42.0,0:21,863333
8478488,Filip,Chlapik,1997-06-03,C,L,2018-19,5,1,0,1,0.2,-2,9,11.11,4,4159.0,13:51,8,16,24,33.33,1,4,2,2,0,0,0,0,491.0,1:38,0,0,0,0.0,0:0,728333
8478491,Jacob,Larsson,1997-04-29,D,L,2018-19,49,0,5,5,0.1,-4,57,0.0,16,50317.0,17:6,0,1,1,0.0,41,59,10,30,-20,0,0,0,132.0,0:2,0,0,0,3628.0,1:14,894166
8478493,Joel,Eriksson Ek,1997-01-29,C,L,2018-19,58,7,7,14,0.24,-7,111,6.31,20,47007.0,13:30,247,293,540,45.74,117,24,18,9,9,0,0,0,571.0,0:9,0,0,0,4765.0,1:22,894167
8478495,Denis,Gurianov,1997-06-07,RW,L,2018-19,21,1,3,4,0.19,-3,23,4.35,0,13699.0,10:52,1,1,2,50.0,23,9,2,5,-3,0,1,1,1387.0,1:6,0,0,0,57.0,0:2,894166
8478498,Jake,DeBrusk,1996-10-17,LW,L,2018-19,68,27,15,42,0.62,2,156,17.31,18,65940.0,16:9,8,30,38,21.05,45,24,42,27,15,8,3,11,10874.0,2:39,0,0,0,924.0,0:13,863333
8478500,Ivan,Provorov,1997-01-13,D,L,2018-19,82,7,19,26,0.32,-16,145,4.83,32,123551.0,25:6,0,1,1,0.0,123,149,16,92,-76,0,2,2,7644.0,1:33,0,0,0,14293.0,2:54,894167
8478506,Gabriel,Carlsson,1997-01-02,D,L,2018-19,1,0,0,0,0.0,-1,1,0.0,2,561.0,9:21,0,0,0,0.0,0,0,1,0,1,0,0,0,0.0,0:0,0,0,0,59.0,0:59,894166
8478512,Austin,Czarnik,1992-12-12,C,R,2018-19,54,6,12,18,0.33,-1,65,9.23,8,36718.0,11:19,30,34,64,46.88,10,24,24,15,9,0,3,3,4198.0,1:17,0,0,0,307.0,0:5,1250000
8478519,Anthony,Cirelli,1997-07-15,C,L,2018-19,82,19,20,39,0.48,25,123,15.45,34,73047.0,14:50,502,449,951,52.79,94,49,47,15,32,0,1,1,1457.0,0:17,5,1,6,13359.0,2:42,728333
8478541,Markus,Hannikainen,1993-03-26,LW,L,2018-19,44,4,3,7,0.16,-5,52,7.69,2,25022.0,9:28,0,3,3,0.0,63,8,15,1,14,0,0,0,164.0,0:3,0,0,0,431.0,0:9,675000
8478542,Evan,Rodrigues,1993-07-28,LW,R,2018-19,74,9,20,29,0.39,-7,168,5.36,25,70257.0,15:49,304,351,655,46.41,33,33,34,39,-5,2,2,4,6032.0,1:21,0,3,3,7412.0,1:40,650000
8478550,Artemi,Panarin,1991-10-30,LW,R,2018-19,79,28,59,87,1.1,14,191,14.66,23,94120.0,19:51,1,3,4,25.0,14,17,31,56,-25,6,12,18,13291.0,2:48,0,0,0,204.0,0:2,6000000
8478561,Andreas,Martinsen,1990-06-13,LW,L,2018-19,24,1,3,4,0.17,-5,21,4.76,14,11426.0,7:56,3,4,7,42.86,83,9,3,7,-4,0,0,0,30.0,0:1,0,0,0,338.0,0:14,650000
8478567,Dean,Kukan,1993-07-08,D,L,2018-19,25,0,5,5,0.2,6,16,0.0,6,20198.0,13:27,0,0,0,0.0,16,21,4,5,-1,0,0,0,25.0,0:1,0,0,0,34.0,0:1,725000
8478569,Noel,Acciari,1991-12-01,C,R,2018-19,72,6,8,14,0.19,-3,99,6.06,47,56099.0,12:59,200,203,403,49.63,221,36,35,13,22,0,0,0,185.0,0:2,0,0,0,6762.0,1:33,725000
8478585,Derek,Ryan,1986-12-29,C,R,2018-19,81,13,25,38,0.47,21,103,12.62,24,67087.0,13:48,440,316,756,58.2,19,19,54,54,0,2,5,7,8186.0,1:41,0,4,4,9416.0,1:56,3125000
8478831,Kevin,Stenlund,1996-09-20,C,R,2018-19,4,0,0,0,0.0,0,3,0.0,4,2631.0,10:57,3,3,6,50.0,3,1,3,1,2,0,0,0,5.0,0:1,0,0,0,0.0,0:0,864166
8478840,William,Borgen,1996-12-19,D,R,2018-19,4,0,0,0,0.0,-5,2,0.0,0,3972.0,16:33,0,0,0,0.0,12,3,0,0,0,0,0,0,0.0,0:0,0,0,0,178.0,0:44,864166
8478841,Colton,White,1997-05-03,D,L,2018-19,3,0,0,0,0.0,-2,1,0.0,2,2561.0,14:13,0,0,0,0.0,2,2,0,1,-1,0,0,0,56.0,0:18,0,0,0,10.0,0:3,728333
8478843,Denis,Malgin,1997-01-18,C,R,2018-19,50,7,9,16,0.32,-10,66,10.61,14,38668.0,12:53,36,56,92,39.13,40,21,16,15,1,0,1,1,1514.0,0:30,0,0,0,1629.0,0:32,690000
8478844,Mikhail,Vorobyev,1997-01-05,C,L,2018-19,15,1,1,2,0.13,0,10,10.0,2,8400.0,9:20,25,46,71,35.21,4,4,5,4,1,0,0,0,807.0,0:53,0,0,0,0.0,0:0,-111
8478846,Christian,Wolanin,1995-03-17,D,L,2018-19,30,4,8,12,0.4,3,36,11.11,6,31186.0,17:19,0,0,0,0.0,11,31,15,25,-10,0,3,3,3366.0,1:52,0,0,0,102.0,0:3,925000
8478856,Conor,Garland,1996-03-11,RW,R,2018-19,47,13,5,18,0.38,1,118,11.02,12,36068.0,12:47,10,8,18,55.56,33,17,25,10,15,4,2,6,6743.0,2:23,0,0,0,1.0,0:0,680556
8478866,Dominik,Simon,1994-08-08,C,L,2018-19,71,8,20,28,0.39,8,121,6.61,18,56764.0,13:19,6,13,19,31.58,89,19,33,33,0,1,2,3,3492.0,0:49,0,0,0,19.0,0:0,750000
8478868,Christian,Jaros,1996-04-02,D,R,2018-19,61,1,9,10,0.16,-14,65,1.54,27,52584.0,14:22,0,0,0,0.0,110,82,17,40,-23,0,2,2,1089.0,0:17,0,0,0,2165.0,0:35,755000
8478870,Rudolfs,Balcers,1997-04-08,LW,L,2018-19,36,5,9,14,0.39,-7,48,10.42,10,26685.0,12:21,1,6,7,14.29,18,24,11,15,-4,3,1,4,3111.0,1:26,0,0,0,485.0,0:13,759167
8478873,Troy,Terry,1997-09-10,RW,R,2018-19,32,4,9,13,0.41,8,25,16.0,2,26776.0,13:56,1,4,5,20.0,4,12,14,16,-2,2,4,6,3613.0,1:52,0,0,0,75.0,0:2,925000
8478874,Adam,Gaudette,1996-10-03,C,R,2018-19,56,5,7,12,0.21,-8,55,9.09,18,36789.0,10:56,150,221,371,40.43,48,15,10,7,3,0,2,2,4596.0,1:22,0,0,0,5.0,0:0,916667
8478881,Brett,Seney,1996-02-28,LW,L,2018-19,51,5,8,13,0.25,-14,49,10.2,31,31604.0,10:19,98,162,260,37.69,48,15,17,17,0,0,1,1,511.0,0:10,0,0,0,152.0,0:2,757500
8478891,Mason,Appleton,1996-01-15,C,R,2018-19,36,3,7,10,0.28,9,29,10.34,4,17721.0,8:12,0,1,1,0.0,28,12,4,5,-1,0,0,0,89.0,0:2,0,0,0,531.0,0:14,741667
8478906,Markus,Nutivaara,1994-06-06,D,L,2018-19,80,5,16,21,0.26,3,99,5.05,6,84863.0,17:40,0,0,0,0.0,80,61,25,23,2,0,0,0,800.0,0:10,0,0,0,788.0,0:9,2700000
8478911,Matt,Roy,1995-03-01,D,R,2018-19,25,2,4,6,0.24,-1,34,5.88,8,25696.0,17:7,0,0,0,0.0,38,47,4,17,-13,0,0,0,225.0,0:9,0,0,0,2271.0,1:30,833750
8478915,Sami,Niku,1996-10-10,D,L,2018-19,30,1,3,4,0.13,0,19,5.26,2,25052.0,13:55,0,0,0,0.0,10,30,3,11,-8,0,0,0,179.0,0:5,0,0,0,34.0,0:1,775000
8478949,Kole,Sherwood,1997-01-22,RW,R,2018-19,2,0,0,0,0.0,0,2,0.0,0,1107.0,9:13,0,0,0,0.0,10,1,1,0,1,0,0,0,97.0,0:48,0,0,0,0.0,0:0,694444
8479026,Philippe,Myers,1997-01-25,D,R,2018-19,21,1,1,2,0.1,-5,25,4.0,2,19362.0,15:22,0,0,0,0.0,42,8,7,13,-6,0,0,0,142.0,0:6,0,0,0,910.0,0:43,678889
8479066,Ryan,Lomberg,1994-12-09,LW,L,2018-19,4,0,0,0,0.0,0,1,0.0,17,1676.0,6:59,0,0,0,0.0,12,0,1,0,1,0,0,0,106.0,0:26,0,0,0,0.0,0:0,710000
8479206,Tanner,Fritz,1991-08-20,C,R,2018-19,8,0,1,1,0.12,-3,6,0.0,2,5195.0,10:49,17,24,41,41.46,18,6,1,1,0,0,0,0,0.0,0:0,0,0,0,167.0,0:20,650000
8479250,Nick,Lappin,1992-11-01,RW,R,2018-19,11,0,0,0,0.0,-6,11,0.0,0,9034.0,13:41,5,1,6,83.33,16,3,3,2,1,0,0,0,791.0,1:11,0,0,0,43.0,0:3,700000
8479268,Casey,Nelson,1992-07-18,D,R,2018-19,38,1,5,6,0.16,1,37,2.7,13,35133.0,15:24,0,0,0,0.0,44,36,5,19,-14,0,0,0,33.0,0:0,0,0,0,2613.0,1:8,812500
8479290,Kalle,Kossila,1993-04-14,C,L,2018-19,8,1,0,1,0.12,-1,11,9.09,4,4946.0,10:18,30,28,58,51.72,5,3,0,2,-2,0,0,0,58.0,0:7,0,0,0,889.0,1:51,650000
8479291,Kevin,Rooney,1993-05-21,C,L,2018-19,41,6,4,10,0.24,-4,39,15.38,15,31028.0,12:36,187,192,379,49.34,77,22,15,9,6,0,0,0,79.0,0:1,1,0,1,4713.0,1:54,700000
8479293,Brandon,Tanev,1991-12-31,LW,L,2018-19,80,14,15,29,0.36,9,127,11.02,41,67729.0,14:6,3,5,8,37.5,278,81,22,18,4,0,0,0,289.0,0:3,2,1,3,10249.0,2:8,1150000
8479314,Matthew,Tkachuk,1997-12-11,LW,L,2018-19,80,34,43,77,0.96,14,207,16.43,62,84475.0,17:35,6,7,13,46.15,104,13,42,56,-14,11,13,24,15329.0,3:11,0,0,0,176.0,0:2,925000
8479315,Joey,Anderson,1998-06-19,RW,R,2018-19,34,4,3,7,0.21,-7,49,8.16,6,26319.0,12:54,9,8,17,52.94,42,11,12,3,9,0,0,0,415.0,0:12,1,0,1,2605.0,1:16,925000
8479316,Luke,Kunin,1997-12-04,C,R,2018-19,49,6,11,17,0.35,-9,88,6.82,27,46703.0,15:53,88,112,200,44.0,67,34,12,15,-3,0,1,1,3765.0,1:16,0,0,0,4260.0,1:26,925000
8479318,Auston,Matthews,1997-09-17,C,L,2018-19,68,37,36,73,1.07,-9,251,14.74,12,75704.0,18:33,475,436,911,52.14,28,60,57,67,-10,12,8,20,10479.0,2:34,0,0,0,124.0,0:1,925000
8479320,Maxime,Lajoie,1997-11-05,D,L,2018-19,56,7,8,15,0.27,-25,79,8.86,20,63523.0,18:54,0,0,0,0.0,34,82,13,48,-35,4,4,8,5532.0,1:38,0,0,0,6216.0,1:51,710000
8479324,Ryan,Lindgren,1998-02-11,D,L,2018-19,5,0,0,0,0.0,-6,8,0.0,8,4376.0,14:35,0,0,0,0.0,11,9,0,2,-2,0,0,0,0.0,0:0,0,0,0,218.0,0:43,925000
8479325,Charlie,McAvoy,1997-12-21,D,R,2018-19,54,7,21,28,0.52,14,79,8.86,45,71840.0,22:10,0,0,0,0.0,92,91,30,54,-24,1,1,2,5105.0,1:34,0,1,1,4208.0,1:17,916667
8479330,Brandon,Gignac,1997-11-07,C,L,2018-19,1,0,0,0,0.0,-2,1,0.0,0,544.0,9:4,0,0,0,0.0,0,1,0,2,-2,0,0,0,0.0,0:0,0,0,0,0.0,0:0,714166
8479333,Libor,Hajek,1998-02-04,D,L,2018-19,5,1,0,1,0.2,1,10,10.0,6,4959.0,16:31,0,0,0,0.0,5,3,4,5,-1,0,0,0,40.0,0:8,0,0,0,272.0,0:54,833333
8479336,Carl,Grundstrom,1997-12-01,RW,L,2018-19,15,5,1,6,0.4,-4,26,19.23,6,13472.0,14:58,0,0,0,0.0,38,3,8,5,3,0,1,1,1807.0,2:0,0,0,0,11.0,0:0,925000
8479337,Alex,DeBrincat,1997-12-18,RW,R,2018-19,82,41,35,76,0.93,0,220,18.64,15,87084.0,17:42,16,19,35,45.71,35,26,51,50,1,13,11,24,16069.0,3:15,0,0,0,552.0,0:6,778333
8479339,Patrik,Laine,1998-04-19,RW,R,2018-19,82,30,20,50,0.61,-24,245,12.24,42,84787.0,17:13,11,19,30,36.67,70,44,28,48,-20,15,8,23,17256.0,3:30,0,0,0,71.0,0:0,925000
8479343,Clayton,Keller,1998-07-29,C,L,2018-19,82,14,33,47,0.57,-21,200,7.0,24,89717.0,18:14,28,56,84,33.33,16,21,46,37,9,1,18,19,17335.0,3:31,0,0,0,701.0,0:8,885833
8479344,Jesse,Puljujarvi,1998-05-07,RW,R,2018-19,46,4,5,9,0.2,-14,53,7.55,16,32991.0,11:57,2,2,4,50.0,46,26,20,29,-9,0,1,1,1231.0,0:26,0,0,0,86.0,0:1,925000
8479345,Jakob,Chychrun,1998-03-31,D,L,2018-19,53,5,15,20,0.38,-12,117,4.27,28,64410.0,20:15,0,0,0,0.0,74,77,20,38,-18,3,5,8,8093.0,2:32,0,0,0,162.0,0:3,925000
8479346,Dillon,Dube,1998-07-20,C,L,2018-19,25,1,4,5,0.2,2,22,4.55,4,15101.0,10:4,16,24,40,40.0,11,3,6,6,0,0,0,0,705.0,0:28,0,0,0,437.0,0:17,778333
8479351,Sam,Steel,1998-02-03,C,L,2018-19,22,6,5,11,0.5,2,33,18.18,8,19754.0,14:57,108,112,220,49.09,9,6,7,10,-3,0,2,2,2100.0,1:35,1,0,1,692.0,0:31,863333
8479353,Brett,Howden,1998-03-29,C,L,2018-19,66,6,17,23,0.35,-16,74,8.11,14,59157.0,14:56,353,376,729,48.42,64,47,28,37,-9,0,2,2,5419.0,1:22,0,0,0,4967.0,1:15,863333
8479364,Tim,Gettinger,1998-04-14,LW,L,2018-19,4,0,0,0,0.0,0,2,0.0,0,1805.0,7:31,0,0,0,0.0,15,3,0,3,-3,0,0,0,0.0,0:0,0,0,0,0.0,0:0,730000
8479365,Trent,Frederic,1998-02-11,C,L,2018-19,15,0,0,0,0.0,-4,19,0.0,15,8460.0,9:24,41,40,81,50.62,18,3,5,2,3,0,0,0,305.0,0:20,0,0,0,91.0,0:6,925000
8479366,Logan,Brown,1998-03-05,C,L,2018-19,2,0,0,0,0.0,-2,2,0.0,0,1262.0,10:31,2,6,8,25.0,0,1,1,0,1,0,0,0,305.0,2:32,0,0,0,0.0,0:0,863333
8479368,Max,Jones,1998-02-17,LW,L,2018-19,30,2,3,5,0.17,-1,58,3.45,14,23714.0,13:10,1,2,3,33.33,30,5,12,9,3,0,1,1,1152.0,0:38,0,0,0,1375.0,0:45,863333
8479370,Tyson,Jost,1998-03-14,C,L,2018-19,70,11,15,26,0.37,-2,114,9.65,14,54625.0,13:0,55,91,146,37.67,48,35,29,8,21,4,1,5,8707.0,2:4,0,0,0,35.0,0:0,885833
8479371,Dante,Fabbro,1998-06-20,D,R,2018-19,4,1,0,1,0.25,-1,5,20.0,0,3057.0,12:44,0,0,0,0.0,3,6,2,1,1,0,0,0,0.0,0:0,0,0,0,53.0,0:13,925000
8479372,Josh,Mahura,1998-05-05,D,L,2018-19,17,1,4,5,0.29,0,20,5.0,4,14590.0,14:18,0,0,0,0.0,6,18,7,8,-1,0,3,3,884.0,0:52,0,0,0,94.0,0:5,745000
8479376,Victor,Mete,1998-06-07,D,L,2018-19,71,0,13,13,0.18,17,65,0.0,6,75713.0,17:46,0,0,0,0.0,21,95,10,57,-47,0,0,0,1330.0,0:18,0,0,0,3772.0,0:53,748333
8479385,Jordan,Kyrou,1998-05-05,C,R,2018-19,16,1,2,3,0.19,-1,16,6.25,4,9273.0,9:39,2,0,2,100.0,2,3,3,3,0,0,0,0,284.0,0:17,0,0,0,0.0,0:0,758333
8479388,Riley,Stillman,1998-03-09,D,L,2018-19,1,0,0,0,0.0,0,1,0.0,2,682.0,11:22,0,0,0,0.0,5,0,0,1,-1,0,0,0,0.0,0:0,0,0,0,0.0,0:0,773333
8479395,Dennis,Cholowski,1998-02-15,D,L,2018-19,52,7,9,16,0.31,-20,71,9.86,16,56950.0,18:15,1,0,1,100.0,18,50,7,50,-43,4,5,9,7655.0,2:27,0,0,0,664.0,0:12,894166
8479398,Samuel,Girard,1998-05-12,D,L,2018-19,82,4,23,27,0.33,8,116,3.45,6,97871.0,19:53,1,0,1,100.0,65,90,25,44,-19,0,9,9,9975.0,2:1,0,0,0,660.0,0:8,728333
8479400,Pierre-Luc,Dubois,1998-06-24,C,L,2018-19,82,27,34,61,0.74,16,174,15.52,64,87160.0,17:42,455,592,1047,43.46,115,52,45,54,-9,2,7,9,11313.0,2:17,0,0,0,879.0,0:10,894166
8479402,Jake,Bean,1998-06-09,D,L,2018-19,2,0,0,0,0.0,0,1,0.0,2,1015.0,8:27,0,0,0,0.0,1,0,1,0,1,0,0,0,19.0,0:9,0,0,0,0.0,0:0,863333
8479404,Henrik,Borgstrom,1997-08-06,C,L,2018-19,50,8,10,18,0.36,-14,54,14.81,4,36009.0,12:0,165,240,405,40.74,11,12,21,25,-4,3,4,7,3337.0,1:6,0,0,0,62.0,0:1,925000
8479407,Jesper,Bratt,1998-07-30,LW,L,2018-19,51,8,25,33,0.65,-8,91,8.79,6,46413.0,15:10,4,3,7,57.14,36,22,17,24,-7,1,7,8,6632.0,2:10,0,0,0,510.0,0:10,749167
8479410,Mikhail,Sergachev,1998-06-25,D,L,2018-19,75,6,26,32,0.43,12,128,4.69,28,80655.0,17:55,1,1,2,50.0,97,93,18,50,-32,0,6,6,6800.0,1:30,0,0,0,1030.0,0:13,894166
8479414,Nathan,Bastian,1997-12-06,RW,R,2018-19,7,3,0,3,0.43,0,13,23.08,10,5326.0,12:40,3,0,3,100.0,24,1,1,0,1,0,0,0,681.0,1:37,0,0,0,0.0,0:0,714166
8479415,Michael,McLeod,1998-02-03,C,R,2018-19,21,0,3,3,0.14,-8,21,0.0,13,15367.0,12:11,70,62,132,53.03,41,4,12,10,2,0,0,0,384.0,0:18,0,0,0,110.0,0:5,863333
8479416,Ben,Gleason,1998-03-25,D,L,2018-19,4,0,1,1,0.25,-1,2,0.0,0,3571.0,14:52,0,0,0,0.0,2,1,4,3,1,0,0,0,230.0,0:57,0,0,0,0.0,0:0,-111
8479420,Tage,Thompson,1997-10-30,C,R,2018-19,65,7,5,12,0.18,-22,108,6.48,20,47306.0,12:7,10,10,20,50.0,66,9,24,32,-8,1,0,1,3370.0,0:51,0,0,0,112.0,0:1,925000
8479423,Alexander,Nylander,1998-03-02,RW,R,2018-19,12,2,2,4,0.33,-4,16,12.5,4,8779.0,12:11,2,1,3,66.67,1,1,1,4,-3,1,0,1,705.0,0:58,0,0,0,0.0,0:0,863333
8479425,Filip,Hronek,1997-11-02,D,R,2018-19,46,5,18,23,0.5,-10,73,6.85,30,55092.0,19:57,0,0,0,0.0,66,32,10,47,-37,1,4,5,4631.0,1:40,0,1,1,3221.0,1:10,714166
8479442,Troy,Stecher,1994-04-07,D,R,2018-19,78,2,21,23,0.29,9,105,1.9,32,93211.0,19:55,0,0,0,0.0,91,96,42,32,10,0,2,2,4121.0,0:52,1,0,1,6724.0,1:26,2325000
8479447,Anthony,Greco,1993-09-30,RW,R,2018-19,1,0,0,0,0.0,-3,2,0.0,0,570.0,9:30,0,0,0,0.0,0,0,0,0,0,0,0,0,0.0,0:0,0,0,0,0.0,0:0,667500
8479458,Nikita,Zaitsev,1991-10-29,D,R,2018-19,81,3,11,14,0.17,2,71,4.23,18,99502.0,20:28,0,0,0,0.0,139,151,18,79,-61,0,0,0,337.0,0:4,0,0,0,13873.0,2:51,4500000
8479465,Drake,Caggiula,1994-06-20,LW,L,2018-19,55,12,11,23,0.42,-5,96,12.5,28,47614.0,14:25,16,27,43,37.21,135,26,18,22,-4,0,0,0,1404.0,0:25,1,0,1,2285.0,0:41,1500000
8479466,Patrick,Russell,1993-01-04,RW,R,2018-19,6,0,0,0,0.0,0,6,0.0,2,3164.0,8:47,0,0,0,0.0,9,2,3,2,1,0,0,0,63.0,0:10,0,0,0,164.0,0:27,700000
8479482,Michal,Kempny,1990-09-08,D,L,2018-19,71,6,19,25,0.35,24,111,5.41,60,81736.0,19:11,0,0,0,0.0,84,135,21,47,-26,0,0,0,59.0,0:0,0,0,0,7007.0,1:38,2500000
8479511,Janne,Kuokkanen,1998-05-25,C,L,2018-19,7,0,0,0,0.0,-2,6,0.0,4,4586.0,10:55,0,0,0,0.0,0,3,2,1,1,0,0,0,938.0,2:14,0,0,0,48.0,0:6,811666
8479553,Maxim,Mamin,1995-01-13,C,L,2018-19,7,0,0,0,0.0,-2,8,0.0,5,3086.0,7:20,0,1,1,0.0,10,1,1,0,1,0,0,0,27.0,0:3,0,0,0,0.0,0:0,757500
8479580,Dylan,Gambrell,1996-08-26,C,R,2018-19,8,0,0,0,0.0,1,6,0.0,2,4142.0,8:37,20,19,39,51.28,13,1,5,0,5,0,0,0,15.0,0:1,0,0,0,165.0,0:20,925000
8479644,Matt,Luff,1997-05-05,RW,R,2018-19,33,8,3,11,0.33,-2,45,17.78,9,22010.0,11:6,1,3,4,25.0,17,19,4,12,-8,1,0,1,1026.0,0:31,0,0,0,0.0,0:0,677777
8479657,Alexandre,Fortin,1997-02-25,LW,L,2018-19,24,3,3,6,0.25,-6,29,10.34,2,15251.0,10:35,11,6,17,64.71,21,7,9,3,6,0,0,0,83.0,0:3,1,0,1,555.0,0:23,706666
8479675,Trevor,Moore,1995-03-31,C,L,2018-19,25,2,6,8,0.32,1,26,7.69,2,13641.0,9:5,0,0,0,0.0,15,7,8,9,-1,0,0,0,359.0,0:14,0,0,0,46.0,0:1,925000
8479772,Zack,MacEwen,1996-07-08,C,R,2018-19,4,0,1,1,0.25,-4,2,0.0,5,1724.0,7:11,0,1,1,0.0,4,1,0,4,-4,0,0,0,160.0,0:40,0,0,0,11.0,0:2,847500
8479944,Zach,Aston-Reese,1994-08-10,C,L,2018-19,43,8,9,17,0.4,12,76,10.53,26,35234.0,13:39,8,10,18,44.44,138,37,17,11,6,0,0,0,303.0,0:7,1,0,1,4838.0,1:52,925000
8479945,Gavin,Bayreuther,1994-05-12,D,L,2018-19,19,2,3,5,0.26,2,25,8.0,10,20735.0,18:11,0,0,0,0.0,11,19,8,13,-5,0,2,2,1530.0,1:20,0,0,0,603.0,0:31,925000
8479968,Vinni,Lettieri,1995-02-06,C,R,2018-19,27,1,2,3,0.11,-7,40,2.5,14,16452.0,10:9,7,6,13,53.85,41,11,7,9,-2,1,1,2,910.0,0:33,0,0,0,284.0,0:10,925000
8479970,Joseph,Gambardella,1993-12-01,C,L,2018-19,15,0,3,3,0.2,2,7,0.0,2,7293.0,8:6,3,1,4,75.0,14,5,5,2,3,0,0,0,7.0,0:0,0,0,0,2.0,0:0,725000
8479974,Nolan,Patrick,1998-09-19,C,R,2018-19,72,13,18,31,0.43,-8,115,11.3,27,65157.0,15:4,399,380,779,51.22,72,26,40,26,14,1,1,2,7138.0,1:39,0,0,0,161.0,0:2,925000
8479976,Juuso,Valimaki,1998-10-06,D,L,2018-19,24,1,2,3,0.12,-2,28,3.57,12,22296.0,15:29,0,0,0,0.0,21,43,9,14,-5,0,0,0,205.0,0:8,0,0,0,1882.0,1:18,894166
8479977,Kailer,Yamamoto,1998-09-29,RW,R,2018-19,17,1,1,2,0.12,-6,13,7.69,2,13322.0,13:3,0,0,0,0.0,18,11,3,6,-3,0,1,1,924.0,0:54,0,0,0,408.0,0:24,894166
8479992,Michael,Rasmussen,1999-04-17,C,L,2018-19,62,8,10,18,0.29,-8,74,10.81,29,44923.0,12:4,23,41,64,35.94,84,28,12,29,-17,4,0,4,6682.0,1:47,0,0,0,23.0,0:0,894166
8479994,Jaret,Anderson-Dolan,1999-09-12,C,L,2018-19,5,0,1,1,0.2,-2,6,0.0,0,3481.0,11:36,4,5,9,44.44,5,2,2,2,0,0,0,0,535.0,1:47,0,0,0,0.0,0:0,745000
8479999,Casey,Mittelstadt,1998-11-22,C,L,2018-19,77,12,13,25,0.32,-19,118,10.17,10,62147.0,13:27,213,323,536,39.74,30,16,31,39,-8,3,7,10,8143.0,1:45,0,0,0,50.0,0:0,925000
8480001,Urho,Vaakanainen,1999-01-01,D,L,2018-19,2,0,0,0,0.0,-1,2,0.0,0,1092.0,9:6,0,0,0,0.0,0,0,0,1,-1,0,0,0,0.0,0:0,0,0,0,53.0,0:26,925000
8480002,Nico,Hischier,1999-01-04,C,L,2018-19,69,17,30,47,0.68,0,160,10.62,24,74950.0,18:6,437,529,966,45.24,53,44,38,32,6,3,8,11,12029.0,2:54,0,0,0,2729.0,0:39,925000
8480005,Kristian,Vesalainen,1999-06-01,LW,L,2018-19,5,0,1,1,0.2,0,1,0.0,0,2052.0,6:50,0,0,0,0.0,1,1,0,2,-2,0,0,0,18.0,0:3,0,0,0,0.0,0:0,925000
8480009,Eeli,Tolvanen,1999-04-22,RW,L,2018-19,4,1,1,2,0.5,2,2,50.0,0,3185.0,13:16,0,0,0,0.0,4,2,3,1,2,0,1,1,348.0,1:27,0,0,0,0.0,0:0,894166
8480012,Elias,Pettersson,1998-11-12,C,L,2018-19,71,28,38,66,0.93,3,144,19.44,12,77644.0,18:13,257,370,627,40.99,42,51,41,52,-11,10,12,22,15264.0,3:34,0,0,0,281.0,0:3,925000
8480023,Robert,Thomas,1999-07-02,C,R,2018-19,70,9,24,33,0.47,-2,80,11.25,14,54905.0,13:4,97,123,220,44.09,13,22,36,30,6,3,4,7,5331.0,1:16,0,0,0,599.0,0:8,894166
8480029,Alex,Formenton,1999-09-13,LW,L,2018-19,9,1,0,1,0.11,-2,16,6.25,6,6301.0,11:40,1,2,3,33.33,11,7,4,5,-1,0,0,0,53.0,0:5,0,0,0,217.0,0:24,753333
8480031,Max,Comtois,1999-01-08,LW,L,2018-19,10,2,5,7,0.7,3,9,22.22,7,8754.0,14:35,3,8,11,27.27,27,3,2,4,-2,0,0,0,893.0,1:29,0,0,0,5.0,0:0,820000
8480035,Henri,Jokiharju,1999-06-17,D,R,2018-19,38,0,12,12,0.32,-7,62,0.0,16,43275.0,18:58,0,0,0,0.0,48,37,7,26,-19,0,1,1,2274.0,0:59,0,0,0,1841.0,0:48,925000
8480036,Miro,Heiskanen,1999-07-18,D,L,2018-19,82,12,21,33,0.4,-14,182,6.59,16,113717.0,23:6,0,0,0,0.0,34,71,35,96,-61,2,6,8,8195.0,1:39,0,1,1,6829.0,1:23,894166
8480039,Martin,Necas,1999-01-15,C,R,2018-19,7,1,1,2,0.29,0,6,16.67,2,4210.0,10:1,16,28,44,36.36,3,2,3,7,-4,0,0,0,808.0,1:55,0,0,0,0.0,0:0,894167
8480068,Ryan,Poehling,1999-01-03,C,L,2018-19,1,3,0,3,3.0,3,3,100.0,0,682.0,11:22,4,3,7,57.14,1,0,0,0,0,0,0,0,0.0,0:0,0,0,0,42.0,0:42,925000
8480072,Lias,Andersson,1998-10-13,C,L,2018-19,42,2,4,6,0.14,-13,41,4.88,29,27007.0,10:43,84,106,190,44.21,60,8,14,12,2,0,0,0,139.0,0:3,1,0,1,1657.0,0:39,894166
8480074,Alexandre,Texier,1999-09-13,C,L,2018-19,2,1,0,1,0.5,3,6,16.67,0,1532.0,12:46,0,1,1,0.0,2,1,0,2,-2,0,0,0,0.0,0:0,0,0,0,0.0,0:0,897500
8480078,Filip,Chytil,1999-09-05,C,L,2018-19,75,11,12,23,0.31,-22,133,8.27,8,62037.0,13:47,68,107,175,38.86,29,21,25,46,-21,3,4,7,6594.0,1:27,0,0,0,12.0,0:0,894166
8480082,Justin,Kloos,1993-11-30,C,R,2018-19,1,0,0,0,0.0,0,2,0.0,0,424.0,7:4,0,0,0,0.0,2,0,1,0,1,0,0,0,0.0,0:0,0,0,0,0.0,0:0,792500
8480083,C.J.,Smith,1994-12-01,LW,L,2018-19,11,2,0,2,0.18,0,18,11.11,0,7032.0,10:39,0,0,0,0.0,4,1,2,3,-1,0,0,0,54.0,0:4,0,0,0,195.0,0:17,874125
8480113,Alex,Iafallo,1993-12-21,C,L,2018-19,82,15,18,33,0.4,-17,148,10.14,22,82802.0,16:49,7,17,24,29.17,87,54,26,19,7,2,4,6,7999.0,1:37,0,0,0,1958.0,0:23,925000
8480143,Jakub,Jerabek,1991-05-12,D,L,2018-19,1,0,0,0,0.0,-3,1,0.0,2,472.0,7:52,0,0,0,0.0,0,1,0,0,0,0,0,0,2.0,0:2,0,0,0,25.0,0:25,1000000
8480144,David,Kampf,1995-01-12,C,L,2018-19,63,4,15,19,0.3,-6,72,5.56,14,52619.0,13:55,276,333,609,45.32,39,30,31,6,25,0,0,0,428.0,0:6,0,0,0,7019.0,1:51,925000
8480145,Neal,Pionk,1995-07-29,D,R,2018-19,73,6,20,26,0.36,-16,132,4.55,35,92706.0,21:9,0,1,1,0.0,138,98,38,60,-22,2,11,13,6556.0,1:29,0,1,1,12597.0,2:52,925000
8480147,Oscar,Fantenberg,1991-10-07,D,L,2018-19,61,2,2,4,0.07,4,70,2.86,17,58562.0,16:0,0,0,0,0.0,91,74,12,38,-26,0,0,0,896.0,0:14,0,0,0,4330.0,1:10,650000
8480157,Calle,Rosen,1994-02-02,D,L,2018-19,4,1,0,1,0.25,-3,5,20.0,0,4009.0,16:42,0,0,0,0.0,1,2,0,4,-4,0,0,0,116.0,0:29,0,0,0,6.0,0:1,925000
8480160,Radim,Simek,1992-09-20,D,L,2018-19,41,1,8,9,0.22,7,41,2.44,8,37432.0,15:12,0,0,0,0.0,67,34,14,21,-7,0,0,0,120.0,0:2,0,0,0,2067.0,0:50,675000
8480161,Libor,Sulak,1994-03-04,D,L,2018-19,6,0,0,0,0.0,-4,7,0.0,6,6977.0,19:22,0,0,0,0.0,18,5,3,10,-7,0,0,0,8.0,0:1,0,0,0,776.0,2:9,833750
8480172,Jan,Rutta,1990-07-29,D,R,2018-19,37,2,6,8,0.22,4,42,4.76,16,34615.0,15:35,0,0,0,0.0,24,30,1,12,-11,0,0,0,85.0,0:2,0,0,0,2418.0,1:5,2250000
8480208,Drake,Batherson,1998-04-27,C,R,2018-19,20,3,6,9,0.45,-2,18,16.67,6,16098.0,13:24,3,1,4,75.0,17,21,7,12,-5,2,1,3,2251.0,1:52,0,0,0,0.0,0:0,736666
8480314,Max,Veronneau,1995-12-12,RW,R,2018-19,12,2,2,4,0.33,-5,15,13.33,0,9015.0,12:31,0,0,0,0.0,0,5,1,3,-2,1,0,1,858.0,1:11,0,0,0,0.0,0:0,925000
8480326,Sheldon,Dries,1994-04-23,C,L,2018-19,40,3,3,6,0.15,-7,44,6.82,26,21777.0,9:4,66,65,131,50.38,66,20,7,7,0,0,0,0,183.0,0:4,1,0,1,2352.0,0:58,925000
8480336,Sean,Walker,1994-11-13,D,R,2018-19,39,3,7,10,0.26,-8,55,5.45,8,36110.0,15:25,0,0,0,0.0,43,40,14,16,-2,1,0,1,318.0,0:8,0,0,0,207.0,0:5,745000
8480341,Adam,Johnson,1994-06-22,C,L,2018-19,6,0,2,2,0.33,2,3,0.0,0,1910.0,5:18,0,0,0,0.0,11,3,2,1,1,0,0,0,0.0,0:0,0,0,0,0.0,0:0,925000
8480748,Kiefer,Sherwood,1995-03-31,RW,R,2018-19,50,6,6,12,0.24,1,60,10.0,8,34111.0,11:22,7,9,16,43.75,79,19,17,23,-6,0,0,0,364.0,0:7,0,0,0,810.0,0:16,925000
8480769,Joel,L'Esperance,1995-08-18,RW,R,2018-19,18,2,0,2,0.11,-4,24,8.33,6,13228.0,12:14,26,30,56,46.43,22,4,6,7,-1,1,0,1,1392.0,1:17,0,0,0,0.0,0:0,722500
8480771,Daniel,Brickley,1995-03-30,D,L,2018-19,4,0,1,1,0.25,-2,2,0.0,0,3074.0,12:48,0,0,0,0.0,5,4,0,2,-2,0,0,0,11.0,0:2,0,0,0,51.0,0:12,925000
8480776,Sheldon,Rempal,1995-08-07,RW,R,2018-19,7,0,0,0,0.0,-1,3,0.0,0,3670.0,8:44,0,0,0,0.0,0,1,0,4,-4,0,0,0,2.0,0:0,0,0,0,0.0,0:0,925000
8480780,Lukas,Radil,1990-08-05,C,R,2018-19,36,7,4,11,0.31,7,40,17.5,6,23074.0,10:40,6,3,9,66.67,29,9,14,9,5,0,0,0,60.0,0:1,0,0,0,0.0,0:0,750000
8480800,Quinn,Hughes,1999-10-14,D,L,2018-19,5,0,3,3,0.6,0,6,0.0,2,5424.0,18:4,0,0,0,0.0,1,1,3,2,1,0,2,2,384.0,1:16,0,0,0,0.0,0:0,916667
8480801,Brady,Tkachuk,1999-09-16,LW,L,2018-19,71,22,23,45,0.63,-10,214,10.28,75,68266.0,16:1,73,76,149,48.99,174,26,22,39,-17,4,6,10,9530.0,2:14,0,0,0,204.0,0:2,925000
8480803,Evan,Bouchard,1999-10-20,D,R,2018-19,7,1,0,1,0.14,-5,10,10.0,2,5189.0,12:21,0,0,0,0.0,6,8,3,2,1,1,0,1,611.0,1:27,0,0,0,36.0,0:5,925000
8480806,Isac,Lundestrom,1999-11-06,C,L,2018-19,15,0,2,2,0.13,-1,13,0.0,2,11726.0,13:1,21,43,64,32.81,4,5,3,5,-2,0,0,0,353.0,0:23,0,0,0,715.0,0:47,925000
8480821,Filip,Zadina,1999-11-27,RW,L,2018-19,9,1,2,3,0.33,-5,18,5.56,0,8308.0,15:23,3,3,6,50.0,6,3,5,5,0,1,1,2,1244.0,2:18,0,0,0,0.0,0:0,925000
8480829,Jesperi,Kotkaniemi,2000-07-06,C,L,2018-19,79,11,23,34,0.43,1,134,8.21,26,65135.0,13:44,359,426,785,45.73,66,41,32,50,-18,1,4,5,9144.0,1:55,0,0,0,38.0,0:0,925000
8480830,Andrei,Svechnikov,2000-03-26,RW,L,2018-19,82,20,17,37,0.45,0,189,10.58,62,72062.0,14:38,1,6,7,14.29,123,26,34,63,-29,0,5,5,9419.0,1:54,0,0,0,67.0,0:0,925000
8480839,Rasmus,Dahlin,2000-04-13,D,L,2018-19,82,9,35,44,0.54,-13,177,5.08,34,104085.0,21:9,0,0,0,0.0,97,66,38,79,-41,5,15,20,14029.0,2:51,0,0,0,779.0,0:9,925000
8480901,Karson,Kuhlman,1995-09-26,C,R,2018-19,11,3,2,5,0.45,5,15,20.0,2,8016.0,12:8,1,0,1,100.0,6,4,3,3,0,0,0,0,3.0,0:0,0,0,0,487.0,0:44,750000
8480935,Lawrence,Pilut,1995-12-30,D,L,2018-19,33,1,5,6,0.18,-8,37,2.7,20,34488.0,17:25,0,0,0,0.0,20,33,7,14,-7,0,0,0,1176.0,0:35,0,0,0,608.0,0:18,925000
8480943,Igor,Ozhiganov,1992-10-13,D,R,2018-19,53,3,4,7,0.13,0,43,6.98,14,44568.0,14:0,0,0,0,0.0,57,48,11,34,-23,0,0,0,91.0,0:1,0,0,0,218.0,0:4,925000
8480944,Par,Lindholm,1991-10-05,C,L,2018-19,65,1,12,13,0.2,5,65,1.54,18,44252.0,11:20,204,203,407,50.12,58,55,30,12,18,0,0,0,270.0,0:4,0,0,0,6190.0,1:35,925000
8480945,Juuso,Riikola,1993-11-09,D,L,2018-19,37,2,3,5,0.14,3,43,4.65,10,37040.0,16:41,0,0,0,0.0,86,38,13,16,-3,2,0,2,2255.0,1:0,0,0,0,163.0,0:4,925000
8480946,Dominik,Kahun,1995-07-02,C,L,2018-19,82,13,24,37,0.45,10,137,9.49,6,69620.0,14:9,22,39,61,36.07,13,27,32,24,8,1,1,2,5214.0,1:3,0,0,0,325.0,0:3,925000
8480948,Egor,Yakovlev,1991-09-17,D,L,2018-19,25,2,5,7,0.28,-6,24,8.33,6,23510.0,15:40,0,0,0,0.0,12,22,3,19,-16,0,0,0,173.0,0:6,0,0,0,46.0,0:1,925000
8480950,Ilya,Lyubushkin,1994-04-06,D,R,2018-19,41,0,4,4,0.1,-9,27,0.0,13,33799.0,13:44,0,0,0,0.0,150,61,6,22,-16,0,0,0,98.0,0:2,0,0,0,593.0,0:14,925000
8480955,Bogdan,Kiselevich,1990-02-14,D,L,2018-19,32,0,8,8,0.25,-3,14,0.0,12,28520.0,14:51,0,0,0,0.0,49,21,4,9,-5,0,0,0,18.0,0:0,0,0,0,1568.0,0:49,925000
8480965,Antti,Suomela,1994-03-17,C,L,2018-19,27,3,5,8,0.3,1,42,7.14,4,18334.0,11:19,102,127,229,44.54,10,11,5,7,-2,0,0,0,79.0,0:2,0,0,0,130.0,0:4,925000
8481186,Logan,O'Connor,1996-08-14,RW,R,2018-19,5,0,0,0,0.0,-2,1,0.0,0,2044.0,6:48,0,3,3,0.0,4,1,2,0,2,0,0,0,0.0,0:0,0,0,0,156.0,0:31,925000
8481426,Ryan,Kuffner,1996-06-12,LW,L,2018-19,10,0,0,0,0.0,-4,8,0.0,0,6561.0,10:56,0,2,2,0.0,4,5,2,1,1,0,0,0,537.0,0:53,0,0,0,0.0,0:0,925000
8481433,Taro,Hirose,1996-06-30,LW,L,2018-19,10,1,6,7,0.7,0,15,6.67,2,9183.0,15:18,1,0,1,100.0,1,9,5,7,-2,0,1,1,543.0,0:54,0,0,0,6.0,0:0,925000
8481442,Brady,Keeper,1996-06-05,D,R,2018-19,1,0,0,0,0.0,1,1,0.0,0,760.0,12:40,0,0,0,0.0,2,1,0,0,0,0,0,0,0.0,0:0,0,0,0,0.0,0:0,925000
8481477,Nico,Sturm,1995-05-03,C,L,2018-19,2,0,0,0,0.0,0,7,0.0,0,1534.0,12:47,5,12,17,29.41,3,2,0,0,0,0,0,0,14.0,0:7,0,0,0,86.0,0:43,4273500
8481479,Brogan,Rafferty,1995-05-28,D,R,2018-19,2,0,0,0,0.0,-1,3,0.0,0,1602.0,13:21,0,0,0,0.0,0,2,1,1,0,0,0,0,0.0,0:0,0,0,0,0.0,0:0,5133750
8481481,Blake,Lizotte,1997-12-13,C,L,2018-19,1,0,0,0,0.0,-1,1,0.0,0,672.0,11:12,4,4,8,50.0,0,1,1,0,1,0,0,0,0.0,0:0,0,0,0,0.0,0:0,925000
8481486,Jimmy,Schuldt,1995-05-11,D,L,2018-19,1,0,1,1,1.0,-1,1,0.0,0,1263.0,21:3,0,0,0,0.0,0,1,0,1,-1,0,0,0,109.0,1:49,0,0,0,2.0,0:2,6567500
