player_id,firstName,lastName,birthDate,primaryPosition,shootsCatches,season,gamesPlayed,goals,assists,points,pointsPerGame,plusMinus,shots,shootingPercentage,penaltyMinutes,timeOnIce,avgTimeOnIce,faceOffWins,faceOffLosses,faceOffTaken,faceOffPercentage,hits,blocks,takeaways,giveaways,turnoverDifferential,powerPlayGoals,powerPlayAssists,powerPlayPoints,powerPlayTimeOnIce,avgPowerPlayTimeOnIce,shortHandedGoals,shortHandedAssists,shortHandedPoints,shortHandedTimeOnIce,avgShortHandedTimeOnIce,salary
8465009,Zdeno,Chara,1977-03-18,D,L,2019-20,71,5,10,15,0.21,24,88,5.68,60,88972.0,20:53,0,0,0,0.0,83,108,27,55,-28,0,0,0,242.0,0:3,0,0,0,13432.0,3:9,2000000
8466138,Joe,Thornton,1979-07-02,C,L,2019-20,70,7,24,31,0.44,-19,76,9.21,34,65102.0,15:30,323,331,654,49.39,20,29,55,30,25,3,5,8,8723.0,2:4,0,0,0,19.0,0:0,2000000
8466139,Patrick,Marleau,1979-09-15,C,L,2019-20,66,11,11,22,0.33,-5,117,9.4,14,61686.0,15:34,36,40,76,47.37,57,24,29,15,14,1,0,1,5863.0,1:28,0,0,0,1046.0,0:15,6250000
8468493,Ron,Hainsey,1981-03-24,D,L,2019-20,64,1,11,12,0.19,10,43,2.33,12,79418.0,20:40,0,0,0,0.0,51,102,9,56,-47,0,0,0,1067.0,0:16,0,3,3,12370.0,3:13,3500000
8468508,Justin,Williams,1981-10-04,RW,R,2019-20,20,8,3,11,0.55,2,60,13.33,6,16339.0,13:36,3,7,10,30.0,20,7,3,13,-10,2,1,3,2964.0,2:28,0,0,0,71.0,0:3,700000
8468674,Deryk,Engelland,1982-04-03,D,R,2019-20,49,1,5,6,0.12,5,59,1.69,37,51630.0,17:33,0,0,0,0.0,114,86,15,17,-2,0,0,0,36.0,0:0,0,1,1,10075.0,3:25,700000
8469454,Ilya,Kovalchuk,1983-04-15,RW,R,2019-20,49,10,17,27,0.55,-3,119,8.4,20,49426.0,16:48,8,16,24,33.33,58,24,11,28,-17,2,3,5,7266.0,2:28,0,0,0,26.0,0:0,6666666
8469455,Jason,Spezza,1983-06-13,C,R,2019-20,58,9,16,25,0.43,-3,73,12.33,18,37685.0,10:49,215,183,398,54.02,13,19,20,33,-13,2,5,7,4081.0,1:10,0,0,0,178.0,0:3,700000
8469459,Mikko,Koivu,1983-03-12,C,L,2019-20,55,4,17,21,0.38,2,74,5.41,28,51381.0,15:34,431,380,811,53.14,25,33,29,13,16,1,6,7,5411.0,1:38,0,1,1,5447.0,1:39,5500000
8469465,Dan,Hamhuis,1982-12-13,D,L,2019-20,60,0,8,8,0.13,6,44,0.0,35,52249.0,14:30,0,0,0,0.0,64,53,9,34,-25,0,0,0,53.0,0:0,0,0,0,8554.0,2:22,1250000
8470047,Valtteri,Filppula,1984-03-20,C,L,2019-20,70,6,15,21,0.3,-42,63,9.52,24,69772.0,16:36,324,398,722,44.88,28,31,17,43,-26,1,4,5,7945.0,1:53,1,0,1,7172.0,1:42,3000000
8470110,Trevor,Daley,1983-10-09,D,L,2019-20,43,0,7,7,0.16,-22,37,0.0,20,40396.0,15:39,0,0,0,0.0,9,44,5,21,-16,0,2,2,1987.0,0:46,0,0,0,1643.0,0:38,3166666
8470144,Frans,Nielsen,1984-04-24,C,L,2019-20,60,4,5,9,0.15,-13,86,4.65,8,49260.0,13:41,210,246,456,46.05,44,35,11,15,-4,0,2,2,3726.0,1:2,1,1,2,6320.0,1:45,5250000
8470151,Jay,Bouwmeester,1983-09-27,D,L,2019-20,56,1,8,9,0.16,5,53,1.89,20,72482.0,21:34,0,0,0,0.0,42,68,11,32,-21,0,0,0,111.0,0:1,0,1,1,8859.0,2:38,3250000
8470187,Johnny,Boychuk,1984-01-19,D,R,2019-20,64,2,9,11,0.17,-11,96,2.08,14,66376.0,17:17,0,0,0,0.0,135,128,6,50,-44,1,0,1,324.0,0:5,0,0,0,7921.0,2:3,6000000
8470257,Alexander,Steen,1984-03-01,LW,L,2019-20,58,7,10,17,0.29,5,71,9.86,16,48678.0,13:59,8,7,15,53.33,29,50,16,13,3,0,1,1,883.0,0:15,0,0,0,8326.0,2:23,5750000
8470281,Duncan,Keith,1983-07-16,D,L,2019-20,61,3,24,27,0.44,1,111,2.7,18,89251.0,24:23,0,0,0,0.0,26,117,42,74,-32,2,9,11,8351.0,2:16,0,0,0,10011.0,2:44,5538462
8470318,Jonathan,Ericsson,1984-03-02,D,L,2019-20,18,0,0,0,0.0,-12,16,0.0,4,15386.0,14:14,0,0,0,0.0,24,14,1,20,-19,0,0,0,12.0,0:0,0,0,0,1660.0,1:32,4250000
8470595,Eric,Staal,1984-10-29,C,L,2019-20,66,19,28,47,0.71,-9,113,16.81,28,67853.0,17:8,495,504,999,49.55,24,22,25,46,-21,5,9,14,10677.0,2:41,0,0,0,1080.0,0:16,3250000
8470600,Ryan,Suter,1985-01-21,D,L,2019-20,69,8,40,48,0.7,-6,111,7.21,12,102009.0,24:38,0,0,0,0.0,48,93,19,27,-8,2,16,18,12019.0,2:54,0,0,0,10007.0,2:25,7538462
8470601,Braydon,Coburn,1985-02-27,D,L,2019-20,40,1,3,4,0.1,5,44,2.27,16,33730.0,14:3,0,0,0,0.0,59,28,3,5,-2,0,0,0,146.0,0:3,0,0,0,2020.0,0:50,1700000
8470604,Jeff,Carter,1985-01-01,C,R,2019-20,60,17,10,27,0.45,-21,182,9.34,36,60894.0,16:54,382,364,746,51.21,66,23,13,20,-7,3,2,5,6605.0,1:50,0,0,0,4967.0,1:22,5272727
8470606,Dustin,Brown,1984-11-04,RW,R,2019-20,66,17,18,35,0.53,-1,169,10.06,22,72890.0,18:24,7,9,16,43.75,143,15,28,35,-7,1,4,5,9922.0,2:30,0,0,0,2666.0,0:40,5875000
8470607,Brent,Seabrook,1985-04-20,D,R,2019-20,32,3,1,4,0.12,1,40,7.5,8,34846.0,18:8,0,0,0,0.0,52,61,3,27,-24,1,0,1,1378.0,0:43,0,0,0,2932.0,1:31,6875000
8470610,Zach,Parise,1984-07-28,LW,L,2019-20,69,25,21,46,0.67,-11,155,16.13,8,71195.0,17:11,41,36,77,53.25,27,38,21,22,-1,12,6,18,11433.0,2:45,1,0,1,3735.0,0:54,7538462
8470612,Ryan,Getzlaf,1985-05-10,C,R,2019-20,69,13,29,42,0.61,-16,143,9.09,58,77512.0,18:43,530,504,1034,51.26,125,69,53,76,-23,3,6,9,10091.0,2:26,0,0,0,2906.0,0:42,8250000
8470613,Brent,Burns,1985-03-09,D,R,2019-20,70,12,33,45,0.64,-22,225,5.33,34,106726.0,25:24,0,0,0,0.0,72,115,49,76,-27,5,12,17,11622.0,2:46,0,1,1,10388.0,2:28,8000000
8470619,Brian,Boyle,1984-12-18,C,L,2019-20,39,6,9,15,0.38,-5,56,10.71,17,28958.0,12:22,197,179,376,52.39,65,34,16,13,3,1,0,1,2075.0,0:53,0,0,0,1205.0,0:30,940000
8470621,Corey,Perry,1985-05-16,RW,R,2019-20,60,6,16,22,0.37,-4,83,7.23,74,49420.0,13:43,4,6,10,40.0,66,35,17,30,-13,2,6,8,7711.0,2:8,0,0,0,63.0,0:1,8625000
8470626,Loui,Eriksson,1985-07-17,LW,L,2019-20,49,6,7,13,0.27,-2,59,10.17,12,36374.0,12:22,2,0,2,100.0,10,15,17,8,9,0,0,0,214.0,0:4,0,0,0,4198.0,1:25,6000000
8470638,Patrice,Bergeron,1985-07-24,C,R,2019-20,64,31,26,57,0.89,22,212,14.62,28,71830.0,18:42,812,583,1395,58.21,49,50,44,23,21,11,9,20,14029.0,3:39,1,0,1,6537.0,1:42,6875000
8470642,Shea,Weber,1985-08-14,D,R,2019-20,65,15,21,36,0.55,8,185,8.11,33,93630.0,24:0,0,0,0,0.0,112,114,18,79,-61,3,5,8,8451.0,2:10,0,0,0,12600.0,3:13,7857143
8470655,David,Backes,1984-05-01,RW,R,2019-20,22,1,5,6,0.27,-1,34,2.94,22,12406.0,9:23,27,44,71,38.03,38,8,5,9,-4,1,0,1,384.0,0:17,0,0,0,134.0,0:6,6000000
8470755,Brad,Richardson,1985-02-04,C,L,2019-20,59,6,5,11,0.19,1,76,7.89,20,48307.0,13:38,355,303,658,53.95,77,44,12,18,-6,0,0,0,132.0,0:2,1,1,2,9074.0,2:33,1250000
8470775,Nate,Thompson,1984-10-05,C,L,2019-20,73,5,11,16,0.22,0,70,7.14,30,56116.0,12:48,452,362,814,55.53,125,56,26,33,-7,0,0,0,254.0,0:3,0,1,1,9651.0,2:12,1000000
8470794,Joe,Pavelski,1984-07-11,C,R,2019-20,70,16,17,33,0.47,5,130,12.31,29,71326.0,16:58,365,312,677,53.91,64,53,38,29,9,6,5,11,11097.0,2:38,0,1,1,3308.0,0:47,7000000
8470966,Mark,Giordano,1983-10-03,D,L,2019-20,60,5,26,31,0.52,2,157,3.18,34,86011.0,23:53,0,0,0,0.0,42,148,36,51,-15,2,9,11,9619.0,2:40,0,2,2,9832.0,2:43,6750000
8471214,Alex,Ovechkin,1985-09-17,LW,R,2019-20,71,48,19,67,0.94,-12,321,14.95,30,88035.0,20:39,1,0,1,100.0,196,30,29,49,-20,13,5,18,20845.0,4:53,0,0,0,72.0,0:1,9538462
8471215,Evgeni,Malkin,1986-07-31,C,L,2019-20,55,25,49,74,1.35,7,171,14.62,58,64420.0,19:31,441,435,876,50.34,38,22,70,69,1,7,17,24,12186.0,3:41,0,0,0,90.0,0:1,9500000
8471217,Andrew,Ladd,1985-12-12,LW,L,2019-20,4,1,0,1,0.25,2,5,20.0,4,2871.0,11:57,0,0,0,0.0,23,0,0,1,-1,0,0,0,62.0,0:15,0,0,0,0.0,0:0,5500000
8471218,Blake,Wheeler,1986-08-31,RW,R,2019-20,71,22,43,65,0.92,1,180,12.22,37,82300.0,19:19,324,328,652,49.69,102,51,37,46,-9,4,18,22,13885.0,3:15,1,1,2,2776.0,0:39,8250000
8471228,Alexander,Radulov,1986-07-05,RW,L,2019-20,63,15,19,34,0.54,8,133,11.28,50,63415.0,16:46,4,10,14,28.57,52,42,29,46,-17,7,3,10,9715.0,2:34,0,0,0,28.0,0:0,6250000
8471233,Travis,Zajac,1985-05-13,C,R,2019-20,69,9,16,25,0.36,-12,72,12.5,28,70776.0,17:5,576,514,1090,52.84,58,39,36,17,19,1,0,1,2395.0,0:34,1,2,3,11825.0,2:51,5750000
8471242,Mike,Green,1985-10-12,D,R,2019-20,50,3,8,11,0.22,-34,76,3.95,32,62631.0,20:52,0,0,0,0.0,61,66,12,41,-29,1,3,4,7036.0,2:20,0,0,0,362.0,0:7,5375000
8471260,Blake,Comeau,1986-02-18,LW,R,2019-20,58,8,9,17,0.29,-6,77,10.39,36,51597.0,14:49,42,55,97,43.3,112,27,25,32,-7,0,0,0,535.0,0:9,1,1,2,7406.0,2:7,2400000
8471262,Carl,Soderberg,1985-10-12,C,L,2019-20,70,17,18,35,0.5,6,135,12.59,18,66765.0,15:53,245,296,541,45.29,77,41,28,24,4,6,5,11,9060.0,2:9,0,0,0,3880.0,0:55,4750000
8471274,Alex,Goligoski,1985-07-30,D,L,2019-20,70,4,28,32,0.46,8,101,3.96,24,96839.0,23:3,0,0,0,0.0,91,134,7,53,-46,2,9,11,8090.0,1:55,0,0,0,9918.0,2:21,5475000
8471276,David,Krejci,1986-04-28,C,R,2019-20,64,13,31,44,0.69,14,89,14.61,25,66177.0,17:14,385,384,769,50.07,38,33,32,40,-8,3,11,14,7129.0,1:51,0,0,0,179.0,0:2,7250000
8471284,Andrej,Sekera,1986-06-08,D,L,2019-20,60,2,6,8,0.13,7,65,3.08,14,64391.0,17:53,0,0,0,0.0,37,79,9,53,-44,0,0,0,270.0,0:4,1,0,1,8226.0,2:17,5500000
8471303,Alexander,Edler,1986-04-21,D,L,2019-20,59,5,28,33,0.56,14,118,4.24,62,80065.0,22:37,0,0,0,0.0,108,162,9,43,-34,1,6,7,4223.0,1:11,0,0,0,10909.0,3:4,6000000
8471392,Roman,Polak,1986-04-28,D,R,2019-20,41,0,4,4,0.1,-6,34,0.0,24,40992.0,16:39,0,0,0,0.0,104,94,4,22,-18,0,0,0,32.0,0:0,0,0,0,6840.0,2:46,1750000
8471426,Troy,Brouwer,1985-08-17,RW,R,2019-20,15,2,0,2,0.13,2,13,15.38,11,8587.0,9:32,1,1,2,50.0,28,6,2,2,0,0,0,0,28.0,0:1,0,0,0,198.0,0:13,4500000
8471669,Paul,Stastny,1985-12-27,C,L,2019-20,74,17,21,38,0.51,6,146,11.64,26,76135.0,17:8,648,541,1189,54.5,64,32,42,21,21,5,5,10,10560.0,2:22,0,1,1,4786.0,1:4,6500000
8471675,Sidney,Crosby,1987-08-07,C,L,2019-20,41,16,31,47,1.15,-8,109,14.68,15,49855.0,20:15,494,394,888,55.63,28,17,26,25,1,4,13,17,9473.0,3:51,0,0,0,707.0,0:17,8700000
8471676,Bobby,Ryan,1987-03-17,RW,R,2019-20,24,5,3,8,0.33,3,43,11.63,22,19465.0,13:31,3,2,5,60.0,41,13,12,18,-6,0,0,0,3572.0,2:28,0,0,0,8.0,0:0,7250000
8471677,Jack,Johnson,1987-01-13,D,L,2019-20,67,3,8,11,0.16,-1,63,4.76,26,78248.0,19:27,0,0,0,0.0,183,97,15,23,-8,0,0,0,272.0,0:4,1,0,1,8862.0,2:12,3250000
8471685,Anze,Kopitar,1987-08-24,C,L,2019-20,70,21,41,62,0.89,6,135,15.56,16,88368.0,21:2,776,631,1407,55.15,49,56,39,49,-10,7,14,21,12107.0,2:52,1,0,1,7522.0,1:47,10000000
8471686,Marc,Staal,1987-01-13,D,L,2019-20,52,2,9,11,0.21,5,46,4.35,16,55043.0,17:38,0,0,0,0.0,69,76,19,34,-15,0,0,0,175.0,0:3,0,0,0,8513.0,2:43,5700000
8471698,T.J.,Oshie,1986-12-23,RW,R,2019-20,72,27,23,50,0.69,4,142,19.01,35,78984.0,18:17,127,131,258,49.22,95,61,46,48,-2,10,2,12,15392.0,3:33,0,0,0,706.0,0:9,5750000
8471699,Andrew,Cogliano,1987-06-14,LW,L,2019-20,71,3,11,14,0.2,2,72,4.17,32,52945.0,12:25,19,20,39,48.72,94,33,26,21,5,0,0,0,427.0,0:6,0,0,0,6366.0,1:29,3250000
8471702,Matt,Niskanen,1986-12-06,D,R,2019-20,71,8,25,33,0.46,19,126,6.35,31,93359.0,21:54,0,0,0,0.0,128,90,14,60,-46,4,9,13,8672.0,2:2,1,0,1,11278.0,2:38,5750000
8471707,James,Neal,1987-09-03,LW,L,2019-20,55,19,12,31,0.56,-20,112,16.96,12,53814.0,16:18,11,20,31,35.48,88,17,24,29,-5,12,5,17,9530.0,2:53,0,0,0,76.0,0:1,5750000
8471709,Marc-Edouard,Vlasic,1987-03-30,D,L,2019-20,70,5,10,15,0.21,-10,74,6.76,10,85238.0,20:17,0,0,0,0.0,37,97,18,40,-22,0,0,0,1120.0,0:16,1,0,1,11754.0,2:47,7000000
8471716,Justin,Abdelkader,1987-02-25,LW,L,2019-20,49,0,3,3,0.06,-14,40,0.0,25,33909.0,11:32,38,31,69,55.07,103,26,10,18,-8,0,0,0,1428.0,0:29,0,0,0,3425.0,1:9,4250000
8471724,Kris,Letang,1987-04-24,D,R,2019-20,61,15,29,44,0.72,0,177,8.47,38,94155.0,25:43,0,0,0,0.0,101,91,31,80,-49,6,9,15,12859.0,3:30,0,0,0,8058.0,2:12,7250000
8471729,Kris,Russell,1987-05-02,D,L,2019-20,55,0,9,9,0.16,0,45,0.0,14,55373.0,16:46,0,0,0,0.0,71,101,31,38,-7,0,0,0,36.0,0:0,0,1,1,7655.0,2:19,4000000
8471735,Keith,Yandle,1986-09-09,D,L,2019-20,69,5,40,45,0.65,0,129,3.88,20,81544.0,19:41,0,1,1,0.0,18,51,25,66,-41,2,19,21,15342.0,3:42,0,0,0,231.0,0:3,6350000
8471743,Vladimir,Sobotka,1987-07-02,LW,L,2019-20,16,1,2,3,0.19,2,23,4.35,4,13695.0,14:15,39,31,70,55.71,26,7,3,3,0,0,0,0,5.0,0:0,0,0,0,1600.0,1:40,3500000
8471769,Niklas,Hjalmarsson,1987-06-06,D,L,2019-20,27,1,4,5,0.19,-2,18,5.56,14,30396.0,18:45,0,0,0,0.0,20,45,11,20,-9,0,0,0,38.0,0:1,0,1,1,4319.0,2:39,5000000
8471794,Darren,Helm,1987-01-21,LW,L,2019-20,68,9,7,16,0.24,-6,102,8.82,37,56032.0,13:44,15,13,28,53.57,88,26,24,30,-6,0,0,0,139.0,0:2,1,1,2,6786.0,1:39,3850000
8471804,Nathan,Gerbe,1987-07-24,C,L,2019-20,30,4,6,10,0.33,-7,55,7.27,22,24756.0,13:45,6,6,12,50.0,46,8,4,12,-8,0,0,0,555.0,0:18,0,0,0,720.0,0:24,675000
8471817,Ryan,Reaves,1987-01-20,RW,R,2019-20,74,8,9,17,0.23,-6,62,12.9,49,44856.0,10:6,24,29,53,45.28,328,25,17,7,10,0,0,0,1035.0,0:13,0,0,0,2.0,0:0,2775000
8471873,Anton,Stralman,1986-08-01,D,R,2019-20,69,5,14,19,0.28,-6,89,5.62,14,87211.0,21:3,0,0,0,0.0,68,96,40,48,-8,0,0,0,355.0,0:5,0,1,1,10316.0,2:29,5500000
8471887,Patric,Hornqvist,1987-01-01,RW,R,2019-20,52,17,15,32,0.62,9,168,10.12,36,49708.0,15:55,2,4,6,33.33,107,41,12,8,4,3,4,7,10435.0,3:20,0,0,0,8.0,0:0,5300000
8472382,Andy,Greene,1982-10-30,D,L,2019-20,63,2,12,14,0.22,1,60,3.33,16,73885.0,19:32,0,0,0,0.0,30,155,16,41,-25,0,1,1,102.0,0:1,0,2,2,12120.0,3:12,5000000
8473412,Bryan,Little,1987-11-12,C,R,2019-20,7,2,3,5,0.71,4,13,15.38,2,6783.0,16:9,48,58,106,45.28,3,3,2,2,0,0,0,0,654.0,1:33,0,0,0,564.0,1:20,5291667
8473415,Alex,Biega,1988-04-04,D,R,2019-20,49,0,3,3,0.06,-9,55,0.0,24,48278.0,16:25,0,0,0,0.0,115,46,4,30,-26,0,0,0,72.0,0:1,0,0,0,5059.0,1:43,825000
8473419,Brad,Marchand,1988-05-11,LW,L,2019-20,73,28,59,87,1.19,22,190,14.74,82,85192.0,19:27,24,29,53,45.28,56,20,43,77,-34,5,23,28,16255.0,3:42,1,2,3,6965.0,1:35,6125000
8473422,Nick,Foligno,1987-10-31,LW,L,2019-20,67,10,21,31,0.46,-3,131,7.63,62,75044.0,18:40,159,160,319,49.84,212,50,39,35,4,2,2,4,7678.0,1:54,0,1,1,6016.0,1:29,5500000
8473446,Erik,Johnson,1988-03-21,D,R,2019-20,62,3,13,16,0.26,11,109,2.75,20,77823.0,20:55,0,0,0,0.0,103,116,32,30,2,0,0,0,1356.0,0:21,0,0,0,11208.0,3:0,6000000
8473449,Kyle,Okposo,1988-04-16,RW,R,2019-20,52,9,10,19,0.37,-3,82,10.98,28,40084.0,12:50,38,33,71,53.52,55,15,15,13,2,1,0,1,2113.0,0:40,0,0,0,303.0,0:5,6000000
8473453,Trevor,Lewis,1987-01-08,C,R,2019-20,56,6,6,12,0.21,-7,92,6.52,16,40022.0,11:54,45,71,116,38.79,68,22,11,14,-3,0,0,0,217.0,0:3,0,0,0,2794.0,0:49,2000000
8473463,Leo,Komarov,1987-01-23,C,L,2019-20,48,4,10,14,0.29,2,46,8.7,10,36278.0,12:35,34,52,86,39.53,123,29,13,16,-3,0,0,0,82.0,0:1,0,1,1,3999.0,1:23,3000000
8473473,Milan,Lucic,1988-06-07,LW,L,2019-20,68,8,12,20,0.29,-6,83,9.64,54,54397.0,13:19,20,26,46,43.48,198,20,19,42,-23,5,3,8,6234.0,1:31,0,0,0,36.0,0:0,6000000
8473485,Chris,Stewart,1987-10-30,RW,R,2019-20,16,0,1,1,0.06,-7,5,0.0,21,7469.0,7:46,0,0,0,0.0,35,4,3,1,2,0,0,0,23.0,0:1,0,0,0,23.0,0:1,753757
8473504,Cal,Clutterbuck,1987-11-18,RW,R,2019-20,37,3,4,7,0.19,6,35,8.57,22,29803.0,13:25,4,5,9,44.44,127,38,12,21,-9,0,0,0,97.0,0:2,1,1,2,4949.0,2:13,3500000
8473507,Jeff,Petry,1987-12-09,D,R,2019-20,71,11,29,40,0.56,-10,158,6.96,26,100732.0,23:38,0,0,0,0.0,177,79,30,88,-58,3,9,12,10241.0,2:24,1,0,1,8889.0,2:5,5500000
8473512,Claude,Giroux,1988-01-12,C,R,2019-20,72,21,32,53,0.74,9,205,10.24,28,81660.0,18:54,686,476,1162,59.04,45,16,38,36,2,7,13,20,13513.0,3:7,1,1,2,3935.0,0:54,8275000
8473533,Jordan,Staal,1988-09-10,C,L,2019-20,68,8,19,27,0.4,3,125,6.4,40,71428.0,17:30,699,585,1284,54.44,149,36,30,41,-11,2,1,3,4712.0,1:9,0,0,0,9586.0,2:20,6000000
8473544,Derick,Brassard,1987-09-22,C,L,2019-20,66,10,22,32,0.48,-2,110,9.09,16,54239.0,13:41,197,160,357,55.18,115,24,26,40,-14,3,7,10,6815.0,1:43,0,0,0,163.0,0:2,1200000
8473546,Michael,Grabner,1987-10-05,RW,L,2019-20,46,8,3,11,0.24,-4,61,13.11,6,34133.0,12:22,0,4,4,0.0,21,12,31,11,20,0,0,0,88.0,0:1,1,0,1,6289.0,2:16,3350000
8473548,Phil,Kessel,1987-10-02,RW,R,2019-20,70,14,24,38,0.54,-21,153,9.15,22,72024.0,17:8,2,7,9,22.22,11,20,19,41,-22,9,8,17,13243.0,3:9,0,0,0,175.0,0:2,8000000
8473560,Korbinian,Holzer,1988-02-16,D,R,2019-20,49,1,3,4,0.08,-2,39,2.56,37,47132.0,16:1,0,0,0,0.0,97,96,2,28,-26,0,0,0,79.0,0:1,0,1,1,5016.0,1:42,850000
8473563,Nicklas,Backstrom,1987-11-23,C,L,2019-20,64,12,43,55,0.86,-1,135,8.89,14,73135.0,19:2,532,567,1099,48.41,32,46,36,43,-7,2,17,19,14365.0,3:44,0,0,0,1049.0,0:16,6700000
8473564,Michael,Frolik,1988-02-17,RW,L,2019-20,57,6,8,14,0.25,-12,70,8.57,28,42624.0,12:27,6,15,21,28.57,32,22,32,28,4,0,0,0,47.0,0:0,2,1,3,4679.0,1:22,4300000
8473573,Artem,Anisimov,1988-05-24,C,L,2019-20,49,15,5,20,0.41,-15,87,17.24,8,40715.0,13:50,185,185,370,50.0,6,25,19,16,3,5,1,6,4620.0,1:34,0,0,0,695.0,0:14,4550000
8473604,Jonathan,Toews,1988-04-29,C,L,2019-20,70,18,42,60,0.86,-2,172,10.47,48,83063.0,19:46,856,638,1494,57.3,56,35,58,40,18,1,7,8,13910.0,3:18,1,0,1,8075.0,1:55,10500000
8473618,Mathieu,Perreault,1988-01-05,C,L,2019-20,49,7,8,15,0.31,-9,71,9.86,10,38535.0,13:6,13,6,19,68.42,69,19,17,11,6,2,0,2,4253.0,1:26,0,0,0,0.0,0:0,4125000
8473914,Mark,Letestu,1985-02-04,C,R,2019-20,7,0,0,0,0.0,0,5,0.0,0,4451.0,10:35,25,21,46,54.35,3,5,0,1,-1,0,0,0,70.0,0:10,0,0,0,410.0,0:58,700000
8473986,Alex,Killorn,1989-09-14,LW,L,2019-20,71,27,25,52,0.73,17,133,20.3,22,76157.0,17:52,5,14,19,26.32,66,15,29,27,2,9,6,15,10856.0,2:32,0,0,0,9392.0,2:12,4450000
8473991,Karl,Alzner,1988-09-24,D,L,2019-20,4,0,0,0,0.0,-1,4,0.0,0,3340.0,13:55,0,0,0,0.0,1,4,0,1,-1,0,0,0,0.0,0:0,0,0,0,163.0,0:40,4625000
8473994,Jamie,Benn,1989-07-18,LW,L,2019-20,72,19,20,39,0.54,-8,170,11.18,53,70986.0,16:25,253,199,452,55.97,176,58,52,60,-8,8,6,14,10479.0,2:25,0,0,0,1151.0,0:15,9500000
8474000,Steven,Kampfer,1988-09-24,D,R,2019-20,10,0,2,2,0.2,2,13,0.0,2,8181.0,13:38,0,0,0,0.0,15,8,4,1,3,0,2,2,300.0,0:30,0,0,0,195.0,0:19,800000
8474009,Nick,Bonino,1988-04-20,C,L,2019-20,67,18,17,35,0.52,17,104,17.31,16,66407.0,16:31,488,440,928,52.59,17,89,47,22,25,1,0,1,5793.0,1:26,0,0,0,10471.0,2:36,4100000
8474013,Ian,Cole,1989-02-21,D,L,2019-20,68,4,22,26,0.38,20,94,4.26,36,72028.0,17:39,0,0,0,0.0,86,126,18,40,-22,0,0,0,71.0,0:1,0,0,0,9826.0,2:24,4250000
8474027,Justin,Braun,1987-02-10,D,R,2019-20,65,3,16,19,0.29,-2,73,4.11,18,67215.0,17:14,0,0,0,0.0,94,85,11,34,-23,0,1,1,219.0,0:3,0,0,0,7500.0,1:55,3800000
8474031,Kevin,Shattenkirk,1989-01-29,D,R,2019-20,73,8,26,34,0.47,20,135,5.93,38,82713.0,18:53,0,0,0,0.0,65,68,33,35,-2,1,6,7,5891.0,1:20,0,0,0,1344.0,0:18,6650000
8474034,Patrick,Maroon,1988-04-23,LW,L,2019-20,67,9,15,24,0.36,4,82,10.98,71,50013.0,12:26,6,3,9,66.67,114,14,14,17,-3,1,2,3,6014.0,1:29,0,0,0,83.0,0:1,900000
8474037,James,van Riemsdyk,1989-05-04,LW,L,2019-20,68,19,21,40,0.59,6,153,12.42,10,60459.0,14:49,8,15,23,34.78,27,19,17,16,1,4,5,9,10343.0,2:32,0,0,0,67.0,0:0,7000000
8474038,Paul,Byron,1989-04-27,LW,L,2019-20,29,4,6,10,0.34,5,29,13.79,4,24928.0,14:19,1,5,6,16.67,42,18,11,10,1,0,0,0,293.0,0:10,1,0,1,3172.0,1:49,3400000
8474040,Sam,Gagner,1989-08-10,C,R,2019-20,42,6,7,13,0.31,-10,79,7.59,12,33640.0,13:20,45,57,102,44.12,22,10,12,21,-9,2,1,3,2559.0,1:0,0,0,0,32.0,0:0,3150000
8474053,Logan,Couture,1989-03-28,C,L,2019-20,52,16,23,39,0.75,0,126,12.7,18,57806.0,18:31,195,248,443,44.02,54,45,28,26,2,0,9,9,8585.0,2:45,0,2,2,5276.0,1:41,8000000
8474056,P.K.,Subban,1989-05-13,D,R,2019-20,68,7,11,18,0.26,-21,151,4.64,79,90265.0,22:7,0,0,0,0.0,88,90,19,65,-46,2,4,6,9614.0,2:21,0,0,0,6690.0,1:38,9000000
8474062,Riley,Nash,1989-05-09,C,R,2019-20,64,5,9,14,0.22,6,64,7.81,10,45479.0,11:50,245,267,512,47.85,68,36,25,10,15,0,0,0,140.0,0:2,1,0,1,4154.0,1:4,2750000
8474068,Kyle,Turris,1989-08-14,C,R,2019-20,62,9,22,31,0.5,-9,88,10.23,22,57378.0,15:25,246,272,518,47.49,18,25,21,29,-8,2,8,10,8588.0,2:18,0,0,0,2390.0,0:38,6000000
8474090,Brendan,Smith,1989-02-08,D,L,2019-20,62,3,5,8,0.13,-12,45,6.67,71,41298.0,11:6,1,0,1,100.0,90,41,18,24,-6,0,0,0,187.0,0:3,1,1,2,7686.0,2:3,4350000
8474091,Brandon,Sutter,1989-02-14,C,R,2019-20,44,8,9,17,0.39,1,76,10.53,25,39203.0,14:50,185,193,378,48.94,18,15,15,9,6,1,2,3,2280.0,0:51,0,0,0,6256.0,2:22,4375000
8474098,Colton,Sceviour,1989-04-20,C,R,2019-20,69,6,10,16,0.23,2,114,5.26,6,54838.0,13:14,65,83,148,43.92,91,72,26,35,-9,0,0,0,83.0,0:1,0,0,0,10352.0,2:30,1200000
8474102,David,Perron,1988-05-28,LW,R,2019-20,74,27,35,62,0.84,1,172,15.7,54,81249.0,18:17,3,5,8,37.5,71,21,39,36,3,10,18,28,13441.0,3:1,0,0,0,141.0,0:1,4000000
8474125,Carl,Gunnarsson,1986-11-09,D,L,2019-20,38,2,5,7,0.18,8,33,6.06,20,35922.0,15:45,0,0,0,0.0,29,53,3,16,-13,0,0,0,38.0,0:1,0,1,1,4577.0,2:0,1750000
8474134,Yannick,Weber,1988-09-23,D,R,2019-20,41,1,2,3,0.07,-1,45,2.22,14,34469.0,14:0,0,0,0,0.0,37,38,11,11,0,0,0,0,158.0,0:3,0,0,0,607.0,0:14,675000
8474141,Patrick,Kane,1988-11-19,RW,L,2019-20,70,33,51,84,1.2,8,275,12.0,40,89631.0,21:20,1,3,4,25.0,24,19,43,41,2,8,15,23,15575.0,3:42,0,0,0,135.0,0:1,10500000
8474145,Robert,Bortuzzo,1989-03-18,D,R,2019-20,43,2,4,6,0.14,10,36,5.56,21,33746.0,13:4,0,0,0,0.0,69,44,2,11,-9,0,0,0,11.0,0:0,0,0,0,6478.0,2:30,1375000
8474149,Evgenii,Dadonov,1989-03-12,RW,L,2019-20,69,25,22,47,0.68,-7,167,14.97,10,70816.0,17:6,0,0,0,0.0,29,24,29,40,-11,11,6,17,13833.0,3:20,0,0,0,44.0,0:0,4000000
8474150,Mikael,Backlund,1989-03-17,C,L,2019-20,70,16,29,45,0.64,3,157,10.19,26,75283.0,17:55,368,410,778,47.3,44,11,64,55,9,3,7,10,5897.0,1:24,3,0,3,6687.0,1:35,5350000
8474151,Ryan,McDonagh,1989-06-13,D,L,2019-20,53,1,12,13,0.25,7,57,1.75,19,66581.0,20:56,0,0,0,0.0,42,108,25,34,-9,0,0,0,352.0,0:6,0,1,1,10399.0,3:16,6750000
8474157,Max,Pacioretty,1988-11-20,LW,L,2019-20,71,32,34,66,0.93,18,307,10.42,44,76319.0,17:54,51,45,96,53.12,90,35,32,55,-23,8,11,19,10443.0,2:27,0,0,0,135.0,0:1,7000000
8474161,Jakub,Voracek,1989-08-15,RW,L,2019-20,71,12,45,57,0.8,15,135,8.89,33,72726.0,17:4,7,13,20,35.0,18,21,30,31,-1,4,13,17,12798.0,3:0,0,0,0,122.0,0:1,8250000
8474162,Jake,Muzzin,1989-02-21,D,L,2019-20,53,6,17,23,0.43,12,99,6.06,40,68672.0,21:35,0,0,0,0.0,109,110,24,63,-39,0,0,0,849.0,0:16,0,1,1,8023.0,2:31,4000000
8474166,Alec,Martinez,1987-07-26,D,L,2019-20,54,3,13,16,0.3,-3,79,3.8,23,70069.0,21:37,0,0,0,0.0,45,126,15,35,-20,0,4,4,4633.0,1:25,0,0,0,5630.0,1:44,4000000
8474176,Carl,Hagelin,1988-08-23,LW,L,2019-20,61,8,18,26,0.43,12,108,7.41,18,52041.0,14:13,13,16,29,44.83,26,20,24,25,-1,0,0,0,49.0,0:0,1,2,3,10487.0,2:51,2750000
8474189,Lars,Eller,1989-05-08,C,L,2019-20,70,16,24,40,0.57,3,152,10.53,48,71446.0,17:0,544,499,1043,52.16,64,44,44,41,3,2,4,6,7201.0,1:42,1,1,2,10027.0,2:23,3500000
8474190,Wayne,Simmonds,1988-08-26,RW,R,2019-20,68,8,17,25,0.37,-21,119,6.72,66,60882.0,14:55,29,45,74,39.19,145,29,27,18,9,5,4,9,10586.0,2:35,0,0,0,3.0,0:0,5000000
8474207,Nick,Holden,1987-05-15,D,L,2019-20,64,6,9,15,0.23,-1,106,5.66,13,71140.0,18:31,0,0,0,0.0,142,75,26,35,-9,1,0,1,261.0,0:4,0,1,1,7150.0,1:51,2200000
8474218,Jason,Demers,1988-06-09,D,R,2019-20,50,0,11,11,0.22,5,53,0.0,25,61484.0,20:29,0,0,0,0.0,76,70,15,32,-17,0,0,0,493.0,0:9,0,1,1,6819.0,2:16,4500000
8474230,Micheal,Haley,1986-03-30,C,L,2019-20,22,1,0,1,0.05,-7,9,11.11,50,7295.0,5:31,7,5,12,58.33,36,6,1,5,-4,0,0,0,2.0,0:0,0,0,0,26.0,0:1,700000
8474250,Zack,Smith,1988-04-05,LW,L,2019-20,50,4,7,11,0.22,2,43,9.3,29,35360.0,11:47,88,102,190,46.32,112,18,21,14,7,0,0,0,525.0,0:10,1,1,2,3698.0,1:13,3250000
8474291,Jay,Beagle,1985-10-16,C,R,2019-20,55,2,6,8,0.15,-9,49,4.08,38,41461.0,12:33,401,277,678,59.14,69,42,14,7,7,0,0,0,173.0,0:3,1,1,2,10010.0,3:2,3000000
8474563,Drew,Doughty,1989-12-08,D,R,2019-20,67,7,28,35,0.52,-16,141,4.96,36,103776.0,25:48,0,0,0,0.0,106,87,15,82,-67,5,9,14,12511.0,3:6,0,1,1,8480.0,2:6,11000000
8474564,Steven,Stamkos,1990-02-07,C,R,2019-20,57,29,37,66,1.16,14,176,16.48,22,62997.0,18:25,365,307,672,54.32,69,38,24,33,-9,10,9,19,11237.0,3:17,0,0,0,1759.0,0:30,8500000
8474565,Alex,Pietrangelo,1990-01-18,D,R,2019-20,73,16,36,52,0.71,11,232,6.9,22,105689.0,24:7,0,0,0,0.0,48,98,43,47,-4,6,16,22,13719.0,3:7,0,1,1,8319.0,1:53,6500000
8474567,Zach,Bogosian,1990-07-15,D,R,2019-20,29,1,6,7,0.24,-1,35,2.86,24,29240.0,16:48,0,0,0,0.0,36,28,4,13,-9,0,0,0,121.0,0:4,0,1,1,3632.0,2:5,5142857
8474568,Luke,Schenn,1989-11-02,D,R,2019-20,25,1,2,3,0.12,-8,31,3.23,23,18677.0,12:27,0,0,0,0.0,83,21,5,10,-5,0,0,0,52.0,0:2,0,0,0,2426.0,1:37,700000
8474569,Colin,Wilson,1989-10-20,C,L,2019-20,9,0,4,4,0.44,6,12,0.0,0,6826.0,12:38,3,4,7,42.86,8,2,1,3,-2,0,0,0,921.0,1:42,0,0,0,0.0,0:0,2600000
8474571,Mikkel,Boedker,1989-12-16,LW,L,2019-20,20,2,2,4,0.2,-1,29,6.9,0,11657.0,9:42,1,3,4,25.0,12,5,1,8,-7,0,0,0,875.0,0:43,1,0,1,651.0,0:32,4000000
8474573,Josh,Bailey,1989-10-02,RW,L,2019-20,68,14,29,43,0.63,-12,94,14.89,10,68946.0,16:53,128,128,256,50.0,20,48,38,54,-16,2,7,9,7338.0,1:47,1,0,1,5860.0,1:26,5000000
8474574,Tyler,Myers,1990-02-01,D,R,2019-20,68,6,15,21,0.31,-7,134,4.48,49,87751.0,21:30,0,0,0,0.0,99,108,42,41,1,1,6,7,5368.0,1:18,1,0,1,6595.0,1:36,6000000
8474578,Erik,Karlsson,1990-05-31,D,R,2019-20,56,6,34,40,0.71,-15,120,5.0,16,82397.0,24:31,0,0,0,0.0,26,74,52,68,-16,1,12,13,10093.0,3:0,1,0,1,8654.0,2:34,11500000
8474579,Luca,Sbisa,1990-01-30,D,L,2019-20,44,2,8,10,0.23,1,49,4.08,37,47355.0,17:56,0,0,0,0.0,91,71,4,26,-22,0,0,0,74.0,0:1,0,0,0,5185.0,1:57,750000
8474581,Jake,Gardiner,1990-07-04,D,L,2019-20,68,4,20,24,0.35,-24,87,4.6,30,67973.0,16:39,0,0,0,0.0,43,42,32,39,-7,1,10,11,7308.0,1:47,0,0,0,172.0,0:2,4050000
8474584,Michael,Del Zotto,1990-06-24,D,L,2019-20,49,2,13,15,0.31,5,57,3.51,14,55033.0,18:43,0,0,0,0.0,101,55,9,33,-24,0,1,1,2327.0,0:47,0,0,0,4106.0,1:23,750000
8474586,Jordan,Eberle,1990-05-15,C,R,2019-20,58,16,24,40,0.69,1,136,11.76,12,61985.0,17:48,3,6,9,33.33,37,39,34,37,-3,4,7,11,9029.0,2:35,0,0,0,36.0,0:0,5500000
8474589,Tyler,Ennis,1989-10-06,LW,L,2019-20,70,16,21,37,0.53,-6,159,10.06,20,61776.0,14:42,7,8,15,46.67,96,26,26,19,7,5,5,10,9020.0,2:8,0,0,0,104.0,0:1,800000
8474590,John,Carlson,1990-01-10,D,R,2019-20,69,15,60,75,1.09,12,189,7.94,26,101954.0,24:37,0,1,1,0.0,55,108,42,80,-38,2,24,26,16663.0,4:1,0,0,0,6156.0,1:29,8000000
8474597,Cody,Goloubef,1989-11-30,D,R,2019-20,26,1,1,2,0.08,-3,18,5.56,8,23693.0,15:11,0,0,0,0.0,45,24,3,21,-18,0,0,0,48.0,0:1,0,0,0,2361.0,1:30,800000
8474600,Roman,Josi,1990-06-01,D,L,2019-20,69,16,49,65,0.94,22,260,6.15,41,106725.0,25:46,0,0,0,0.0,52,108,34,68,-34,4,19,23,13569.0,3:16,0,0,0,8311.0,2:0,4000000
8474602,Justin,Schultz,1990-07-06,D,R,2019-20,46,3,9,12,0.26,-13,86,3.49,6,54855.0,19:52,0,0,0,0.0,36,50,6,18,-12,0,6,6,7575.0,2:44,0,0,0,443.0,0:9,5500000
8474604,Aaron,Ness,1990-05-18,D,L,2019-20,24,0,1,1,0.04,1,11,0.0,0,18050.0,12:32,0,0,0,0.0,17,20,1,8,-7,0,0,0,54.0,0:2,0,0,0,241.0,0:10,725000
8474611,Cameron,Gaunce,1990-03-19,D,L,2019-20,3,1,3,4,1.33,2,5,20.0,4,2136.0,11:52,0,0,0,0.0,5,2,0,0,0,0,0,0,0.0,0:0,0,0,0,91.0,0:30,700000
8474612,Travis,Hamonic,1990-08-16,D,R,2019-20,50,3,9,12,0.24,-3,83,3.61,27,63584.0,21:11,0,0,0,0.0,39,110,21,36,-15,0,0,0,226.0,0:4,0,0,0,9338.0,3:6,3857143
8474613,Derek,Stepan,1990-06-18,C,R,2019-20,70,10,18,28,0.4,-4,158,6.33,16,74097.0,17:38,569,628,1197,47.54,43,54,38,28,10,1,6,7,7053.0,1:40,1,0,1,8336.0,1:59,6500000
8474618,Marco,Scandella,1990-02-23,D,L,2019-20,65,4,9,13,0.2,15,79,5.06,20,68830.0,17:38,0,0,0,0.0,80,63,18,50,-32,0,0,0,201.0,0:3,0,0,0,8235.0,2:6,4000000
8474628,Michael,Stone,1990-06-07,D,R,2019-20,33,2,5,7,0.21,-5,57,3.51,16,32285.0,16:18,0,0,0,0.0,52,54,6,9,-3,0,0,0,32.0,0:0,0,0,0,2370.0,1:11,3500000
8474641,Adam,Henrique,1990-02-06,C,L,2019-20,71,26,17,43,0.61,-2,169,15.38,22,71872.0,16:52,512,418,930,55.05,75,32,26,32,-6,5,4,9,9907.0,2:19,0,0,0,2387.0,0:33,5825000
8474668,Dale,Weise,1988-08-05,RW,R,2019-20,23,1,4,5,0.22,1,15,6.67,16,12788.0,9:16,0,0,0,0.0,70,10,8,12,-4,0,0,0,70.0,0:3,0,0,0,440.0,0:19,2350000
8474673,TJ,Brodie,1990-06-07,D,L,2019-20,64,4,15,19,0.3,7,65,6.15,36,78527.0,20:26,0,0,0,0.0,20,87,34,52,-18,0,1,1,2387.0,0:37,0,0,0,6355.0,1:39,4650400
8474679,Gustav,Nyquist,1989-09-01,RW,L,2019-20,70,15,27,42,0.6,4,151,9.93,16,75736.0,18:1,17,16,33,51.52,37,26,27,41,-14,3,6,9,10831.0,2:34,1,0,1,2756.0,0:39,5500000
8474683,Derek,Grant,1990-04-20,C,L,2019-20,59,15,11,26,0.44,2,98,15.31,30,48933.0,13:49,375,349,724,51.8,56,28,23,11,12,2,0,2,2496.0,0:42,3,2,5,8421.0,2:22,700000
8474685,Matt,Calvert,1989-12-24,LW,L,2019-20,53,12,13,25,0.47,12,96,12.5,41,44630.0,14:2,12,14,26,46.15,65,23,22,14,8,0,0,0,160.0,0:3,3,1,4,6942.0,2:10,2850000
8474688,Greg,Pateryn,1990-06-20,D,R,2019-20,20,0,3,3,0.15,1,22,0.0,6,18565.0,15:28,0,0,0,0.0,25,30,3,6,-3,0,0,0,123.0,0:6,0,0,0,2442.0,2:2,2250000
8474697,Mark,Borowiecki,1989-07-12,D,L,2019-20,53,7,11,18,0.34,1,63,11.11,58,57047.0,17:56,0,0,0,0.0,199,120,10,30,-20,0,0,0,95.0,0:1,1,0,1,7612.0,2:23,1200000
8474709,Matt,Martin,1989-05-08,LW,L,2019-20,55,5,3,8,0.15,-1,49,10.2,40,34397.0,10:25,3,4,7,42.86,242,24,11,17,-6,0,0,0,265.0,0:4,0,0,0,633.0,0:11,2500000
8474715,Cam,Atkinson,1989-06-05,RW,R,2019-20,44,12,14,26,0.59,2,148,8.11,6,47111.0,17:50,27,30,57,47.37,18,21,26,21,5,3,5,8,6021.0,2:16,0,0,0,4168.0,1:34,5875000
8474716,Jared,Spurgeon,1989-11-29,D,R,2019-20,62,12,20,32,0.52,-1,112,10.71,18,83972.0,22:34,0,1,1,0.0,61,102,10,23,-13,3,10,13,9207.0,2:28,0,0,0,9108.0,2:26,5187500
8474717,Mark,Barberio,1990-03-23,D,L,2019-20,21,0,2,2,0.1,3,29,0.0,16,17765.0,14:5,0,0,0,0.0,13,19,6,13,-7,0,0,0,133.0,0:6,0,0,0,1303.0,1:2,1450000
8474722,Luke,Witkowski,1990-04-14,RW,R,2019-20,12,1,2,3,0.25,-4,10,10.0,13,6338.0,8:48,0,0,0,0.0,38,3,2,2,0,0,0,0,34.0,0:2,0,0,0,67.0,0:5,700000
8474736,Zac,Rinaldo,1990-06-15,C,L,2019-20,19,3,2,5,0.26,-1,19,15.79,34,9427.0,8:16,0,0,0,0.0,69,8,5,5,0,0,0,0,12.0,0:0,0,0,0,0.0,0:0,700000
8474774,Dalton,Prout,1990-03-13,D,R,2019-20,2,0,0,0,0.0,0,2,0.0,7,1537.0,12:48,0,0,0,0.0,3,3,2,0,2,0,0,0,0.0,0:0,0,0,0,51.0,0:25,800000
8474818,Jordie,Benn,1987-07-26,D,L,2019-20,44,1,6,7,0.16,-7,58,1.72,17,42996.0,16:17,0,0,0,0.0,45,62,7,17,-10,0,0,0,123.0,0:2,0,0,0,6218.0,2:21,2000000
8474849,Antoine,Roussel,1989-11-21,LW,L,2019-20,41,7,6,13,0.32,0,55,12.73,43,29113.0,11:50,6,6,12,50.0,44,14,7,13,-6,1,1,2,3210.0,1:18,0,0,0,26.0,0:0,3000000
8474870,Tyler,Johnson,1990-07-29,C,R,2019-20,68,16,18,34,0.5,8,118,13.56,18,59211.0,14:30,177,189,366,48.36,67,23,15,20,-5,2,7,9,7965.0,1:57,0,0,0,291.0,0:4,5000000
8474873,Brian,Lashoff,1990-07-16,D,L,2019-20,9,0,1,1,0.11,1,6,0.0,6,7861.0,14:33,0,0,0,0.0,16,7,0,2,-2,0,0,0,1.0,0:0,0,0,0,731.0,1:21,700000
8474884,Mike,Hoffman,1989-11-24,LW,L,2019-20,69,29,30,59,0.86,-5,214,13.55,28,69708.0,16:50,7,8,15,46.67,33,22,31,52,-21,11,10,21,15143.0,3:39,0,0,0,98.0,0:1,5187500
8475098,Tyler,Bozak,1986-03-19,C,R,2019-20,70,13,17,30,0.43,0,115,11.3,10,64485.0,15:21,385,314,699,55.08,33,36,30,22,8,2,2,4,6879.0,1:38,1,0,1,6191.0,1:28,5000000
8475149,Marcus,Johansson,1990-10-06,LW,L,2019-20,60,9,21,30,0.5,-12,87,10.34,20,61730.0,17:8,196,294,490,40.0,39,22,15,24,-9,1,5,6,8872.0,2:27,0,0,0,1165.0,0:19,4500000
8475151,Kyle,Palmieri,1991-02-01,RW,R,2019-20,65,25,20,45,0.69,-4,155,16.13,41,66731.0,17:6,12,25,37,32.43,74,36,29,28,1,11,7,18,12377.0,3:10,0,0,0,840.0,0:12,4650000
8475158,Ryan,O'Reilly,1991-02-07,C,L,2019-20,74,12,52,64,0.86,12,122,9.84,10,91686.0,20:39,923,692,1615,57.15,17,43,71,24,47,2,17,19,12979.0,2:55,1,0,1,9914.0,2:13,7500000
8475160,Kyle,Clifford,1991-01-13,LW,L,2019-20,69,7,10,17,0.25,-7,110,6.36,68,46368.0,11:12,6,4,10,60.0,133,15,11,17,-6,0,0,0,428.0,0:6,0,0,0,497.0,0:7,1600000
8475163,Alex,Chiasson,1990-10-01,RW,R,2019-20,65,11,13,24,0.37,-3,97,11.34,42,51182.0,13:7,0,4,4,0.0,56,15,14,20,-6,6,7,13,8633.0,2:12,0,0,0,31.0,0:0,2150000
8475164,Jakob,Silfverberg,1990-10-13,RW,R,2019-20,66,21,18,39,0.59,0,155,13.55,14,70026.0,17:41,8,33,41,19.51,28,41,40,32,8,4,3,7,9423.0,2:22,2,0,2,6575.0,1:39,5250000
8475166,John,Tavares,1990-09-20,C,L,2019-20,63,26,34,60,0.95,-7,197,13.2,24,73897.0,19:32,617,499,1116,55.29,32,31,35,47,-12,7,14,21,11380.0,3:0,0,0,0,64.0,0:1,11000000
8475167,Victor,Hedman,1990-12-18,D,L,2019-20,69,11,45,56,0.81,27,158,6.96,31,97936.0,23:39,0,0,0,0.0,75,101,48,40,8,4,19,23,12304.0,2:58,0,0,0,9623.0,2:19,7875000
8475168,Matt,Duchene,1991-01-16,C,L,2019-20,66,13,29,42,0.64,-4,136,9.56,24,66847.0,16:52,390,305,695,56.12,40,22,31,36,-5,5,6,11,10478.0,2:38,0,0,0,92.0,0:1,8000000
8475169,Evander,Kane,1991-08-02,LW,L,2019-20,64,26,21,47,0.73,-12,216,12.04,122,75028.0,19:32,106,95,201,52.74,135,25,45,51,-6,14,4,18,10444.0,2:43,2,0,2,5217.0,1:21,7000000
8475170,Brayden,Schenn,1991-08-22,C,L,2019-20,74,25,35,60,0.81,1,141,17.73,44,81538.0,18:21,359,382,741,48.45,124,22,27,40,-13,10,12,22,12845.0,2:53,0,0,0,1052.0,0:14,5125000
8475171,Oliver,Ekman-Larsson,1991-07-17,D,L,2019-20,66,9,21,30,0.45,-3,135,6.67,38,91114.0,23:0,0,0,0,0.0,129,65,19,45,-26,2,5,7,10577.0,2:40,1,0,1,8192.0,2:4,8250000
8475172,Nazem,Kadri,1990-10-06,C,L,2019-20,54,20,20,40,0.74,8,147,13.61,97,56843.0,17:32,427,335,762,56.04,65,9,22,30,-8,5,9,14,12483.0,3:51,0,0,0,369.0,0:6,4500000
8475176,Ryan,Ellis,1991-01-03,D,R,2019-20,49,8,30,38,0.78,16,114,7.02,19,69103.0,23:30,0,0,0,0.0,48,96,24,36,-12,2,7,9,6518.0,2:13,0,0,0,6915.0,2:21,6250000
8475177,Calvin,de Haan,1991-05-09,D,L,2019-20,29,1,5,6,0.21,10,42,2.38,10,34645.0,19:54,0,0,0,0.0,93,73,9,29,-20,0,0,0,183.0,0:6,0,0,0,4678.0,2:41,4550000
8475178,Zack,Kassian,1991-01-24,RW,R,2019-20,59,15,19,34,0.58,0,99,15.15,69,55444.0,15:39,1,2,3,33.33,157,8,26,45,-19,0,0,0,1457.0,0:24,0,0,0,76.0,0:1,1950000
8475179,Dmitry,Kulikov,1990-10-29,D,L,2019-20,51,2,8,10,0.2,-4,54,3.7,32,61259.0,20:1,0,0,0,0.0,104,77,16,55,-39,0,0,0,380.0,0:7,0,0,0,4188.0,1:22,4333333
8475181,Nick,Leddy,1991-03-20,D,L,2019-20,60,3,18,21,0.35,-1,72,4.17,14,76004.0,21:6,0,0,0,0.0,62,72,17,52,-35,1,3,4,4214.0,1:10,0,0,0,2973.0,0:49,5500000
8475184,Chris,Kreider,1991-04-30,LW,L,2019-20,63,24,21,45,0.71,13,156,15.38,58,65204.0,17:14,53,70,123,43.09,116,42,22,61,-39,9,4,13,13113.0,3:28,0,0,0,114.0,0:1,4625000
8475186,John,Moore,1990-11-19,D,L,2019-20,24,2,1,3,0.12,-2,33,6.06,11,23822.0,16:32,0,0,0,0.0,36,27,2,7,-5,0,0,0,261.0,0:10,0,0,0,2734.0,1:53,2750000
8475188,Brayden,McNabb,1991-01-21,D,L,2019-20,74,2,8,10,0.14,2,76,2.63,44,88795.0,19:59,0,0,0,0.0,209,140,32,33,-1,0,0,0,251.0,0:3,1,0,1,13621.0,3:4,2500000
8475191,Reilly,Smith,1991-04-01,RW,L,2019-20,74,27,29,56,0.76,20,173,15.61,20,79360.0,17:52,3,9,12,25.0,60,30,59,42,17,3,3,6,8556.0,1:55,2,2,4,8566.0,1:55,5000000
8475193,Tomas,Tatar,1990-12-01,LW,L,2019-20,68,22,39,61,0.9,5,162,13.58,36,66480.0,16:17,9,16,25,36.0,79,24,31,29,2,8,6,14,8918.0,2:11,0,0,0,115.0,0:1,5300000
8475197,Tyson,Barrie,1991-07-26,D,R,2019-20,70,5,34,39,0.56,-7,169,2.96,16,91885.0,21:52,0,0,0,0.0,47,76,16,62,-46,1,11,12,11204.0,2:40,0,0,0,145.0,0:2,5500000
8475200,Dmitry,Orlov,1991-07-23,D,L,2019-20,72,4,24,28,0.39,4,111,3.6,38,96675.0,22:22,0,0,0,0.0,111,88,50,68,-18,1,5,6,6530.0,1:30,0,1,1,3768.0,0:52,5100000
8475204,Brandon,Pirri,1991-04-10,RW,L,2019-20,16,0,2,2,0.12,-4,24,0.0,8,12062.0,12:33,6,3,9,66.67,16,5,8,4,4,0,0,0,1682.0,1:45,0,0,0,7.0,0:0,775000
8475208,Brian,Dumoulin,1991-09-06,D,L,2019-20,28,1,7,8,0.29,17,35,2.86,10,35373.0,21:3,0,0,0,0.0,44,35,13,13,0,0,1,1,1102.0,0:39,1,0,1,3580.0,2:7,4100000
8475209,Richard,Panik,1991-02-07,RW,L,2019-20,62,10,13,23,0.37,16,68,14.71,38,42353.0,11:23,11,8,19,57.89,79,21,23,31,-8,0,0,0,774.0,0:12,0,0,0,2096.0,0:33,2750000
8475218,Mattias,Ekholm,1990-05-24,D,L,2019-20,68,8,25,33,0.49,-1,154,5.19,32,95363.0,23:22,0,0,0,0.0,49,100,51,50,1,0,5,5,5414.0,1:19,1,1,2,11540.0,2:49,3750000
8475220,Marcus,Foligno,1991-08-10,LW,L,2019-20,59,11,14,25,0.42,8,86,12.79,30,51636.0,14:35,9,15,24,37.5,184,36,31,17,14,0,0,0,115.0,0:1,0,0,0,6434.0,1:49,2875000
8475222,Sami,Vatanen,1991-06-03,D,R,2019-20,47,5,18,23,0.49,-12,95,5.26,22,61336.0,21:45,0,0,0,0.0,50,80,14,24,-10,1,9,10,8582.0,3:2,0,1,1,5544.0,1:57,4875000
8475224,Jordan,Szwarz,1991-05-14,RW,R,2019-20,3,0,0,0,0.0,0,2,0.0,2,886.0,4:55,4,5,9,44.44,6,1,0,0,0,0,0,0,0.0,0:0,0,0,0,0.0,0:0,800000
8475225,Craig,Smith,1989-09-05,RW,R,2019-20,69,18,13,31,0.45,18,184,9.78,34,55578.0,13:25,14,15,29,48.28,60,19,26,26,0,4,3,7,9507.0,2:17,0,0,0,37.0,0:0,4250000
8475231,Casey,Cizikas,1991-02-27,C,L,2019-20,48,10,4,14,0.29,12,67,14.93,41,41166.0,14:17,368,320,688,53.49,133,39,38,28,10,0,0,0,134.0,0:2,3,2,5,6720.0,2:20,3350000
8475233,David,Savard,1990-10-22,D,R,2019-20,68,0,11,11,0.16,-3,97,0.0,35,84397.0,20:41,0,0,0,0.0,129,163,18,43,-25,0,2,2,868.0,0:12,0,0,0,7484.0,1:50,4250000
8475235,Nicolas,Deslauriers,1991-02-22,LW,L,2019-20,59,7,6,13,0.22,-1,64,10.94,92,34613.0,9:46,0,0,0,0.0,137,32,10,10,0,0,0,0,182.0,0:3,0,0,0,93.0,0:1,950000
8475236,Cody,Eakin,1991-05-24,C,L,2019-20,49,5,10,15,0.31,-3,61,8.2,16,42855.0,14:34,312,329,641,48.67,49,16,23,21,2,0,1,1,1227.0,0:25,0,0,0,5536.0,1:52,3850000
8475246,Kevin,Connauton,1990-02-23,D,L,2019-20,4,0,0,0,0.0,-2,4,0.0,0,3720.0,15:30,0,0,0,0.0,6,6,0,0,0,0,0,0,25.0,0:6,0,0,0,289.0,1:12,1375000
8475254,Gabriel,Dumont,1990-10-06,C,R,2019-20,3,0,0,0,0.0,-1,3,0.0,0,2071.0,11:30,6,9,15,40.0,9,2,1,0,1,0,0,0,24.0,0:8,0,0,0,12.0,0:4,700000
8475268,Gabriel,Bourque,1990-09-23,LW,L,2019-20,52,2,4,6,0.12,-1,33,6.06,7,26841.0,8:36,2,3,5,40.0,125,40,5,14,-9,0,0,0,252.0,0:4,0,0,0,820.0,0:15,700000
8475279,Ben,Chiarot,1991-05-09,D,L,2019-20,69,9,12,21,0.3,5,130,6.92,61,95773.0,23:8,0,0,0,0.0,152,128,18,86,-68,0,0,0,1116.0,0:16,0,0,0,12624.0,3:2,3500000
8475287,Erik,Haula,1991-03-23,LW,L,2019-20,48,12,12,24,0.5,1,92,13.04,22,45592.0,15:49,381,323,704,54.12,27,15,21,29,-8,4,4,8,6623.0,2:17,0,0,0,2214.0,0:46,2750000
8475314,Anders,Lee,1990-07-03,LW,L,2019-20,68,20,23,43,0.63,8,195,10.26,47,74649.0,18:17,90,109,199,45.23,102,50,24,44,-20,2,5,7,9321.0,2:17,0,0,0,59.0,0:0,7000000
8475324,Nick,Jensen,1990-09-21,D,R,2019-20,71,0,8,8,0.11,0,63,0.0,13,75606.0,17:44,0,0,0,0.0,60,74,28,55,-27,0,1,1,235.0,0:3,0,0,0,10012.0,2:21,2500000
8475343,Nic,Dowd,1990-05-27,C,R,2019-20,59,7,8,15,0.25,9,55,12.73,28,38739.0,10:56,284,292,576,49.31,124,28,23,7,16,0,0,0,65.0,0:1,3,0,3,8748.0,2:28,750000
8475413,Justin,Dowling,1990-10-01,C,L,2019-20,29,3,3,6,0.21,-3,29,10.34,8,19061.0,10:57,42,54,96,43.75,25,12,15,9,6,0,0,0,2137.0,1:13,0,0,0,138.0,0:4,750000
8475430,Brandon,Manning,1990-06-04,D,L,2019-20,9,1,0,1,0.11,-1,8,12.5,17,5965.0,11:2,0,0,0,0.0,10,6,1,8,-7,0,0,0,0.0,0:0,0,0,0,0.0,0:0,2250000
8475455,Brenden,Dillon,1990-11-13,D,L,2019-20,72,1,13,14,0.19,-1,63,1.59,106,84491.0,19:33,0,0,0,0.0,206,80,16,29,-13,0,0,0,201.0,0:2,0,1,1,9202.0,2:7,3270000
8475461,Andrew,Agozzino,1991-01-03,LW,L,2019-20,22,1,2,3,0.14,3,10,10.0,4,9709.0,7:21,38,37,75,50.67,25,7,5,4,1,0,0,0,598.0,0:27,0,0,0,85.0,0:3,700000
8475462,Radko,Gudas,1990-06-05,D,R,2019-20,65,2,15,17,0.26,15,91,2.2,40,65182.0,16:42,0,0,0,0.0,167,79,23,36,-13,0,0,0,216.0,0:3,0,0,0,10625.0,2:43,3350000
8475625,Matt,Irwin,1987-11-29,D,L,2019-20,36,0,3,3,0.08,-15,58,0.0,15,31260.0,14:28,0,0,0,0.0,80,54,8,13,-5,0,0,0,93.0,0:2,0,0,0,2029.0,0:56,675000
8475690,Christopher,Tanev,1989-12-20,D,R,2019-20,69,2,18,20,0.29,4,45,4.44,41,80860.0,19:31,0,0,0,0.0,32,159,20,45,-25,0,1,1,304.0,0:4,0,1,1,14113.0,3:24,4450000
8475692,Mats,Zuccarello,1987-09-01,RW,L,2019-20,65,15,22,37,0.57,-9,96,15.62,18,62164.0,15:56,9,5,14,64.29,13,36,33,17,16,3,4,7,9562.0,2:27,0,0,0,113.0,0:1,6000000
8475714,Calle,Jarnkrok,1991-09-25,C,R,2019-20,64,15,19,34,0.53,4,136,11.03,14,61191.0,15:56,33,37,70,47.14,28,27,19,11,8,2,7,9,6908.0,1:47,2,0,2,6055.0,1:34,2000000
8475716,Martin,Marincin,1992-02-18,D,L,2019-20,26,1,3,4,0.15,-1,28,3.57,14,23699.0,15:11,0,0,0,0.0,22,43,9,22,-13,0,0,0,27.0,0:1,0,0,0,2594.0,1:39,700000
8475718,Justin,Holl,1992-01-30,D,R,2019-20,68,2,16,18,0.26,13,89,2.25,43,75517.0,18:30,0,0,0,0.0,89,83,21,59,-38,0,0,0,167.0,0:2,0,0,0,8074.0,1:58,675000
8475722,Jason,Zucker,1992-01-16,LW,L,2019-20,60,20,21,41,0.68,-4,111,18.02,21,58814.0,16:20,12,29,41,29.27,53,23,31,25,6,7,5,12,8229.0,2:17,0,0,0,376.0,0:6,5500000
8475726,Tyler,Toffoli,1992-04-24,C,R,2019-20,68,24,20,44,0.65,-1,203,11.82,20,68671.0,16:49,4,10,14,28.57,48,16,35,34,1,5,5,10,8838.0,2:9,0,0,0,3723.0,0:54,4600000
8475728,Johan,Larsson,1992-07-25,C,L,2019-20,62,6,12,18,0.29,8,60,10.0,26,55424.0,14:53,322,346,668,48.2,85,31,24,23,1,0,0,0,293.0,0:4,0,0,0,7477.0,2:0,1550000
8475730,Stephen,Johns,1992-04-18,D,R,2019-20,20,2,3,5,0.25,-2,37,5.41,10,20994.0,17:29,0,0,0,0.0,64,24,6,12,-6,0,0,0,107.0,0:5,0,0,0,995.0,0:49,2350000
8475735,Greg,McKegg,1992-06-17,C,L,2019-20,53,5,4,9,0.17,-2,40,12.5,17,30416.0,9:33,104,107,211,49.29,69,24,14,13,1,0,0,0,61.0,0:1,1,1,2,2996.0,0:56,750000
8475738,Jordan,Weal,1992-04-15,C,R,2019-20,49,8,7,15,0.31,-8,86,9.3,14,40023.0,13:36,96,97,193,49.74,32,21,22,12,10,2,3,5,5719.0,1:56,0,0,0,89.0,0:1,1400000
8475744,Evgeny,Kuznetsov,1992-05-19,C,L,2019-20,66,20,33,53,0.8,-3,134,14.93,44,70328.0,17:45,367,481,848,43.28,39,16,24,47,-23,7,6,13,12456.0,3:8,0,0,0,68.0,0:1,7800000
8475745,Charlie,Coyle,1992-03-02,C,R,2019-20,73,16,21,37,0.51,7,150,10.67,21,74085.0,16:54,348,391,739,47.09,88,35,51,33,18,1,4,5,8426.0,1:55,2,0,2,3969.0,0:54,3200000
8475747,Patrik,Nemeth,1992-02-08,D,L,2019-20,64,1,8,9,0.14,-10,89,1.12,28,84626.0,22:2,0,0,0,0.0,80,92,10,54,-44,0,0,0,366.0,0:5,0,1,1,13194.0,3:26,3000000
8475750,Jon,Merrill,1992-02-03,D,L,2019-20,49,2,5,7,0.14,9,37,5.41,32,53373.0,18:9,0,0,0,0.0,51,71,14,27,-13,0,0,0,612.0,0:12,0,1,1,4078.0,1:23,1375000
8475752,Tyler,Pitlick,1991-11-01,C,R,2019-20,66,9,12,21,0.32,13,80,11.25,12,47983.0,12:7,5,13,18,27.78,138,43,29,17,12,0,0,0,203.0,0:3,0,0,0,4285.0,1:4,1000000
8475753,Justin,Faulk,1992-03-20,D,R,2019-20,72,5,11,16,0.22,-1,150,3.33,32,88907.0,20:34,0,0,0,0.0,90,80,25,41,-16,1,2,3,4537.0,1:3,0,1,1,5390.0,1:14,4833333
8475754,Brock,Nelson,1991-10-15,C,L,2019-20,68,26,28,54,0.79,6,175,14.86,32,76948.0,18:51,615,573,1188,51.77,49,44,26,52,-26,4,3,7,8284.0,2:1,0,0,0,6432.0,1:34,6000000
8475760,Nick,Bjugstad,1992-07-17,C,R,2019-20,13,1,1,2,0.15,3,18,5.56,8,9542.0,12:14,38,58,96,39.58,19,7,3,5,-2,0,0,0,971.0,1:14,0,0,0,300.0,0:23,4100000
8475762,Derek,Forbort,1992-03-04,D,L,2019-20,20,0,1,1,0.05,-5,22,0.0,4,21375.0,17:48,0,0,0,0.0,35,30,2,16,-14,0,0,0,0.0,0:0,0,0,0,1792.0,1:29,2525000
8475763,Kevin,Hayes,1992-05-08,C,L,2019-20,72,23,22,45,0.62,-2,182,12.64,34,76572.0,17:43,443,430,873,50.74,93,24,48,35,13,4,3,7,7200.0,1:40,4,0,4,8645.0,2:0,7142857
8475764,Cam,Fowler,1991-12-05,D,L,2019-20,59,9,20,29,0.49,0,117,7.69,20,77842.0,21:59,0,0,0,0.0,25,58,21,31,-10,2,6,8,9071.0,2:33,0,0,0,2394.0,0:40,6500000
8475765,Vladimir,Tarasenko,1991-12-13,RW,L,2019-20,12,3,7,10,0.83,-3,31,9.68,0,11583.0,16:5,0,0,0,0.0,17,8,6,5,1,1,2,3,1852.0,2:34,0,0,0,14.0,0:1,7500000
8475766,Austin,Watson,1992-01-13,LW,R,2019-20,53,6,8,14,0.26,-9,50,12.0,65,36952.0,11:37,6,6,12,50.0,131,48,18,20,-2,0,0,0,210.0,0:3,0,2,2,3421.0,1:4,1100000
8475768,Jaden,Schwartz,1992-06-25,LW,L,2019-20,74,22,35,57,0.77,1,164,13.41,20,80466.0,18:7,9,12,21,42.86,62,30,52,30,22,9,11,20,12655.0,2:51,0,0,0,978.0,0:13,5350000
8475772,Riley,Sheahan,1991-12-07,C,L,2019-20,66,8,7,15,0.23,-13,70,11.43,6,50660.0,12:47,409,425,834,49.04,26,33,36,25,11,0,0,0,124.0,0:1,1,1,2,9293.0,2:20,900000
8475780,Chris,Wagner,1991-05-27,RW,R,2019-20,70,8,4,12,0.17,-8,84,9.52,47,51875.0,12:21,117,135,252,46.43,204,33,16,21,-5,0,0,0,274.0,0:3,1,0,1,6081.0,1:26,1250000
8475784,Jeff,Skinner,1992-05-16,LW,L,2019-20,59,14,9,23,0.39,-22,183,7.65,18,58354.0,16:29,32,54,86,37.21,29,11,28,24,4,0,3,3,8770.0,2:28,0,0,0,3.0,0:0,9000000
8475786,Zach,Hyman,1992-06-09,C,R,2019-20,51,21,16,37,0.73,13,106,19.81,23,58434.0,19:5,70,90,160,43.75,52,23,32,16,16,3,3,6,3364.0,1:5,1,0,1,5717.0,1:52,2250000
8475790,Erik,Gudbranson,1992-01-07,D,R,2019-20,51,4,5,9,0.18,0,78,5.13,95,59254.0,19:21,0,0,0,0.0,89,58,0,33,-33,0,0,0,387.0,0:7,0,1,1,6271.0,2:2,4000000
8475791,Taylor,Hall,1991-11-14,LW,L,2019-20,65,16,36,52,0.8,-14,232,6.9,34,74778.0,19:10,20,31,51,39.22,47,29,41,52,-11,4,14,18,13505.0,3:27,0,0,0,808.0,0:12,6000000
8475792,Brett,Connolly,1992-05-02,RW,R,2019-20,69,19,14,33,0.48,-3,117,16.24,26,60006.0,14:29,6,11,17,35.29,56,17,28,22,6,4,2,6,5406.0,1:18,0,0,0,37.0,0:0,3500000
8475793,Ryan,Johansen,1992-07-31,C,R,2019-20,68,14,22,36,0.53,-5,101,13.86,45,69585.0,17:3,549,483,1032,53.2,39,34,38,24,14,3,6,9,10970.0,2:41,1,0,1,3657.0,0:53,8000000
8475794,Tyler,Seguin,1992-01-31,C,R,2019-20,71,17,33,50,0.7,-6,250,6.8,24,81352.0,19:5,551,398,949,58.06,95,32,35,54,-19,3,12,15,10737.0,2:31,0,0,0,3166.0,0:44,9850000
8475795,Dylan,McIlrath,1992-04-20,D,R,2019-20,16,0,0,0,0.0,-4,14,0.0,23,14227.0,14:49,0,0,0,0.0,48,12,4,8,-4,0,0,0,0.0,0:0,0,0,0,2569.0,2:40,700000
8475796,Mark,Pysyk,1992-01-11,D,R,2019-20,58,9,9,18,0.31,4,64,14.06,20,44375.0,12:45,3,3,6,50.0,47,38,26,15,11,0,0,0,35.0,0:0,0,0,0,2125.0,0:36,2733333
8475797,Jarred,Tinordi,1992-02-20,D,L,2019-20,28,1,4,5,0.18,-1,20,5.0,34,27911.0,16:36,0,0,0,0.0,71,36,1,18,-17,0,0,0,15.0,0:0,0,1,1,2461.0,1:27,700000
8475798,Mikael,Granlund,1992-02-26,RW,L,2019-20,63,17,13,30,0.48,-4,130,13.08,28,67293.0,17:48,73,77,150,48.67,42,55,24,34,-10,4,2,6,9248.0,2:26,1,0,1,2951.0,0:46,5750000
8475799,Nino,Niederreiter,1992-09-08,RW,L,2019-20,67,11,18,29,0.43,-3,115,9.57,42,59567.0,14:49,1,3,4,25.0,52,19,35,42,-7,4,7,11,7543.0,1:52,0,0,0,121.0,0:1,5250000
8475807,Joakim,Nordstrom,1992-02-25,LW,L,2019-20,51,4,4,8,0.16,-6,51,7.84,17,36610.0,11:57,1,6,7,14.29,98,33,12,12,0,0,0,0,92.0,0:1,0,0,0,5700.0,1:51,1000000
8475808,Michael,Chaput,1992-04-09,C,L,2019-20,2,0,0,0,0.0,-2,2,0.0,2,1201.0,10:0,7,6,13,53.85,3,2,0,1,-1,0,0,0,0.0,0:0,0,0,0,87.0,0:43,675000
8475810,Bryan,Rust,1992-05-11,RW,R,2019-20,55,27,29,56,1.02,14,151,17.88,30,65225.0,19:45,2,8,10,20.0,71,35,29,37,-8,8,9,17,9237.0,2:47,1,1,2,5398.0,1:38,3500000
8475820,Joonas,Donskoi,1992-04-13,RW,R,2019-20,68,18,18,36,0.53,4,116,15.52,28,65614.0,16:4,10,14,24,41.67,26,39,28,21,7,4,2,6,8945.0,2:11,0,0,0,2319.0,0:34,3900000
8475825,Jani,Hakanpaa,1992-03-31,D,R,2019-20,5,1,0,1,0.2,1,4,25.0,2,5436.0,18:7,0,0,0,0.0,15,7,0,1,-1,0,0,0,112.0,0:22,0,0,0,393.0,1:18,850000
8475832,Tom,Kuhnhackl,1992-01-21,RW,L,2019-20,28,3,3,6,0.21,-4,28,10.71,2,18982.0,11:17,0,0,0,0.0,31,22,4,11,-7,0,0,0,43.0,0:1,0,1,1,2184.0,1:18,850000
8475834,Marcus,Sorensen,1992-04-07,LW,L,2019-20,66,7,11,18,0.27,-12,78,8.97,26,54824.0,13:50,3,17,20,15.0,56,18,28,18,10,0,0,0,855.0,0:12,1,0,1,5869.0,1:28,1500000
8475841,Tim,Heed,1991-01-27,D,R,2019-20,38,1,4,5,0.13,-10,44,2.27,2,29646.0,13:0,0,1,1,0.0,16,30,10,17,-7,0,1,1,1856.0,0:48,0,0,0,350.0,0:9,960000
8475842,Sam,Carrick,1992-02-04,C,R,2019-20,9,1,1,2,0.22,-3,16,6.25,0,7434.0,13:46,33,39,72,45.83,13,8,1,5,-4,0,0,0,693.0,1:17,1,0,1,219.0,0:24,700000
8475848,Brendan,Gallagher,1992-05-06,RW,R,2019-20,59,22,21,43,0.73,9,226,9.73,29,59863.0,16:54,12,17,29,41.38,53,29,39,18,21,1,4,5,7266.0,2:3,0,0,0,88.0,0:1,3750000
8475855,Jesper,Fast,1991-12-02,RW,R,2019-20,69,12,17,29,0.42,16,84,14.29,20,68753.0,16:36,9,17,26,34.62,125,53,24,32,-8,0,0,0,435.0,0:6,2,0,2,9755.0,2:21,1850000
8475857,Kevin,Gravel,1992-03-06,D,L,2019-20,3,0,0,0,0.0,0,2,0.0,0,1996.0,11:5,0,0,0,0.0,2,3,0,1,-1,0,0,0,0.0,0:0,0,0,0,133.0,0:44,700000
8475868,Anthony,Bitetto,1990-07-15,D,L,2019-20,51,0,8,8,0.16,3,54,0.0,32,46393.0,15:9,0,0,0,0.0,145,50,16,22,-6,0,0,0,173.0,0:3,0,1,1,6683.0,2:11,700000
8475869,Brandon,Davidson,1991-08-21,D,L,2019-20,12,0,0,0,0.0,-3,17,0.0,0,8982.0,12:28,0,0,0,0.0,24,20,3,9,-6,0,0,0,10.0,0:0,0,0,0,166.0,0:13,700000
8475902,Zach,Trotman,1990-08-26,D,R,2019-20,8,0,0,0,0.0,-1,11,0.0,4,7063.0,14:42,0,0,0,0.0,21,10,0,6,-6,0,0,0,350.0,0:43,0,0,0,183.0,0:22,700000
8475906,John,Klingberg,1992-08-14,D,R,2019-20,60,6,27,33,0.55,-12,124,4.84,24,80084.0,22:14,0,0,0,0.0,29,73,26,73,-47,2,15,17,9271.0,2:34,0,0,0,1127.0,0:18,4250000
8475907,Micheal,Ferland,1992-04-20,LW,L,2019-20,14,1,4,5,0.36,-3,15,6.67,7,8228.0,9:47,2,0,2,100.0,40,2,2,1,1,0,0,0,743.0,0:53,0,0,0,0.0,0:0,3500000
8475913,Mark,Stone,1992-05-13,RW,R,2019-20,68,23,45,68,1.0,16,174,13.22,27,79003.0,19:21,17,30,47,36.17,59,54,80,40,40,6,12,18,10481.0,2:34,0,1,1,7687.0,1:53,9500000
8475958,Michael,Sgarbossa,1992-07-25,C,L,2019-20,2,0,0,0,0.0,0,1,0.0,0,973.0,8:6,3,3,6,50.0,3,0,2,1,1,0,0,0,0.0,0:0,0,0,0,0.0,0:0,700000
8476043,Ben,Street,1987-02-13,C,L,2019-20,3,0,1,1,0.33,1,4,0.0,0,1463.0,8:7,5,6,11,45.45,3,0,0,0,0,0,0,0,0.0,0:0,0,0,0,0.0,0:0,750000
8476166,Taylor,Fedun,1988-06-04,D,R,2019-20,27,2,7,9,0.33,3,40,5.0,8,22278.0,13:45,0,0,0,0.0,16,19,2,12,-10,0,0,0,181.0,0:6,0,0,0,599.0,0:22,737500
8476195,Cory,Conacher,1989-12-14,C,L,2019-20,4,0,1,1,0.25,-2,5,0.0,4,2661.0,11:5,0,0,0,0.0,3,1,5,1,4,0,0,0,158.0,0:39,0,0,0,0.0,0:0,700000
8476207,Brian,Gibbons,1988-02-26,LW,L,2019-20,15,0,0,0,0.0,-7,9,0.0,4,8784.0,9:45,0,0,0,0.0,7,9,8,7,1,0,0,0,46.0,0:3,0,0,0,616.0,0:41,725000
8476278,Colin,Blackwell,1993-03-28,C,R,2019-20,27,3,7,10,0.37,7,31,9.68,10,17746.0,10:57,37,29,66,56.06,43,23,6,7,-1,0,0,0,143.0,0:5,0,0,0,1.0,0:0,675000
8476285,Matthew,Peca,1993-04-27,C,L,2019-20,14,0,2,2,0.14,-4,7,0.0,0,8772.0,10:26,43,36,79,54.43,15,4,0,1,-1,0,0,0,24.0,0:1,0,0,0,484.0,0:34,1300000
8476288,Ryan,Dzingel,1992-03-09,LW,L,2019-20,64,8,21,29,0.45,3,98,8.16,30,54353.0,14:9,9,20,29,31.03,36,25,15,19,-4,4,5,9,8437.0,2:11,0,0,0,124.0,0:1,3375000
8476292,Ondrej,Palat,1991-03-28,LW,L,2019-20,72,17,25,42,0.58,24,135,12.59,22,69929.0,16:11,8,15,23,34.78,148,64,44,37,7,4,4,8,5641.0,1:18,1,0,1,3459.0,0:48,5300000
8476293,Scott,Wilson,1992-04-24,C,L,2019-20,6,1,1,2,0.33,1,8,12.5,2,4187.0,11:37,0,0,0,0.0,3,0,5,0,5,0,0,0,9.0,0:1,0,0,0,0.0,0:0,1050000
8476312,Josh,Manson,1991-10-07,D,R,2019-20,50,1,8,9,0.18,-10,64,1.56,37,61893.0,20:37,0,0,0,0.0,113,65,21,41,-20,0,0,0,344.0,0:6,0,1,1,7512.0,2:30,4100000
8476326,Josh,Archibald,1992-10-06,RW,R,2019-20,62,12,9,21,0.34,-8,64,18.75,12,49221.0,13:13,0,2,2,0.0,165,44,24,11,13,0,0,0,204.0,0:3,2,1,3,8497.0,2:17,1000000
8476329,Travis,Boyd,1993-09-14,C,L,2019-20,26,4,7,11,0.42,10,28,14.29,2,18224.0,11:40,56,82,138,40.58,15,9,7,6,1,0,1,1,1315.0,0:50,0,0,0,436.0,0:16,800000
8476331,Dylan,DeMelo,1993-05-01,D,R,2019-20,59,0,10,10,0.17,4,74,0.0,37,71306.0,20:8,0,0,0,0.0,105,77,9,42,-33,0,0,0,2713.0,0:45,0,2,2,8074.0,2:16,900000
8476344,Tyler,Graovac,1993-04-27,C,L,2019-20,8,2,0,2,0.25,-2,5,40.0,2,3006.0,6:15,8,14,22,36.36,6,3,1,2,-1,2,0,2,361.0,0:45,0,0,0,0.0,0:0,700000
8476346,Johnny,Gaudreau,1993-08-13,LW,L,2019-20,70,18,40,58,0.83,-10,209,8.61,12,78834.0,18:46,1,3,4,25.0,1,11,40,71,-31,6,12,18,12170.0,2:53,0,0,0,54.0,0:0,6750000
8476356,Tobias,Rieder,1993-01-10,C,L,2019-20,55,4,6,10,0.18,-12,77,5.19,6,36612.0,11:5,11,42,53,20.75,30,26,17,8,9,0,0,0,95.0,0:1,1,1,2,5299.0,1:36,700000
8476368,Fredrik,Claesson,1992-11-24,D,L,2019-20,5,1,1,2,0.4,1,1,100.0,0,4346.0,14:29,0,0,0,0.0,5,7,1,1,0,0,0,0,0.0,0:0,0,0,0,244.0,0:48,700000
8476372,Nick,Seeler,1993-06-03,D,L,2019-20,12,0,1,1,0.08,-8,5,0.0,15,8588.0,11:55,0,0,0,0.0,19,21,1,7,-6,0,0,0,21.0,0:1,0,0,0,468.0,0:39,725000
8476374,Sean,Kuraly,1993-01-20,C,L,2019-20,72,6,18,24,0.33,-3,99,6.06,36,57155.0,13:13,270,283,553,48.82,151,33,29,27,2,0,1,1,113.0,0:1,0,1,1,6906.0,1:35,1275000
8476381,Andrew,Shaw,1991-07-20,RW,R,2019-20,26,3,7,10,0.38,-4,46,6.52,33,22554.0,14:27,42,51,93,45.16,74,9,12,15,-3,1,1,2,3506.0,2:14,0,0,0,233.0,0:8,3900000
8476389,Vincent,Trocheck,1993-07-11,C,R,2019-20,62,11,27,38,0.61,-8,141,7.8,49,62219.0,16:43,434,398,832,52.16,101,37,51,64,-13,1,6,7,7341.0,1:58,1,0,1,1929.0,0:31,4750000
8476391,TJ,Tynan,1992-02-25,C,R,2019-20,16,0,1,1,0.06,-1,7,0.0,2,8135.0,8:28,3,15,18,16.67,7,3,5,0,5,0,0,0,511.0,0:31,0,0,0,0.0,0:0,700000
8476392,Adam,Lowry,1993-03-29,C,L,2019-20,49,4,6,10,0.2,-4,68,5.88,23,43987.0,14:57,349,300,649,53.78,137,22,31,11,20,0,0,0,688.0,0:14,1,1,2,6519.0,2:13,2916667
8476393,Nick,Cousins,1993-07-20,C,L,2019-20,68,10,18,28,0.41,-1,118,8.47,35,54984.0,13:28,36,46,82,43.9,102,32,29,22,7,3,3,6,6647.0,1:37,0,0,0,57.0,0:0,1000000
8476396,Steven,Fogarty,1993-04-19,C,R,2019-20,7,0,0,0,0.0,-1,2,0.0,0,2474.0,5:53,6,3,9,66.67,4,4,2,2,0,0,0,0,0.0,0:0,0,0,0,73.0,0:10,700000
8476399,Blake,Coleman,1991-11-28,C,L,2019-20,69,21,11,32,0.46,-1,205,10.24,67,68677.0,16:35,47,102,149,31.54,205,46,48,21,27,1,2,3,1746.0,0:25,3,1,4,10709.0,2:35,1800000
8476400,Logan,Shaw,1992-10-05,RW,R,2019-20,35,3,2,5,0.14,0,20,15.0,0,14327.0,6:49,11,9,20,55.0,24,13,2,5,-3,0,1,1,160.0,0:4,0,0,0,185.0,0:5,700000
8476404,Andy,Andreoff,1991-05-17,LW,L,2019-20,14,0,1,1,0.07,-3,14,0.0,2,7168.0,8:32,4,4,8,50.0,20,4,1,0,1,0,0,0,7.0,0:0,0,0,0,0.0,0:0,750000
8476406,Nick,Shore,1992-09-26,C,R,2019-20,63,3,3,6,0.1,1,45,6.67,20,34697.0,9:10,210,170,380,55.26,55,20,14,16,-2,0,0,0,120.0,0:1,0,0,0,5289.0,1:23,750000
8476409,Alan,Quine,1993-02-25,C,L,2019-20,9,1,0,1,0.11,-1,12,8.33,4,5295.0,9:48,1,0,1,100.0,6,2,2,1,1,0,0,0,10.0,0:1,0,0,0,0.0,0:0,735000
8476410,Josh,Leivo,1993-05-26,LW,R,2019-20,36,7,12,19,0.53,1,69,10.14,4,32425.0,15:0,10,7,17,58.82,17,8,11,15,-4,0,4,4,4000.0,1:51,0,0,0,122.0,0:3,1500000
8476419,Jean-Gabriel,Pageau,1992-11-11,C,R,2019-20,67,26,16,42,0.63,4,151,17.22,49,77011.0,19:9,615,534,1149,53.52,128,53,33,32,1,5,5,10,7151.0,1:46,3,3,6,9076.0,2:15,3100000
8476422,Mike,Reilly,1993-07-13,D,L,2019-20,44,1,15,16,0.36,-6,85,1.18,24,47573.0,18:1,0,0,0,0.0,39,46,9,39,-30,1,8,9,4303.0,1:37,0,1,1,872.0,0:19,1500000
8476428,Rocco,Grimaldi,1993-02-08,C,R,2019-20,66,10,21,31,0.47,10,122,8.2,10,50093.0,12:38,1,5,6,16.67,23,14,27,20,7,0,0,0,523.0,0:7,0,0,0,65.0,0:0,1000000
8476429,Scott,Mayfield,1992-10-14,D,R,2019-20,67,5,8,13,0.19,8,98,5.1,53,80166.0,19:56,0,0,0,0.0,93,117,21,70,-49,0,0,0,219.0,0:3,0,2,2,10041.0,2:29,1450000
8476430,Tomas,Jurco,1992-12-28,LW,L,2019-20,12,0,2,2,0.17,1,7,0.0,4,7183.0,9:58,2,2,4,50.0,4,3,6,2,4,0,0,0,178.0,0:14,0,0,0,0.0,0:0,750000
8476432,Boone,Jenner,1993-06-15,C,L,2019-20,70,11,13,24,0.34,-14,179,6.15,36,76089.0,18:6,643,523,1166,55.15,109,80,24,28,-4,2,2,4,7465.0,1:46,0,1,1,7550.0,1:47,3750000
8476437,Victor,Rask,1993-03-01,C,L,2019-20,43,5,8,13,0.3,7,38,13.16,6,27044.0,10:28,120,152,272,44.12,26,8,13,5,8,0,0,0,632.0,0:14,0,0,0,81.0,0:1,4000000
8476438,Brandon,Saad,1992-10-27,LW,L,2019-20,58,21,12,33,0.57,2,140,15.0,16,58281.0,16:44,23,35,58,39.66,36,19,40,25,15,1,0,1,4295.0,1:14,2,0,2,6095.0,1:45,6000000
8476439,Brett,Ritchie,1993-07-01,RW,R,2019-20,27,2,4,6,0.22,-3,34,5.88,21,16854.0,10:24,2,3,5,40.0,89,3,3,4,-1,0,1,1,834.0,0:30,0,0,0,4.0,0:0,1000000
8476440,Markus,Granlund,1993-04-16,C,L,2019-20,34,3,1,4,0.12,-1,26,11.54,14,22092.0,10:49,25,32,57,43.86,15,18,11,7,4,0,0,0,121.0,0:3,0,0,0,2386.0,1:10,1300000
8476441,Joel,Edmundson,1993-06-28,D,L,2019-20,68,7,13,20,0.29,7,97,7.22,72,75273.0,18:26,0,0,0,0.0,118,91,23,45,-22,0,0,0,73.0,0:1,0,0,0,11452.0,2:48,3100000
8476442,Matt,Nieto,1992-11-05,LW,L,2019-20,72,8,13,21,0.29,6,86,9.3,8,58333.0,13:30,2,3,5,40.0,41,23,19,17,2,0,0,0,139.0,0:1,2,0,2,10164.0,2:21,1975000
8476443,Xavier,Ouellet,1993-07-29,D,L,2019-20,12,0,2,2,0.17,0,8,0.0,4,10006.0,13:53,0,0,0,0.0,24,15,1,4,-3,0,0,0,0.0,0:0,0,0,0,681.0,0:56,700000
8476447,Miikka,Salomaki,1993-03-09,RW,L,2019-20,5,1,0,1,0.2,2,2,50.0,4,3644.0,12:8,0,0,0,0.0,9,3,1,3,-2,0,0,0,89.0,0:17,0,0,0,64.0,0:12,750000
8476448,William,Karlsson,1993-01-08,C,L,2019-20,66,16,33,49,0.74,14,146,10.96,16,74851.0,18:54,506,480,986,51.32,44,39,56,38,18,2,7,9,8078.0,2:2,2,3,5,7610.0,1:55,5900000
8476449,Scott,Harrington,1993-03-10,D,L,2019-20,39,1,7,8,0.21,-3,37,2.7,16,32633.0,13:56,0,0,0,0.0,46,48,5,9,-4,0,0,0,73.0,0:1,0,0,0,1423.0,0:36,1633333
8476453,Nikita,Kucherov,1993-06-17,RW,L,2019-20,71,34,53,87,1.23,24,220,15.45,42,80468.0,18:53,0,1,1,0.0,39,20,33,62,-29,4,21,25,14742.0,3:27,0,0,0,22.0,0:0,9500000
8476454,Ryan,Nugent-Hopkins,1993-04-12,C,L,2019-20,65,22,39,61,0.94,1,172,12.79,33,79820.0,20:28,205,199,404,50.74,33,44,54,39,15,7,17,24,14609.0,3:44,0,0,0,6671.0,1:42,6000000
8476455,Gabriel,Landeskog,1992-11-23,LW,L,2019-20,57,21,25,46,0.81,-1,153,13.73,53,68781.0,20:6,279,218,497,56.14,91,35,39,26,13,6,11,17,13458.0,3:56,0,0,0,164.0,0:2,5571429
8476456,Jonathan,Huberdeau,1993-06-04,LW,L,2019-20,69,23,55,78,1.13,5,152,15.13,30,77713.0,18:46,24,37,61,39.34,51,26,42,70,-28,5,24,29,14786.0,3:34,0,0,0,98.0,0:1,5900000
8476457,Adam,Larsson,1992-11-12,D,R,2019-20,49,1,5,6,0.12,0,61,1.64,35,58304.0,19:49,0,0,0,0.0,112,82,16,35,-19,0,0,0,61.0,0:1,0,0,0,4738.0,1:36,4166666
8476458,Ryan,Strome,1993-07-11,C,R,2019-20,70,18,41,59,0.84,21,154,11.69,48,82262.0,19:35,496,548,1044,47.51,45,32,27,54,-27,3,14,17,12397.0,2:57,0,1,1,9411.0,2:14,3100000
8476459,Mika,Zibanejad,1993-04-18,C,R,2019-20,57,41,34,75,1.32,9,208,19.71,14,73970.0,21:37,592,612,1204,49.17,51,49,42,43,-1,15,12,27,12551.0,3:40,3,2,5,8968.0,2:37,5350000
8476460,Mark,Scheifele,1993-03-15,C,R,2019-20,71,29,44,73,1.03,2,170,17.06,45,92887.0,21:48,604,685,1289,46.86,34,49,57,46,11,10,10,20,14088.0,3:18,0,0,0,1053.0,0:14,6125000
8476461,Sean,Couturier,1992-12-07,C,L,2019-20,72,22,39,61,0.85,24,190,11.58,32,85525.0,19:47,559,387,946,59.09,68,27,41,36,5,4,9,13,12094.0,2:47,0,0,0,8820.0,2:2,4333333
8476462,Dougie,Hamilton,1993-06-17,D,R,2019-20,47,14,26,40,0.85,30,170,8.24,32,65661.0,23:17,0,0,0,0.0,52,63,22,40,-18,2,10,12,8919.0,3:9,0,1,1,6562.0,2:19,5750000
8476463,Jonas,Brodin,1993-07-12,D,L,2019-20,69,2,26,28,0.41,15,103,1.94,24,89223.0,21:33,0,0,0,0.0,41,112,14,16,-2,0,1,1,1602.0,0:23,0,2,2,8478.0,2:2,4166667
8476466,Sven,Baertschi,1992-10-05,LW,L,2019-20,6,0,2,2,0.33,-2,7,0.0,4,4256.0,11:49,0,0,0,0.0,5,0,1,1,0,0,2,2,573.0,1:35,0,0,0,0.0,0:0,3366666
8476467,Jamie,Oleksiak,1992-12-21,D,L,2019-20,72,4,7,11,0.15,-5,81,4.94,41,68951.0,15:57,0,0,0,0.0,161,63,24,50,-26,0,0,0,135.0,0:1,0,0,0,2764.0,0:38,2137500
8476468,J.T.,Miller,1993-03-14,C,L,2019-20,69,27,45,72,1.04,11,165,16.36,47,83226.0,20:6,425,293,718,59.19,123,38,52,36,16,9,16,25,16020.0,3:52,0,2,2,2513.0,0:36,5250000
8476469,Joel,Armia,1993-05-31,RW,R,2019-20,58,16,14,30,0.52,2,155,10.32,28,59947.0,17:13,4,7,11,36.36,146,25,47,27,20,3,1,4,7019.0,2:1,3,1,4,5616.0,1:36,2600000
8476470,Nathan,Beaulieu,1992-12-05,D,L,2019-20,38,1,7,8,0.21,15,38,2.63,29,38751.0,16:59,0,0,0,0.0,62,47,6,23,-17,0,0,0,85.0,0:2,0,0,0,5254.0,2:18,1000000
8476472,Oscar,Klefbom,1993-07-20,D,L,2019-20,62,5,29,34,0.55,-17,159,3.14,24,94530.0,25:24,0,0,0,0.0,45,180,36,58,-22,2,16,18,13508.0,3:37,0,0,0,9256.0,2:29,4167000
8476473,Connor,Murphy,1993-03-26,D,R,2019-20,58,5,14,19,0.33,2,117,4.27,27,73952.0,21:15,0,0,0,0.0,128,138,17,44,-27,0,0,0,241.0,0:4,0,1,1,9582.0,2:45,3850000
8476474,Stefan,Noesen,1993-02-12,RW,R,2019-20,40,7,2,9,0.22,-1,67,10.45,32,27676.0,11:31,7,11,18,38.89,74,17,16,8,8,1,0,1,1662.0,0:41,0,0,0,22.0,0:0,700000
8476479,Phillip,Danault,1993-02-24,C,L,2019-20,71,13,34,47,0.66,18,131,9.92,32,80276.0,18:50,728,608,1336,54.49,119,37,34,50,-16,1,3,4,6663.0,1:33,0,0,0,10692.0,2:30,3083333
8476480,Vladislav,Namestnikov,1992-11-22,C,L,2019-20,68,18,14,32,0.47,-4,103,17.48,45,61028.0,14:57,22,25,47,46.81,115,49,25,28,-3,2,2,4,6243.0,1:31,4,2,6,7016.0,1:43,4000000
8476483,Rickard,Rakell,1993-05-05,C,R,2019-20,65,15,27,42,0.65,-5,186,8.06,12,70838.0,18:9,10,3,13,76.92,81,29,30,42,-12,3,6,9,9212.0,2:21,0,3,3,2546.0,0:39,3789444
8476525,Colin,Miller,1992-10-29,D,R,2019-20,51,1,10,11,0.22,-9,79,1.27,22,52430.0,17:8,0,0,0,0.0,87,40,9,29,-20,0,3,3,4171.0,1:21,0,0,0,927.0,0:18,3875000
8476539,Jonathan,Marchessault,1990-12-27,C,R,2019-20,69,24,25,49,0.71,9,242,9.92,32,71504.0,17:16,59,79,138,42.75,106,13,39,49,-10,7,6,13,9485.0,2:17,0,0,0,48.0,0:0,5000000
8476624,Barclay,Goodrow,1993-02-26,RW,L,2019-20,73,8,18,26,0.36,-8,106,7.55,99,69282.0,15:49,394,412,806,48.88,172,66,44,24,20,0,2,2,2790.0,0:38,0,1,1,10529.0,2:24,925000
8476779,Brad,Hunt,1988-08-24,D,L,2019-20,59,8,11,19,0.32,-7,106,7.55,6,53586.0,15:8,0,0,0,0.0,12,39,15,14,1,3,7,10,7996.0,2:15,0,0,0,200.0,0:3,700000
8476792,Torey,Krug,1991-04-12,D,L,2019-20,64,9,41,50,0.78,-6,149,6.04,40,79009.0,20:34,0,0,0,0.0,37,49,23,50,-27,2,26,28,14948.0,3:53,0,0,0,357.0,0:5,5250000
8476807,Matt,Tennyson,1990-04-23,D,R,2019-20,20,0,3,3,0.15,-2,14,0.0,6,14576.0,12:8,0,0,0,0.0,27,18,2,8,-6,0,0,0,8.0,0:0,0,0,0,59.0,0:2,700000
8476822,Luke,Glendening,1989-04-28,RW,R,2019-20,60,6,3,9,0.15,-29,76,7.89,14,55276.0,15:21,393,307,700,56.14,147,68,10,18,-8,0,0,0,417.0,0:6,1,0,1,10366.0,2:52,1800000
8476826,Yanni,Gourde,1991-12-15,C,L,2019-20,73,10,21,31,0.42,-5,112,8.93,56,61600.0,14:3,105,95,200,52.5,85,21,53,15,38,1,5,6,3129.0,0:42,2,1,3,6347.0,1:26,5166666
8476850,Ryan,Murray,1993-09-27,D,L,2019-20,27,2,7,9,0.33,-9,32,6.25,4,32328.0,19:57,0,0,0,0.0,12,50,6,15,-9,0,2,2,1395.0,0:51,0,0,0,3308.0,2:2,4600000
8476851,Alex,Galchenyuk,1994-02-12,LW,L,2019-20,59,8,16,24,0.41,-5,86,9.3,16,43545.0,12:18,67,64,131,51.15,52,17,5,20,-15,2,5,7,5872.0,1:39,0,0,0,39.0,0:0,4900000
8476853,Morgan,Rielly,1994-03-09,D,L,2019-20,47,3,24,27,0.57,6,123,2.44,24,68246.0,24:12,0,1,1,0.0,38,67,17,42,-25,0,7,7,6598.0,2:20,0,0,0,5595.0,1:59,5000000
8476854,Hampus,Lindholm,1994-01-20,D,L,2019-20,55,2,20,22,0.4,-10,109,1.83,34,76123.0,23:4,0,0,0,0.0,34,71,20,53,-33,1,7,8,6008.0,1:49,0,2,2,8763.0,2:39,5205556
8476856,Matt,Dumba,1994-07-25,D,R,2019-20,69,6,18,24,0.35,-7,167,3.59,41,93149.0,22:29,0,0,0,0.0,98,88,20,35,-15,1,7,8,10997.0,2:39,0,1,1,4586.0,1:6,6000000
8476857,Pontus,Aberg,1993-09-23,LW,R,2019-20,5,0,1,1,0.2,0,4,0.0,0,2611.0,8:42,0,0,0,0.0,1,1,1,2,-1,0,0,0,0.0,0:0,0,0,0,0.0,0:0,700000
8476858,Phillip,Di Giuseppe,1993-10-09,LW,L,2019-20,20,1,3,4,0.2,1,35,2.86,2,13546.0,11:17,0,2,2,0.0,38,20,3,4,-1,0,0,0,20.0,0:1,0,0,0,87.0,0:4,700000
8476869,Brady,Skjei,1994-03-26,D,L,2019-20,67,8,16,24,0.36,-10,139,5.76,45,83177.0,20:41,0,0,0,0.0,103,96,36,55,-19,0,0,0,470.0,0:7,0,2,2,10264.0,2:33,5250000
8476870,Stefan,Matteau,1994-02-23,C,L,2019-20,9,2,1,3,0.33,0,18,11.11,5,6675.0,12:21,0,0,0,0.0,27,10,2,1,1,0,0,0,14.0,0:1,0,0,0,160.0,0:17,725000
8476871,Tanner,Pearson,1992-08-10,LW,L,2019-20,69,21,24,45,0.65,-4,164,12.8,27,68360.0,16:30,3,14,17,17.65,96,40,37,33,4,3,7,10,6587.0,1:35,2,1,3,4390.0,1:3,3750000
8476872,Scott,Laughton,1994-05-30,C,L,2019-20,52,16,16,32,0.62,17,79,20.25,38,45484.0,14:34,148,128,276,53.62,114,28,23,21,2,0,0,0,354.0,0:6,0,0,0,5286.0,1:41,2300000
8476873,Mark,Jankowski,1994-09-13,C,L,2019-20,56,5,2,7,0.12,-12,38,13.16,14,37289.0,11:5,190,235,425,44.71,14,33,32,20,12,0,0,0,416.0,0:7,0,0,0,6852.0,2:2,1675000
8476874,Olli,Maatta,1994-08-22,D,L,2019-20,65,4,13,17,0.26,0,80,5.0,20,71838.0,18:25,0,0,0,0.0,119,110,22,57,-35,0,0,0,945.0,0:14,0,2,2,7377.0,1:53,4083333
8476875,Mike,Matheson,1994-02-27,D,L,2019-20,59,8,12,20,0.34,-1,104,7.69,14,63846.0,18:2,0,0,0,0.0,44,53,41,54,-13,1,1,2,744.0,0:12,0,0,0,4300.0,1:12,4875000
8476878,Zemgus,Girgensons,1994-01-05,C,L,2019-20,69,12,7,19,0.28,-1,85,14.12,10,57106.0,13:47,30,43,73,41.1,110,20,13,11,2,0,0,0,171.0,0:2,1,0,1,8837.0,2:8,1600000
8476879,Cody,Ceci,1993-12-21,D,R,2019-20,56,1,7,8,0.14,7,48,2.08,20,69018.0,20:32,0,0,0,0.0,92,79,13,30,-17,0,0,0,250.0,0:4,0,0,0,9541.0,2:50,4500000
8476880,Tom,Wilson,1994-03-29,RW,R,2019-20,71,22,23,45,0.63,-4,158,13.92,99,77643.0,18:13,19,42,61,31.15,267,63,26,41,-15,5,2,7,7872.0,1:50,1,1,2,8538.0,2:0,5166666
8476881,Tomas,Hertl,1993-11-12,C,L,2019-20,48,16,20,36,0.75,-18,117,13.68,16,53122.0,18:26,433,357,790,54.81,29,25,25,18,7,2,5,7,7441.0,2:35,2,0,2,4174.0,1:26,5625000
8476882,Teuvo,Teravainen,1994-09-11,LW,L,2019-20,68,15,48,63,0.93,20,182,8.24,8,78308.0,19:11,26,27,53,49.06,18,30,44,44,0,4,17,21,12268.0,3:0,1,3,4,7237.0,1:46,5400000
8476884,Derrick,Pouliot,1994-01-16,D,L,2019-20,2,0,0,0,0.0,-1,1,0.0,2,1000.0,8:20,0,0,0,0.0,2,1,0,1,-1,0,0,0,0.0,0:0,0,0,0,0.0,0:0,700000
8476885,Jacob,Trouba,1994-02-26,D,R,2019-20,70,7,20,27,0.39,-12,168,4.17,61,94770.0,22:33,0,0,0,0.0,173,128,43,69,-26,4,4,8,7501.0,1:47,0,2,2,10509.0,2:30,8000000
8476886,Slater,Koekkoek,1994-02-18,D,L,2019-20,42,1,9,10,0.24,3,47,2.13,42,42230.0,16:45,0,0,0,0.0,64,58,9,27,-18,0,0,0,75.0,0:1,0,0,0,3344.0,1:19,925000
8476887,Filip,Forsberg,1994-08-13,LW,R,2019-20,63,21,27,48,0.76,-7,198,10.61,29,65585.0,17:21,1,2,3,33.33,82,27,58,45,13,7,7,14,10825.0,2:51,0,0,0,1484.0,0:23,6000000
8476889,Radek,Faksa,1994-01-09,C,L,2019-20,69,11,9,20,0.29,-7,112,9.82,42,65464.0,15:48,424,431,855,49.59,86,44,34,29,5,3,0,3,6144.0,1:29,0,0,0,6062.0,1:27,2200000
8476891,Matt,Grzelcyk,1994-01-05,D,L,2019-20,70,4,17,21,0.3,14,112,3.57,34,75877.0,18:3,0,0,0,0.0,59,69,22,41,-19,1,6,7,6609.0,1:34,0,1,1,4180.0,0:59,1400000
8476892,Colton,Parayko,1993-05-12,D,R,2019-20,67,12,18,30,0.45,7,173,6.94,16,92632.0,23:2,0,0,0,0.0,94,117,36,43,-7,3,2,5,3444.0,0:51,0,1,1,7900.0,1:57,5500000
8476894,Brendan,Leipsic,1994-05-19,LW,L,2019-20,61,3,8,11,0.18,3,49,6.12,13,33527.0,9:9,9,12,21,42.86,57,20,8,24,-16,0,1,1,1634.0,0:26,0,0,0,0.0,0:0,700000
8476897,Oskar,Sundqvist,1994-03-23,C,R,2019-20,60,12,11,23,0.38,4,101,11.88,28,51690.0,14:21,117,139,256,45.7,63,30,37,12,25,0,0,0,667.0,0:11,1,1,2,6238.0,1:43,2750000
8476902,Esa,Lindell,1994-05-23,D,L,2019-20,72,3,20,23,0.32,0,106,2.83,14,101308.0,23:27,0,0,0,0.0,95,134,32,66,-34,1,6,7,4905.0,1:8,0,3,3,16452.0,3:48,5800000
8476905,Chandler,Stephenson,1994-04-22,C,L,2019-20,68,12,15,27,0.4,25,78,15.38,16,58958.0,14:27,238,288,526,45.25,56,35,38,22,16,1,1,2,2616.0,0:38,2,1,3,5145.0,1:15,1050000
8476906,Shayne,Gostisbehere,1993-04-20,D,L,2019-20,43,5,9,14,0.33,-2,75,6.67,20,47022.0,18:13,0,0,0,0.0,14,39,9,28,-19,1,4,5,6754.0,2:37,0,0,0,185.0,0:4,4500000
8476907,Mackenzie,MacEachern,1994-03-09,LW,L,2019-20,52,7,3,10,0.19,1,64,10.94,33,27879.0,8:56,1,3,4,25.0,85,13,14,11,3,0,0,0,93.0,0:1,0,0,0,151.0,0:2,750000
8476913,Devin,Shore,1994-07-19,C,L,2019-20,45,5,7,12,0.27,-10,50,10.0,8,31444.0,11:38,47,53,100,47.0,52,14,12,8,4,0,2,2,1257.0,0:27,0,0,0,528.0,0:11,2300000
8476915,Jujhar,Khaira,1994-08-13,LW,L,2019-20,64,6,4,10,0.16,-19,69,8.7,38,48127.0,12:31,34,32,66,51.52,136,30,15,36,-21,0,0,0,414.0,0:6,0,0,0,6087.0,1:35,1200000
8476917,Adam,Pelech,1994-08-16,D,L,2019-20,38,1,8,9,0.24,4,49,2.04,20,48181.0,21:7,0,0,0,0.0,81,83,32,48,-16,0,0,0,135.0,0:3,0,2,2,6345.0,2:46,1600000
8476918,Jimmy,Vesey,1993-05-26,LW,L,2019-20,64,9,11,20,0.31,12,93,9.68,15,53005.0,13:48,0,5,5,0.0,43,20,26,16,10,0,1,1,1443.0,0:22,1,0,1,3666.0,0:57,2275000
8476919,Chris,Tierney,1994-07-01,C,L,2019-20,71,11,26,37,0.52,-6,102,10.78,20,73229.0,17:11,521,497,1018,51.18,44,37,32,42,-10,1,1,2,4014.0,0:56,4,1,5,9898.0,2:19,2937500
8476921,Jordan,Martinook,1992-07-25,LW,L,2019-20,45,2,11,13,0.29,-2,44,4.55,22,30401.0,11:15,66,62,128,51.56,72,23,24,19,5,0,0,0,45.0,0:1,0,2,2,3464.0,1:16,2000000
8476922,Boo,Nieves,1994-01-23,C,L,2019-20,4,0,0,0,0.0,2,2,0.0,4,1807.0,7:31,14,5,19,73.68,3,2,1,0,1,0,0,0,0.0,0:0,0,0,0,153.0,0:38,-111
8476923,Damon,Severson,1994-08-07,D,R,2019-20,69,8,23,31,0.45,-20,114,7.02,52,95066.0,22:57,0,0,0,0.0,81,97,35,73,-38,3,7,10,8242.0,1:59,0,0,0,10154.0,2:27,4166666
8476924,Martin,Frk,1993-10-05,RW,R,2019-20,17,6,2,8,0.47,-1,26,23.08,4,14115.0,13:50,0,0,0,0.0,14,3,2,10,-8,1,0,1,1508.0,1:28,0,0,0,1.0,0:0,700000
8476925,Colton,Sissons,1993-11-05,C,R,2019-20,57,9,6,15,0.26,-2,52,17.31,20,49012.0,14:19,283,269,552,51.27,84,41,14,25,-11,0,0,0,731.0,0:12,1,0,1,8043.0,2:21,2857143
8476927,Teddy,Blueger,1994-08-15,C,L,2019-20,69,9,13,22,0.32,2,102,8.82,25,65460.0,15:48,402,488,890,45.17,83,35,29,22,7,0,0,0,466.0,0:6,0,2,2,9866.0,2:22,750000
8476931,Jake,McCabe,1993-10-12,D,L,2019-20,66,3,10,13,0.2,-11,75,4.0,41,73374.0,18:31,0,0,0,0.0,91,90,19,21,-2,0,0,0,182.0,0:2,1,0,1,9023.0,2:16,2850000
8476934,Brock,McGinn,1994-02-02,LW,L,2019-20,68,7,10,17,0.25,-4,93,7.53,17,53864.0,13:12,15,24,39,38.46,80,28,19,10,9,0,0,0,181.0,0:2,2,0,2,9881.0,2:25,2100000
8476941,Connor,Carrick,1994-04-13,D,R,2019-20,29,1,5,6,0.21,-6,25,4.0,17,25073.0,14:24,0,0,0,0.0,27,39,5,12,-7,0,0,0,149.0,0:5,0,0,0,803.0,0:27,1500000
8476947,Nikolai,Prokhorkin,1993-09-17,LW,L,2019-20,43,4,10,14,0.33,-6,63,6.35,6,31232.0,12:6,101,111,212,47.64,38,7,19,14,5,0,3,3,1521.0,0:35,0,0,0,14.0,0:0,925000
8476948,Charles,Hudon,1994-06-23,LW,L,2019-20,15,1,1,2,0.13,-9,22,4.55,0,10387.0,11:32,1,3,4,25.0,25,2,5,2,3,0,0,0,953.0,1:3,0,0,0,0.0,0:0,800000
8476952,Dominic,Toninato,1994-03-09,C,L,2019-20,46,4,7,11,0.24,4,38,10.53,37,30752.0,11:8,128,144,272,47.06,57,28,17,13,4,0,0,0,290.0,0:6,0,0,0,1201.0,0:26,775000
8476953,Trevor,Carrick,1994-07-04,D,L,2019-20,3,0,0,0,0.0,0,1,0.0,5,1042.0,5:47,0,0,0,0.0,1,0,0,2,-2,0,0,0,91.0,0:30,0,0,0,0.0,0:0,700000
8476958,Jaccob,Slavin,1994-05-01,D,L,2019-20,68,6,30,36,0.53,30,145,4.14,10,95495.0,23:24,0,0,0,0.0,43,107,81,49,32,0,3,3,3732.0,0:54,0,1,1,12655.0,3:6,5300000
8476960,Andreas,Athanasiou,1994-08-06,LW,L,2019-20,55,11,15,26,0.47,-46,129,8.53,30,52287.0,15:50,43,60,103,41.75,36,24,15,31,-16,3,4,7,6675.0,2:1,0,0,0,143.0,0:2,3000000
8476966,Gemel,Smith,1994-04-16,C,L,2019-20,3,1,0,1,0.33,0,1,100.0,4,1651.0,9:10,13,7,20,65.0,1,2,1,0,1,0,0,0,10.0,0:3,0,0,0,112.0,0:37,700000
8476967,Brett,Kulak,1994-01-06,D,L,2019-20,56,0,7,7,0.12,-1,101,0.0,12,57589.0,17:8,0,0,0,0.0,59,50,13,36,-23,0,0,0,186.0,0:3,0,0,0,722.0,0:12,1850000
8476974,Thomas,Di Pauli,1994-04-29,C,L,2019-20,2,0,0,0,0.0,-3,2,0.0,10,718.0,5:59,0,0,0,0.0,4,1,0,0,0,0,0,0,0.0,0:0,0,0,0,0.0,0:0,-111
8476975,Cedric,Paquette,1993-08-13,C,L,2019-20,64,7,11,18,0.28,-1,82,8.54,42,50080.0,13:2,325,310,635,51.18,190,50,17,9,8,0,0,0,255.0,0:3,1,1,2,7057.0,1:50,1650000
8476979,Erik,Gustafsson,1992-03-14,D,L,2019-20,66,6,23,29,0.44,-9,103,5.83,27,80710.0,20:22,0,0,0,0.0,86,58,21,58,-37,2,7,9,10668.0,2:41,0,0,0,697.0,0:10,1200000
8476981,Josh,Anderson,1994-05-07,RW,R,2019-20,26,1,3,4,0.15,-8,63,1.59,17,25052.0,16:3,7,12,19,36.84,68,13,9,12,-3,0,0,0,2714.0,1:44,0,0,0,2537.0,1:37,1850000
8476983,Paul,LaDue,1992-09-06,D,R,2019-20,2,0,1,1,0.5,0,2,0.0,0,1536.0,12:48,0,0,0,0.0,2,3,1,1,0,0,0,0,0.0,0:0,0,0,0,30.0,0:15,825000
8476987,Jake,Bischoff,1994-07-25,D,L,2019-20,4,0,0,0,0.0,-2,6,0.0,4,3744.0,15:36,0,0,0,0.0,8,8,0,2,-2,0,0,0,32.0,0:8,0,0,0,141.0,0:35,716667
8476988,Matt,Benning,1994-05-25,D,R,2019-20,43,1,7,8,0.19,8,38,2.63,15,34126.0,13:13,0,0,0,0.0,78,34,12,19,-7,0,0,0,10.0,0:0,0,0,0,1645.0,0:38,1900000
8476994,Vinnie,Hinostroza,1994-04-03,LW,R,2019-20,68,5,17,22,0.32,1,132,3.79,14,53474.0,13:6,26,35,61,42.62,51,26,30,20,10,0,1,1,284.0,0:4,0,1,1,3217.0,0:47,1500000
8477003,Riley,Barber,1994-02-07,RW,R,2019-20,9,0,0,0,0.0,-1,6,0.0,2,4459.0,8:15,1,0,1,100.0,15,1,0,2,-2,0,0,0,0.0,0:0,0,0,0,0.0,0:0,700000
8477010,Joseph,Blandisi,1994-07-18,LW,L,2019-20,21,2,3,5,0.24,-3,12,16.67,10,10346.0,8:12,33,48,81,40.74,26,9,8,1,7,0,0,0,24.0,0:1,0,0,0,64.0,0:3,700000
8477015,Connor,Brown,1994-01-14,RW,R,2019-20,71,16,27,43,0.61,-6,173,9.25,24,85689.0,20:6,29,39,68,42.65,39,35,52,40,12,3,1,4,7104.0,1:40,0,2,2,11107.0,2:36,2100000
8477018,Ben,Hutton,1993-04-20,D,L,2019-20,65,4,12,16,0.25,5,114,3.51,14,71254.0,18:16,0,0,0,0.0,51,76,12,41,-29,0,0,0,497.0,0:7,0,0,0,5511.0,1:24,1500000
8477021,Alexander,Kerfoot,1994-08-11,C,L,2019-20,65,9,19,28,0.43,-2,88,10.23,32,57600.0,14:46,191,216,407,46.93,48,41,28,33,-5,1,2,3,4893.0,1:15,0,0,0,1055.0,0:16,3500000
8477038,Nikita,Gusev,1992-07-08,LW,R,2019-20,66,13,31,44,0.67,-15,158,8.23,12,58185.0,14:41,1,2,3,33.33,12,7,22,40,-18,5,10,15,9850.0,2:29,0,0,0,10.0,0:0,4500000
8477043,Christian,Djoos,1994-08-06,D,L,2019-20,11,1,2,3,0.27,3,13,7.69,0,12609.0,19:6,0,0,0,0.0,2,12,2,6,-4,0,1,1,1439.0,2:10,0,0,0,811.0,1:13,1250000
8477046,Joakim,Ryan,1993-06-17,D,L,2019-20,35,1,4,5,0.14,-10,54,1.85,10,40166.0,19:7,0,0,0,0.0,24,46,6,28,-22,0,0,0,122.0,0:3,0,0,0,3474.0,1:39,725000
8477073,Kurtis,MacDermid,1994-03-25,D,L,2019-20,45,3,5,8,0.18,-9,51,5.88,47,36990.0,13:42,0,0,0,0.0,95,43,5,26,-21,0,0,0,11.0,0:0,0,1,1,3085.0,1:8,675000
8477085,Ashton,Sautner,1994-05-27,D,L,2019-20,1,0,0,0,0.0,0,1,0.0,0,169.0,2:49,0,0,0,0.0,0,0,0,0,0,0,0,0,0.0,0:0,0,0,0,0.0,0:0,675000
8477126,Jayson,Megna,1990-02-01,C,R,2019-20,8,0,0,0,0.0,-1,4,0.0,2,3222.0,6:42,0,1,1,0.0,10,5,0,1,-1,0,0,0,4.0,0:0,0,0,0,0.0,0:0,700000
8477149,Scott,Sabourin,1992-07-30,RW,R,2019-20,35,2,4,6,0.17,-6,29,6.9,33,14730.0,7:0,0,1,1,0.0,74,13,5,6,-1,0,0,0,5.0,0:0,0,0,0,0.0,0:0,700000
8477210,Buddy,Robinson,1991-09-30,RW,R,2019-20,5,1,0,1,0.2,0,6,16.67,7,3671.0,12:14,0,0,0,0.0,14,5,2,1,1,0,0,0,0.0,0:0,0,0,0,155.0,0:31,700000
8477213,Tim,Schaller,1990-11-16,C,L,2019-20,53,5,1,6,0.11,-14,49,10.2,14,36771.0,11:33,7,11,18,38.89,51,28,14,9,5,0,0,0,124.0,0:2,1,0,1,8584.0,2:41,1900000
8477215,Danny,DeKeyser,1990-03-07,D,L,2019-20,8,0,4,4,0.5,0,12,0.0,4,10589.0,22:3,0,0,0,0.0,6,18,0,8,-8,0,0,0,6.0,0:0,0,0,0,1686.0,3:30,5000000
8477220,Nate,Schmidt,1991-07-16,D,L,2019-20,62,8,26,34,0.55,12,122,6.56,16,81219.0,21:49,0,0,0,0.0,27,93,35,41,-6,1,6,7,4199.0,1:7,0,0,0,5925.0,1:35,5950000
8477240,Carter,Rowney,1989-05-10,RW,R,2019-20,71,8,11,19,0.27,5,63,12.7,14,54630.0,12:49,47,56,103,45.63,189,42,24,26,-2,0,0,0,374.0,0:5,2,2,4,10093.0,2:22,1133333
8477244,Chad,Ruhwedel,1990-05-07,D,R,2019-20,41,2,4,6,0.15,4,44,4.55,12,36332.0,14:46,0,0,0,0.0,74,25,7,17,-10,0,0,0,74.0,0:1,0,0,0,3142.0,1:16,700000
8477290,Michael,Raffl,1988-12-01,LW,L,2019-20,59,9,13,22,0.37,0,68,13.24,16,43673.0,12:20,100,99,199,50.25,74,25,19,23,-4,0,1,1,167.0,0:2,1,0,1,4430.0,1:15,1600000
8477320,Anton,Blidh,1995-03-14,LW,L,2019-20,7,0,0,0,0.0,-1,9,0.0,0,4837.0,11:31,0,1,1,0.0,20,5,2,1,1,0,0,0,0.0,0:0,0,0,0,586.0,1:23,700000
8477330,Dominik,Kubalik,1995-08-21,LW,L,2019-20,68,30,16,46,0.68,2,157,19.11,16,58648.0,14:22,6,13,19,31.58,79,17,23,25,-2,4,4,8,7953.0,1:56,0,0,0,101.0,0:1,925000
8477337,John,Gilmour,1993-05-17,D,L,2019-20,4,0,0,0,0.0,-2,5,0.0,0,4090.0,17:2,0,0,0,0.0,3,3,0,3,-3,0,0,0,0.0,0:0,0,0,0,310.0,1:17,700000
8477341,Andreas,Johnsson,1994-11-21,LW,L,2019-20,43,8,13,21,0.49,0,78,10.26,14,40647.0,15:45,0,2,2,0.0,43,21,13,20,-7,4,1,5,5213.0,2:1,0,0,0,567.0,0:13,3400000
8477343,Tyler,Lewington,1994-12-05,D,R,2019-20,6,0,0,0,0.0,-2,2,0.0,17,3657.0,10:9,0,0,0,0.0,13,7,1,3,-2,0,0,0,0.0,0:0,0,0,0,140.0,0:23,675000
8477346,MacKenzie,Weegar,1994-01-07,D,R,2019-20,45,7,11,18,0.4,6,77,9.09,33,54315.0,20:7,0,0,0,0.0,76,71,25,38,-13,0,0,0,558.0,0:12,0,0,0,4842.0,1:47,1600000
8477353,Tyler,Motte,1995-03-10,C,L,2019-20,34,4,4,8,0.24,-10,38,10.53,10,26758.0,13:7,8,11,19,42.11,118,37,16,9,7,0,0,0,103.0,0:3,0,0,0,4085.0,2:0,975000
8477355,Will,Butcher,1995-01-06,D,L,2019-20,56,4,17,21,0.38,-8,62,6.45,6,60202.0,17:55,0,0,0,0.0,31,75,10,27,-17,0,1,1,4355.0,1:17,0,0,0,751.0,0:13,3733333
8477359,Tucker,Poolman,1993-06-08,D,R,2019-20,57,4,12,16,0.28,-1,64,6.25,24,59673.0,17:26,0,0,0,0.0,58,59,14,46,-32,0,0,0,601.0,0:10,1,0,1,2444.0,0:42,775000
8477365,Connor,Clifton,1995-04-28,D,R,2019-20,32,2,0,2,0.06,3,22,9.09,14,27763.0,14:27,0,0,0,0.0,95,34,12,8,4,0,0,0,154.0,0:4,0,0,0,858.0,0:26,725000
8477366,Luke,Johnson,1994-09-19,C,R,2019-20,3,0,0,0,0.0,-3,1,0.0,0,2085.0,11:35,16,16,32,50.0,6,0,0,0,0,0,0,0,109.0,0:36,0,0,0,76.0,0:25,700000
8477369,Carson,Soucy,1994-07-27,D,L,2019-20,55,7,7,14,0.25,16,61,11.48,18,51575.0,15:37,0,0,0,0.0,69,50,17,16,1,0,0,0,118.0,0:2,1,0,1,3773.0,1:8,750000
8477380,Jonny,Brodzinski,1993-06-19,C,L,2019-20,3,0,1,1,0.33,0,5,0.0,0,1332.0,7:24,0,1,1,0.0,3,0,0,0,0,0,0,0,76.0,0:25,0,0,0,0.0,0:0,700000
8477384,Josh,Brown,1994-01-21,D,R,2019-20,56,3,5,8,0.14,1,48,6.25,39,45084.0,13:25,0,0,0,0.0,77,53,10,24,-14,0,0,0,12.0,0:0,0,0,0,1430.0,0:25,675000
8477401,John,Hayden,1995-02-14,RW,R,2019-20,43,3,1,4,0.09,-2,39,7.69,77,25066.0,9:42,4,15,19,21.05,87,27,13,7,6,0,0,0,133.0,0:3,0,0,0,532.0,0:12,750000
8477402,Pavel,Buchnevich,1995-04-17,RW,L,2019-20,68,16,30,46,0.68,2,148,10.81,24,69073.0,16:55,4,19,23,17.39,80,22,38,64,-26,4,5,9,9380.0,2:17,0,0,0,69.0,0:1,3250000
8477404,Jake,Guentzel,1994-10-06,C,L,2019-20,39,20,23,43,1.1,11,127,15.75,14,48270.0,20:37,22,24,46,47.83,46,19,21,12,9,6,4,10,7426.0,3:10,0,0,0,572.0,0:14,6000000
8477406,Mattias,Janmark,1992-12-08,C,L,2019-20,65,6,16,22,0.34,-5,92,6.52,16,57175.0,14:39,31,40,71,43.66,25,37,28,32,-4,1,4,5,2426.0,0:37,1,1,2,6292.0,1:36,2300000
8477407,Anthony,Duclair,1995-08-26,LW,L,2019-20,66,23,17,40,0.61,-5,184,12.5,18,64393.0,16:15,3,3,6,50.0,53,39,18,46,-28,5,3,8,10190.0,2:34,2,0,2,3693.0,0:55,1650000
8477409,Carter,Verhaeghe,1995-08-14,C,L,2019-20,52,9,4,13,0.25,-9,57,15.79,8,29208.0,9:21,14,17,31,45.16,29,8,19,11,8,1,0,1,763.0,0:14,0,0,0,79.0,0:1,700000
8477416,Oliver,Bjorkstrand,1995-04-10,RW,R,2019-20,49,21,15,36,0.73,8,162,12.96,12,52748.0,17:56,6,13,19,31.58,43,16,32,27,5,3,3,6,7296.0,2:28,0,0,0,28.0,0:0,2500000
8477425,Miles,Wood,1995-09-13,LW,L,2019-20,68,11,12,23,0.34,-19,141,7.8,57,53992.0,13:14,0,1,1,0.0,102,26,15,22,-7,0,0,0,3227.0,0:47,0,0,0,247.0,0:3,2750000
8477426,Nick,Paul,1995-03-20,LW,L,2019-20,56,9,11,20,0.36,0,103,8.74,24,48525.0,14:26,191,182,373,51.21,122,39,27,19,8,0,1,1,1729.0,0:30,0,0,0,1471.0,0:26,750000
8477429,Andrew,Copp,1994-07-08,C,L,2019-20,63,10,16,26,0.41,-3,121,8.26,10,66892.0,17:41,310,275,585,52.99,59,27,38,27,11,1,0,1,4475.0,1:11,0,3,3,8625.0,2:16,2280000
8477435,Ryan,Graves,1995-05-21,D,L,2019-20,72,10,17,27,0.38,43,138,7.25,45,81898.0,18:57,0,0,0,0.0,118,155,19,41,-22,0,0,0,254.0,0:3,0,2,2,12277.0,2:50,735000
8477444,Andre,Burakovsky,1995-02-09,LW,L,2019-20,61,21,27,48,0.79,13,105,20.0,22,55230.0,15:5,5,9,14,35.71,27,35,27,33,-6,3,9,12,8885.0,2:25,0,0,0,12.0,0:0,3250000
8477447,Shea,Theodore,1995-08-03,D,L,2019-20,74,15,35,50,0.68,14,230,6.52,27,99061.0,22:18,0,0,0,0.0,20,73,55,55,0,2,16,18,13937.0,3:8,1,0,1,650.0,0:8,5200000
8477448,Marko,Dano,1994-11-30,C,L,2019-20,3,0,0,0,0.0,-1,2,0.0,2,1291.0,7:10,0,0,0,0.0,5,3,1,1,0,0,0,0,0.0,0:0,0,0,0,0.0,0:0,800000
8477450,Jason,Dickinson,1995-07-04,C,L,2019-20,68,9,12,21,0.31,6,90,10.0,6,61417.0,15:3,211,270,481,43.87,97,58,48,32,16,0,0,0,292.0,0:4,0,1,1,9005.0,2:12,1500000
8477451,Ryan,Hartman,1994-09-20,RW,R,2019-20,69,9,11,20,0.29,4,114,7.89,69,50738.0,12:15,83,69,152,54.61,44,54,34,14,20,1,0,1,360.0,0:5,0,0,0,4473.0,1:4,1900000
8477454,Adam,Erne,1995-04-20,LW,L,2019-20,56,2,3,5,0.09,-24,63,3.17,28,39701.0,11:48,20,13,33,60.61,142,25,5,27,-22,0,0,0,2917.0,0:52,0,0,0,184.0,0:3,1050000
8477455,Jacob,de la Rose,1995-05-20,LW,L,2019-20,50,2,7,9,0.18,2,46,4.35,10,32174.0,10:43,118,156,274,43.07,120,16,13,8,5,0,0,0,53.0,0:1,0,0,0,3549.0,1:10,900000
8477456,J.T.,Compher,1995-04-08,LW,R,2019-20,70,12,21,33,0.47,12,112,10.71,18,69559.0,16:33,359,388,747,48.06,37,62,22,21,1,1,4,5,8509.0,2:1,0,3,3,9533.0,2:16,3500000
8477458,Valentin,Zykov,1995-05-15,LW,R,2019-20,15,1,3,4,0.27,-2,19,5.26,6,10990.0,12:12,0,1,1,0.0,20,3,5,12,-7,1,0,1,1204.0,1:20,0,0,0,7.0,0:0,675000
8477462,Robert,Hagg,1995-02-08,D,L,2019-20,51,3,10,13,0.25,12,39,7.69,32,47690.0,15:35,0,0,0,0.0,141,81,7,32,-25,1,0,1,100.0,0:1,0,0,0,3397.0,1:6,1150000
8477463,Steven,Santini,1995-03-07,D,R,2019-20,2,0,0,0,0.0,1,1,0.0,2,1146.0,9:33,0,0,0,0.0,3,0,0,0,0,0,0,0,0.0,0:0,0,0,0,35.0,0:17,1416667
8477464,Nic,Petan,1995-03-22,LW,L,2019-20,16,0,3,3,0.19,-4,19,0.0,4,10674.0,11:7,1,3,4,25.0,7,4,4,2,2,0,0,0,778.0,0:48,0,0,0,0.0,0:0,775000
8477467,Gustav,Olofsson,1994-12-01,D,L,2019-20,3,0,0,0,0.0,-4,2,0.0,2,1459.0,8:6,0,0,0,0.0,1,6,0,1,-1,0,0,0,0.0,0:0,0,0,0,0.0,0:0,700000
8477472,Carl,Dahlstrom,1995-01-28,D,L,2019-20,15,0,1,1,0.07,-4,9,0.0,6,13288.0,14:45,0,0,0,0.0,5,13,4,14,-10,0,0,0,67.0,0:4,0,0,0,897.0,0:59,850000
8477473,Justin,Bailey,1995-07-01,RW,R,2019-20,2,0,0,0,0.0,0,1,0.0,0,639.0,5:19,0,0,0,0.0,4,0,0,1,-1,0,0,0,0.0,0:0,0,0,0,0.0,0:0,750000
8477474,Madison,Bowey,1995-04-22,D,R,2019-20,53,3,14,17,0.32,-16,70,4.29,34,56947.0,17:54,0,0,0,0.0,53,58,14,45,-31,0,1,1,2176.0,0:41,0,0,0,4318.0,1:21,1000000
8477476,Artturi,Lehkonen,1995-07-04,LW,L,2019-20,70,13,14,27,0.39,2,140,9.29,24,64797.0,15:25,12,14,26,46.15,120,38,30,22,8,0,0,0,760.0,0:10,1,0,1,10150.0,2:25,2400000
8477478,William,Carrier,1994-12-20,LW,L,2019-20,74,8,12,20,0.27,0,106,7.55,41,43570.0,9:48,9,5,14,64.29,221,11,23,8,15,0,0,0,264.0,0:3,0,0,0,191.0,0:2,725000
8477479,Tyler,Bertuzzi,1995-02-24,LW,L,2019-20,71,21,27,48,0.68,-23,129,16.28,40,82279.0,19:18,4,2,6,66.67,71,30,25,57,-32,3,11,14,13391.0,3:8,0,0,0,778.0,0:10,1400000
8477482,Zach,Sanford,1994-11-09,LW,L,2019-20,61,16,16,32,0.52,14,93,17.2,30,50460.0,13:47,2,8,10,20.0,114,39,19,19,0,1,0,1,2480.0,0:40,0,0,0,1942.0,0:31,1500000
8477488,Brett,Pesce,1994-11-15,D,R,2019-20,61,4,14,18,0.3,7,104,3.85,27,80088.0,21:52,0,0,0,0.0,22,91,42,39,3,0,0,0,1071.0,0:17,0,2,2,11930.0,3:15,4025000
8477492,Nathan,MacKinnon,1995-09-01,C,R,2019-20,72,36,60,96,1.33,15,333,10.81,16,91872.0,21:16,381,499,880,43.3,58,31,39,53,-14,13,20,33,18276.0,4:13,0,0,0,303.0,0:4,6300000
8477493,Aleksander,Barkov,1995-09-02,C,L,2019-20,66,20,42,62,0.94,2,172,11.63,18,79260.0,20:0,653,550,1203,54.28,21,35,51,52,-1,7,13,20,13425.0,3:23,0,1,1,4409.0,1:6,5900000
8477494,Jonathan,Drouin,1995-03-28,LW,L,2019-20,27,7,8,15,0.56,-6,51,13.73,14,25436.0,15:42,4,8,12,33.33,25,5,12,11,1,1,3,4,3894.0,2:24,0,0,0,27.0,0:1,5500000
8477495,Seth,Jones,1994-10-03,D,R,2019-20,56,6,24,30,0.54,10,126,4.76,20,84941.0,25:16,0,0,0,0.0,62,123,29,37,-8,2,7,9,8647.0,2:34,0,1,1,8123.0,2:25,5400000
8477496,Elias,Lindholm,1994-12-02,C,R,2019-20,70,29,25,54,0.77,-8,169,17.16,22,82878.0,19:43,395,406,801,49.31,93,41,38,33,5,8,11,19,11886.0,2:49,0,0,0,8796.0,2:5,4850000
8477497,Sean,Monahan,1994-10-12,C,L,2019-20,70,22,26,48,0.69,-16,166,13.25,25,75939.0,18:4,549,495,1044,52.59,65,22,43,36,7,8,8,16,12031.0,2:51,0,0,0,123.0,0:1,6375000
8477498,Darnell,Nurse,1995-02-04,D,L,2019-20,71,5,28,33,0.46,-2,170,2.94,48,99916.0,23:27,0,0,0,0.0,172,141,26,54,-28,0,5,5,4521.0,1:3,0,0,0,8668.0,2:2,3200000
8477499,Rasmus,Ristolainen,1994-10-27,D,R,2019-20,69,6,27,33,0.48,-2,128,4.69,46,94389.0,22:47,0,0,0,0.0,203,82,17,24,-7,2,7,9,9631.0,2:19,0,1,1,9328.0,2:15,5400000
8477500,Bo,Horvat,1995-04-05,C,L,2019-20,69,22,31,53,0.77,-14,178,12.36,21,81690.0,19:43,850,633,1483,57.32,55,66,28,27,1,11,4,15,15353.0,3:42,0,0,0,1691.0,0:24,5500000
8477501,Valeri,Nichushkin,1995-03-04,RW,L,2019-20,68,13,14,27,0.4,26,117,11.11,14,57504.0,14:5,2,3,5,40.0,91,22,39,21,18,1,0,1,6490.0,1:35,1,0,1,2331.0,0:34,2950000
8477503,Max,Domi,1995-03-02,LW,L,2019-20,71,17,27,44,0.62,-3,179,9.5,35,72835.0,17:5,385,403,788,48.86,32,13,42,64,-22,1,10,11,9890.0,2:19,0,0,0,84.0,0:1,3150000
8477504,Josh,Morrissey,1995-03-28,D,L,2019-20,65,5,26,31,0.48,1,120,4.17,24,88804.0,22:46,0,0,0,0.0,34,59,22,46,-24,1,11,12,6810.0,1:44,0,0,0,3733.0,0:57,3150000
8477505,Alexander,Wennberg,1994-09-22,C,L,2019-20,57,5,17,22,0.39,-5,72,6.94,16,57055.0,16:40,309,363,672,45.98,21,31,20,25,-5,1,4,5,7100.0,2:4,0,0,0,5105.0,1:29,4900000
8477506,Ryan,Pulock,1994-10-06,D,R,2019-20,68,10,25,35,0.51,8,163,6.13,14,91424.0,22:24,0,0,0,0.0,110,139,15,64,-49,3,5,8,7208.0,1:46,0,0,0,6084.0,1:29,2000000
8477507,Nikita,Zadorov,1995-04-16,D,L,2019-20,67,4,9,13,0.19,5,67,5.97,67,70864.0,17:37,0,0,0,0.0,183,69,23,35,-12,0,0,0,272.0,0:4,0,0,0,6789.0,1:41,3200000
8477508,Curtis,Lazar,1995-02-02,C,R,2019-20,38,5,5,10,0.26,-3,33,15.15,9,26979.0,11:49,185,176,361,51.25,70,24,13,10,3,0,0,0,49.0,0:1,0,1,1,4050.0,1:46,700000
8477509,Mirco,Mueller,1995-03-21,D,L,2019-20,50,2,5,7,0.14,-13,29,6.9,23,52927.0,17:38,0,0,0,0.0,63,91,9,27,-18,0,1,1,363.0,0:7,0,0,0,6218.0,2:4,1400000
8477511,Anthony,Mantha,1994-09-16,RW,L,2019-20,43,16,22,38,0.88,-7,137,11.68,34,48745.0,18:53,16,22,38,42.11,49,25,22,30,-8,6,3,9,7881.0,3:3,0,0,0,40.0,0:0,3300000
8477512,Frederik,Gauthier,1995-04-26,C,L,2019-20,61,7,5,12,0.2,-4,42,16.67,10,34360.0,9:23,208,172,380,54.74,66,23,7,13,-6,0,0,0,84.0,0:1,0,0,0,3476.0,0:56,675000
8477527,Ross,Johnston,1994-02-18,LW,L,2019-20,32,3,1,4,0.12,1,16,18.75,78,15336.0,7:59,1,0,1,100.0,93,14,2,4,-2,0,0,0,6.0,0:0,0,0,0,0.0,0:0,1000000
8477529,Colby,Cave,1994-12-26,C,L,2019-20,11,1,0,1,0.09,-3,5,20.0,4,6364.0,9:38,36,41,77,46.75,17,3,3,1,2,0,0,0,5.0,0:0,0,0,0,598.0,0:54,675000
8477541,Dakota,Mermis,1994-01-05,D,L,2019-20,10,1,3,4,0.4,7,17,5.88,4,11530.0,19:13,0,0,0,0.0,20,21,1,7,-6,0,0,0,16.0,0:1,0,0,0,1202.0,2:0,700000
8477573,Nathan,Walker,1994-02-07,LW,L,2019-20,5,1,1,2,0.4,-2,6,16.67,4,3339.0,11:7,1,0,1,100.0,10,1,0,1,-1,0,0,0,0.0,0:0,0,0,0,0.0,0:0,700000
8477810,Joel,Hanley,1991-06-08,D,L,2019-20,8,0,2,2,0.25,0,4,0.0,6,5451.0,11:21,0,0,0,0.0,3,8,0,5,-5,0,0,0,16.0,0:2,0,0,0,96.0,0:12,700000
8477839,Conor,Sheary,1992-06-08,LW,L,2019-20,63,10,13,23,0.37,-5,102,9.8,10,49549.0,13:6,1,3,4,25.0,28,26,19,18,1,1,2,3,4482.0,1:11,0,0,0,81.0,0:1,3000000
8477845,Trevor,van Riemsdyk,1991-07-24,D,R,2019-20,49,1,7,8,0.16,-7,58,1.72,10,43707.0,14:51,0,0,0,0.0,21,37,13,17,-4,0,0,0,100.0,0:2,0,0,0,3615.0,1:13,2300000
8477846,Ryan,Carpenter,1991-01-18,C,R,2019-20,69,3,12,15,0.22,-6,80,3.75,28,58264.0,14:4,263,347,610,43.11,117,48,30,29,1,0,0,0,984.0,0:14,1,2,3,9966.0,2:24,1000000
8477850,Christian,Folin,1991-02-09,D,R,2019-20,16,1,1,2,0.12,-1,13,7.69,13,13856.0,14:26,0,0,0,0.0,38,21,1,8,-7,0,0,0,5.0,0:0,0,0,0,536.0,0:33,800000
8477851,Jordan,Oesterle,1992-06-25,D,L,2019-20,58,3,10,13,0.22,-9,69,4.35,14,59211.0,17:0,0,0,0,0.0,48,88,11,37,-26,0,2,2,3447.0,0:59,0,0,0,2281.0,0:39,1400000
8477887,Patrick,Brown,1992-05-29,C,R,2019-20,1,1,0,1,1.0,0,2,50.0,0,604.0,10:4,0,0,0,0.0,6,0,0,1,-1,0,0,0,0.0,0:0,0,0,0,0.0,0:0,700000
8477901,Daniel,Carr,1991-11-01,LW,L,2019-20,11,1,0,1,0.09,-5,14,7.14,4,6822.0,10:20,0,1,1,0.0,10,2,8,1,7,0,0,0,111.0,0:10,0,0,0,19.0,0:1,700000
8477903,Garnet,Hathaway,1991-11-23,RW,R,2019-20,69,9,7,16,0.23,4,83,10.84,81,44728.0,10:48,9,20,29,31.03,197,49,21,16,5,0,0,0,160.0,0:2,0,1,1,5386.0,1:18,1500000
8477922,Melker,Karlsson,1990-07-18,C,R,2019-20,61,6,6,12,0.2,-7,56,10.71,20,44905.0,12:16,14,17,31,45.16,38,39,26,11,15,0,0,0,147.0,0:2,0,0,0,7789.0,2:7,2000000
8477930,Pierre-Edouard,Bellemare,1985-03-06,LW,L,2019-20,72,9,13,22,0.31,1,89,10.11,19,57769.0,13:22,434,387,821,52.86,45,49,54,17,37,0,0,0,294.0,0:4,2,2,4,9001.0,2:5,1800000
8477931,Tomas,Nosek,1992-09-01,LW,L,2019-20,70,8,8,16,0.23,-3,94,8.51,22,48733.0,11:36,230,225,455,50.55,98,38,22,16,6,0,0,0,277.0,0:3,1,0,1,5293.0,1:15,1000000
8477932,Aaron,Ekblad,1996-02-07,D,R,2019-20,67,5,36,41,0.61,12,147,3.4,26,92365.0,22:58,0,0,0,0.0,34,84,37,74,-37,0,6,6,5807.0,1:26,0,1,1,8169.0,2:1,7500000
8477933,Sam,Reinhart,1995-11-06,C,R,2019-20,69,22,28,50,0.72,-15,144,15.28,20,85402.0,20:37,40,72,112,35.71,36,27,21,33,-12,5,7,12,14340.0,3:27,0,0,0,202.0,0:2,3650000
8477934,Leon,Draisaitl,1995-10-27,C,L,2019-20,71,43,67,110,1.55,-7,218,19.72,18,96324.0,22:36,661,608,1269,52.09,27,19,60,91,-31,16,28,44,16380.0,3:50,0,0,0,3724.0,0:52,8500000
8477935,Sam,Bennett,1996-06-20,C,L,2019-20,52,8,4,12,0.23,-1,82,9.76,36,39035.0,12:30,89,83,172,51.74,101,13,19,22,-3,0,1,1,2279.0,0:43,0,0,0,212.0,0:4,2550000
8477936,Michael,Dal Colle,1996-06-20,LW,L,2019-20,53,4,6,10,0.19,-8,59,6.78,12,37519.0,11:47,5,2,7,71.43,81,21,10,18,-8,0,0,0,876.0,0:16,0,0,0,25.0,0:0,700000
8477937,Jake,Virtanen,1996-08-17,RW,R,2019-20,69,18,18,36,0.52,-4,150,12.0,41,54173.0,13:5,5,13,18,27.78,102,28,37,31,6,6,3,9,3684.0,0:53,0,0,0,117.0,0:1,1250000
8477938,Haydn,Fleury,1996-07-08,D,L,2019-20,45,4,10,14,0.31,-2,65,6.15,8,36896.0,13:39,0,0,0,0.0,48,45,17,26,-9,0,0,0,21.0,0:0,0,1,1,2100.0,0:46,850000
8477939,William,Nylander,1996-05-01,C,R,2019-20,68,31,28,59,0.87,-2,197,15.74,12,74291.0,18:12,106,106,212,50.0,9,14,42,41,1,9,8,17,11767.0,2:53,0,0,0,57.0,0:0,6962366
8477940,Nikolaj,Ehlers,1996-02-14,LW,L,2019-20,71,25,33,58,0.82,14,203,12.32,30,70390.0,16:31,0,2,2,0.0,36,28,32,39,-7,3,2,5,5666.0,1:19,1,0,1,119.0,0:1,6000000
8477941,Nick,Ritchie,1995-12-05,LW,L,2019-20,50,9,12,21,0.42,1,79,11.39,97,42538.0,14:10,2,7,9,22.22,106,17,11,20,-9,2,1,3,4657.0,1:33,0,0,0,181.0,0:3,1498925
8477942,Kevin,Fiala,1996-07-22,LW,L,2019-20,64,23,31,54,0.84,-1,175,13.14,42,59139.0,15:24,2,7,9,22.22,25,18,33,35,-2,9,9,18,9146.0,2:22,0,0,0,111.0,0:1,3000000
8477943,Brendan,Perlini,1996-04-27,LW,L,2019-20,40,1,3,4,0.1,-18,48,2.08,10,25670.0,10:41,0,0,0,0.0,22,10,7,8,-1,0,0,0,2922.0,1:13,0,0,0,11.0,0:0,874125
8477944,Jakub,Vrana,1996-02-28,LW,L,2019-20,72,25,27,52,0.72,2,193,12.95,18,64187.0,14:51,6,5,11,54.55,32,16,33,46,-13,1,11,12,8389.0,1:56,0,0,0,84.0,0:1,3350000
8477946,Dylan,Larkin,1996-07-30,C,L,2019-20,71,19,34,53,0.75,-21,223,8.52,39,90521.0,21:14,714,648,1362,52.42,52,45,43,81,-38,5,9,14,13751.0,3:13,0,0,0,3229.0,0:45,6100000
8477947,Sonny,Milano,1996-05-12,LW,L,2019-20,55,7,16,23,0.42,-7,75,9.33,26,43220.0,13:5,0,0,0,0.0,26,13,22,30,-8,1,2,3,3999.0,1:12,0,0,0,58.0,0:1,874125
8477948,Travis,Sanheim,1996-03-29,D,L,2019-20,72,9,18,27,0.38,9,116,7.76,34,86874.0,20:6,0,0,0,0.0,44,91,23,57,-34,0,4,4,3972.0,0:55,0,0,0,7772.0,1:47,3250000
8477949,Alex,Tuch,1996-05-10,RW,R,2019-20,45,11,9,20,0.44,-9,106,10.38,8,39654.0,14:41,8,22,30,26.67,62,22,27,30,-3,4,4,8,4951.0,1:50,0,0,0,272.0,0:6,4750000
8477950,Tony,DeAngelo,1995-10-24,D,R,2019-20,68,15,38,53,0.78,12,149,10.07,47,78692.0,19:17,0,0,0,0.0,48,57,16,65,-49,3,16,19,12555.0,3:4,0,0,0,202.0,0:2,-111
8477951,Nick,Schmaltz,1996-02-23,C,R,2019-20,70,11,34,45,0.64,3,95,11.58,20,65247.0,15:32,160,216,376,42.55,12,35,52,27,25,2,11,13,9431.0,2:14,0,0,0,54.0,0:0,5850000
8477952,Robby,Fabbri,1996-01-22,C,L,2019-20,61,15,17,32,0.52,-33,111,13.51,20,59104.0,16:8,27,40,67,40.3,75,14,13,39,-26,6,3,9,9306.0,2:32,0,0,0,45.0,0:0,900000
8477953,Kasperi,Kapanen,1996-07-23,RW,R,2019-20,69,13,23,36,0.52,0,121,10.74,22,65371.0,15:47,2,13,15,13.33,73,17,36,29,7,0,3,3,5191.0,1:15,2,0,2,6845.0,1:39,3200000
8477955,Jared,McCann,1996-05-31,C,L,2019-20,66,14,21,35,0.53,6,150,9.33,17,60365.0,15:14,265,306,571,46.41,89,27,33,29,4,2,4,6,6683.0,1:41,0,0,0,1960.0,0:29,1250000
8477956,David,Pastrnak,1996-05-25,RW,R,2019-20,73,48,47,95,1.3,18,292,16.44,40,83365.0,19:1,8,11,19,42.11,49,23,51,93,-42,20,18,38,16652.0,3:48,0,0,0,39.0,0:0,6666667
8477960,Adrian,Kempe,1996-09-13,LW,L,2019-20,69,11,21,32,0.46,-10,148,7.43,29,66290.0,16:0,92,131,223,41.26,71,17,24,27,-3,2,8,10,10303.0,2:29,2,2,4,3753.0,0:54,2000000
8477961,John,Quenneville,1996-04-16,C,L,2019-20,9,0,0,0,0.0,-1,14,0.0,0,5966.0,11:2,3,1,4,75.0,21,3,2,5,-3,0,0,0,396.0,0:44,0,0,0,19.0,0:2,750000
8477962,Brendan,Lemieux,1996-03-15,LW,L,2019-20,59,6,12,18,0.31,-14,86,6.98,111,45561.0,12:52,18,31,49,36.73,164,52,15,30,-15,2,3,5,4628.0,1:18,1,1,2,2251.0,0:38,925000
8477963,Jayce,Hawryluk,1996-01-01,C,R,2019-20,26,3,7,10,0.38,1,26,11.54,16,17306.0,11:5,4,8,12,33.33,65,9,11,12,-1,0,0,0,229.0,0:8,0,0,0,24.0,0:0,874125
8477964,Ivan,Barbashev,1995-12-14,C,L,2019-20,70,11,15,26,0.37,4,77,14.29,23,56403.0,13:25,152,179,331,45.92,151,34,33,31,2,0,0,0,455.0,0:6,2,1,3,6735.0,1:36,1475000
8477969,Marcus,Pettersson,1996-05-08,D,L,2019-20,69,2,20,22,0.32,9,79,2.53,35,80320.0,19:24,0,0,0,0.0,106,84,17,38,-21,0,2,2,3616.0,0:52,0,0,0,5273.0,1:16,874125
8477971,Andreas,Englund,1996-01-21,D,L,2019-20,24,0,3,3,0.12,-8,10,0.0,12,15705.0,10:54,0,0,0,0.0,58,16,4,5,-1,0,0,0,42.0,0:1,0,0,0,1568.0,1:5,700000
8477972,Josh,Jacobs,1996-02-15,D,R,2019-20,2,0,0,0,0.0,1,3,0.0,2,1991.0,16:35,0,0,0,0.0,3,4,1,0,1,0,0,0,0.0,0:0,0,0,0,41.0,0:20,700000
8477973,Vladislav,Kamenev,1996-08-12,C,L,2019-20,38,1,7,8,0.21,-2,32,3.12,8,20466.0,8:58,57,50,107,53.27,34,16,18,7,11,0,2,2,2423.0,1:3,0,0,0,144.0,0:3,750000
8477974,Ryan,MacInnis,1996-02-14,C,L,2019-20,10,0,1,1,0.1,1,13,0.0,0,5611.0,9:21,10,17,27,37.04,8,3,3,2,1,0,0,0,51.0,0:5,0,0,0,0.0,0:0,874125
8477979,Nicolas,Aube-Kubel,1996-05-10,RW,R,2019-20,39,9,8,17,0.44,2,55,16.36,21,26497.0,11:19,1,2,3,33.33,93,17,14,12,2,2,1,3,2105.0,0:53,0,0,0,390.0,0:10,700000
8477983,Maxim,Letunov,1996-02-20,C,L,2019-20,3,1,0,1,0.33,0,3,33.33,0,1634.0,9:4,3,3,6,50.0,0,1,2,1,1,0,0,0,0.0,0:0,0,0,0,0.0,0:0,700000
8477986,Brandon,Montour,1994-04-11,D,R,2019-20,54,5,13,18,0.33,13,86,5.81,28,63175.0,19:29,0,0,0,0.0,60,53,12,27,-15,0,2,2,2138.0,0:39,0,0,0,3732.0,1:9,3387500
8477987,Ryan,Donato,1996-04-09,C,L,2019-20,62,14,9,23,0.37,5,95,14.74,12,39562.0,10:38,40,62,102,39.22,53,14,21,13,8,0,2,2,2709.0,0:43,0,0,0,17.0,0:0,1900000
8477989,Christian,Dvorak,1996-02-02,C,L,2019-20,70,18,20,38,0.54,6,134,13.43,12,70124.0,16:41,523,426,949,55.11,39,36,20,23,-3,6,4,10,11466.0,2:43,0,0,0,1233.0,0:17,4450000
8477998,Warren,Foegele,1996-04-01,LW,L,2019-20,68,13,17,30,0.44,9,129,10.08,34,55935.0,13:42,18,20,38,47.37,64,17,39,30,9,0,0,0,216.0,0:3,3,0,3,4447.0,1:5,746667
8478010,Brayden,Point,1996-03-13,C,R,2019-20,69,26,41,67,0.97,26,148,17.57,17,78126.0,18:52,424,394,818,51.83,25,32,32,20,12,8,6,14,13206.0,3:11,0,0,0,235.0,0:3,6750000
8478013,Jake,Walman,1996-02-20,D,L,2019-20,1,0,0,0,0.0,1,1,0.0,0,664.0,11:4,0,0,0,0.0,0,1,0,0,0,0,0,0,0.0,0:0,0,0,0,0.0,0:0,925000
8478017,Mark,Friedman,1995-12-25,D,R,2019-20,6,0,1,1,0.17,0,2,0.0,2,4892.0,13:35,0,0,0,0.0,8,5,1,0,1,0,0,0,28.0,0:4,0,0,0,0.0,0:0,749167
8478020,Michael,Amadio,1996-05-13,C,R,2019-20,68,6,10,16,0.24,-11,99,6.06,10,53053.0,13:0,232,248,480,48.33,21,22,31,25,6,0,3,3,5825.0,1:25,0,0,0,613.0,0:9,700000
8478021,William,Lagesson,1996-02-22,D,L,2019-20,8,0,0,0,0.0,-4,8,0.0,0,5695.0,11:51,0,0,0,0.0,4,12,0,7,-7,0,0,0,0.0,0:0,0,0,0,628.0,1:18,741666
8478027,Lucas,Wallmark,1995-09-05,C,L,2019-20,67,12,13,25,0.37,0,84,14.29,18,51388.0,12:46,379,374,753,50.33,57,26,22,17,5,3,3,6,4217.0,1:2,0,1,1,4385.0,1:5,675000
8478029,Chase,De Leo,1995-10-25,C,L,2019-20,1,0,0,0,0.0,0,1,0.0,0,899.0,14:59,0,1,1,0.0,1,0,0,0,0,0,0,0,44.0,0:44,0,0,0,0.0,0:0,750000
8478036,Christoffer,Ehn,1996-04-05,C,L,2019-20,54,2,2,4,0.07,-21,36,5.56,2,33729.0,10:24,96,130,226,42.48,59,18,6,12,-6,0,0,0,79.0,0:1,0,0,0,4027.0,1:14,759167
8478038,Devon,Toews,1994-02-21,D,L,2019-20,68,6,22,28,0.41,1,122,4.92,16,83690.0,20:30,0,0,0,0.0,55,75,32,57,-25,1,5,6,9136.0,2:14,0,0,0,341.0,0:5,700000
8478042,Viktor,Arvidsson,1993-04-08,LW,R,2019-20,57,15,13,28,0.49,-4,127,11.81,26,55411.0,16:12,11,8,19,57.89,27,24,15,24,-9,4,4,8,8443.0,2:28,0,0,0,1993.0,0:34,4250000
8478043,Sam,Lafferty,1995-03-06,C,R,2019-20,50,6,7,13,0.26,5,56,10.71,23,28862.0,9:37,117,119,236,49.58,95,17,17,12,5,0,0,0,77.0,0:1,0,0,0,1841.0,0:36,767500
8478046,Danton,Heinen,1995-07-05,C,L,2019-20,67,10,16,26,0.39,-2,109,9.17,10,58169.0,14:28,5,8,13,38.46,35,34,19,30,-11,3,3,6,8742.0,2:10,0,0,0,475.0,0:7,2800000
8478056,Clark,Bishop,1996-03-29,C,L,2019-20,5,0,1,1,0.2,-2,4,0.0,4,2295.0,7:39,13,21,34,38.24,5,0,1,1,0,0,0,0,26.0,0:5,0,0,0,35.0,0:7,700000
8478067,Oskar,Lindblom,1996-08-15,LW,L,2019-20,30,11,7,18,0.6,4,72,15.28,4,31695.0,17:36,13,19,32,40.62,31,16,15,13,2,3,1,4,4050.0,2:15,0,0,0,2646.0,1:28,925000
8478073,Anton,Lindholm,1994-11-29,D,L,2019-20,4,0,1,1,0.25,1,1,0.0,0,2827.0,11:46,0,0,0,0.0,5,5,0,0,0,0,0,0,0.0,0:0,0,0,0,90.0,0:22,742500
8478074,Anthony,Angello,1996-03-06,C,R,2019-20,8,1,0,1,0.12,-1,5,20.0,4,2745.0,5:43,0,1,1,0.0,13,5,1,0,1,0,0,0,0.0,0:0,0,0,0,16.0,0:2,833750
8478075,Anders,Bjork,1996-08-05,LW,L,2019-20,61,9,10,19,0.31,3,72,12.5,10,47193.0,12:53,2,4,6,33.33,46,22,22,15,7,1,0,1,1165.0,0:19,0,0,0,1774.0,0:29,925000
8478099,Kevin,Labanc,1995-12-12,RW,R,2019-20,70,14,19,33,0.47,-33,176,7.95,38,67494.0,16:4,2,10,12,16.67,46,24,33,33,0,3,6,9,10140.0,2:24,0,0,0,154.0,0:2,1000000
8478104,Sammy,Blais,1996-06-17,LW,L,2019-20,43,6,8,14,0.33,-1,57,10.53,24,32159.0,12:27,0,0,0,0.0,166,15,13,19,-6,0,0,0,2128.0,0:49,0,0,0,28.0,0:0,850000
8478106,Dylan,Sikura,1995-06-01,RW,L,2019-20,9,1,2,3,0.33,1,10,10.0,0,5345.0,9:53,0,3,3,0.0,0,2,2,0,2,0,0,0,0.0,0:0,0,0,0,0.0,0:0,750000
8478109,Victor,Olofsson,1995-07-18,RW,L,2019-20,54,20,22,42,0.78,-1,127,15.75,6,59563.0,18:23,1,1,2,50.0,10,16,12,26,-14,11,6,17,10763.0,3:19,0,0,0,416.0,0:7,767500
8478115,Pierre,Engvall,1996-05-31,LW,L,2019-20,48,8,7,15,0.31,4,72,11.11,6,34369.0,11:56,41,64,105,39.05,29,10,15,23,-8,0,0,0,16.0,0:0,1,1,2,3742.0,1:17,925000
8478131,Ondrej,Kase,1995-11-08,RW,R,2019-20,56,7,18,25,0.45,-6,144,4.86,14,55350.0,16:28,6,23,29,20.69,14,18,42,30,12,0,2,2,5740.0,1:42,1,0,1,2153.0,0:38,2600000
8478133,Jake,Evans,1996-06-02,C,R,2019-20,13,2,1,3,0.23,1,14,14.29,0,8075.0,10:21,29,27,56,51.79,16,5,5,3,2,0,0,0,382.0,0:29,0,0,0,441.0,0:33,925000
8478136,Jacob,Middleton,1996-01-02,D,L,2019-20,10,0,2,2,0.2,-2,9,0.0,9,6460.0,10:46,0,0,0,0.0,18,5,1,1,0,0,0,0,0.0,0:0,0,0,0,455.0,0:45,735000
8478146,Matthew,Highmore,1996-02-27,C,L,2019-20,36,2,4,6,0.17,-1,35,5.71,6,21196.0,9:48,1,3,4,25.0,38,9,15,9,6,0,0,0,146.0,0:4,0,0,0,754.0,0:20,775833
8478176,Joe,Hicketts,1996-05-04,D,L,2019-20,6,0,2,2,0.33,-5,6,0.0,2,6579.0,18:16,0,0,0,0.0,14,13,2,3,-1,0,0,0,294.0,0:49,0,0,0,552.0,1:32,700000
8478211,Dryden,Hunt,1995-11-24,LW,L,2019-20,21,0,4,4,0.19,0,33,0.0,24,13221.0,10:29,0,0,0,0.0,37,7,4,4,0,0,0,0,96.0,0:4,0,0,0,0.0,0:0,715000
8478233,Andrew,Mangiapane,1996-04-04,LW,L,2019-20,68,17,15,32,0.47,4,109,15.6,18,55900.0,13:42,12,31,43,27.91,73,25,38,29,9,0,1,1,2106.0,0:30,0,0,0,58.0,0:0,715000
8478366,Frank,Vatrano,1994-03-14,C,L,2019-20,69,16,18,34,0.49,-8,162,9.88,30,62170.0,15:1,12,28,40,30.0,102,43,32,18,14,2,0,2,6027.0,1:27,2,0,2,5196.0,1:15,2533333
8478367,Cole,Bardreau,1993-07-22,C,R,2019-20,10,1,1,2,0.2,-2,10,10.0,6,5322.0,8:52,21,29,50,42.0,21,1,4,4,0,0,0,0,0.0,0:0,0,0,0,329.0,0:32,700000
8478396,Noah,Hanifin,1997-01-25,D,L,2019-20,70,5,17,22,0.31,-12,132,3.79,12,88968.0,21:10,0,0,0,0.0,82,89,38,63,-25,1,4,5,5453.0,1:17,0,0,0,6980.0,1:39,4950000
8478397,Rasmus,Andersson,1996-10-27,D,R,2019-20,70,5,17,22,0.31,-7,124,4.03,57,83814.0,19:57,0,0,0,0.0,51,83,19,39,-20,0,4,4,6245.0,1:29,0,0,0,2999.0,0:42,755833
8478398,Kyle,Connor,1996-12-09,LW,L,2019-20,71,38,35,73,1.03,4,239,15.9,34,89833.0,21:5,2,11,13,15.38,18,17,43,39,4,9,8,17,14051.0,3:17,1,1,2,4446.0,1:2,7142857
8478399,Jonas,Siegenthaler,1997-05-06,D,L,2019-20,67,2,7,9,0.13,7,52,3.85,43,63089.0,15:41,0,0,0,0.0,57,109,14,35,-21,0,0,0,75.0,0:1,0,0,0,12521.0,3:6,714166
8478400,Colin,White,1997-01-30,C,R,2019-20,61,7,16,23,0.38,-12,83,8.43,39,57487.0,15:42,275,305,580,47.41,47,30,23,29,-6,1,3,4,7960.0,2:10,0,0,0,82.0,0:1,4750000
8478401,Pavel,Zacha,1997-04-06,C,L,2019-20,65,8,24,32,0.49,-12,97,8.25,14,63443.0,16:16,283,371,654,43.27,62,19,35,31,4,3,5,8,6400.0,1:38,2,2,4,7926.0,2:1,2250000
8478402,Connor,McDavid,1997-01-13,C,L,2019-20,64,34,63,97,1.52,-6,212,16.04,28,83964.0,21:51,320,350,670,47.76,37,18,53,75,-22,11,32,43,14927.0,3:53,0,0,0,401.0,0:6,12500000
8478403,Jack,Eichel,1996-10-28,C,R,2019-20,68,36,42,78,1.15,5,227,15.86,34,90172.0,22:6,614,697,1311,46.83,40,42,44,66,-22,11,16,27,15829.0,3:52,1,0,1,1133.0,0:16,10000000
8478407,Vince,Dunn,1996-10-29,D,L,2019-20,74,9,15,24,0.32,12,142,6.34,31,72187.0,16:15,0,0,0,0.0,54,49,14,32,-18,4,6,10,6743.0,1:31,0,0,0,247.0,0:3,722500
8478408,Travis,Dermott,1996-12-22,D,L,2019-20,56,4,7,11,0.2,14,65,6.15,37,58157.0,17:18,0,0,0,0.0,76,58,23,44,-21,0,0,0,161.0,0:2,0,0,0,3865.0,1:9,863333
8478409,Anthony,Richard,1996-12-20,C,L,2019-20,1,0,0,0,0.0,-1,2,0.0,0,250.0,4:10,0,0,0,0.0,0,0,0,0,0,0,0,0,0.0,0:0,0,0,0,0.0,0:0,688333
8478413,Jordan,Greenway,1997-02-16,LW,L,2019-20,67,8,20,28,0.42,2,93,8.6,54,56929.0,14:9,15,12,27,55.56,95,44,41,30,11,0,3,3,1227.0,0:18,0,0,0,3538.0,0:52,916666
8478414,Timo,Meier,1996-10-08,RW,L,2019-20,70,22,27,49,0.7,-22,199,11.06,42,72588.0,17:16,12,25,37,32.43,155,38,39,31,8,2,7,9,8853.0,2:6,0,0,0,2917.0,0:41,6000000
8478416,Erik,Cernak,1997-05-28,D,R,2019-20,70,5,7,12,0.17,11,129,3.88,61,80015.0,19:3,0,0,0,0.0,180,105,19,28,-9,0,0,0,540.0,0:7,0,0,0,12396.0,2:57,697500
8478420,Mikko,Rantanen,1996-10-29,RW,L,2019-20,45,19,26,45,1.0,1,118,16.1,14,51620.0,19:7,49,36,85,57.65,32,23,37,19,18,8,7,15,10000.0,3:42,0,0,0,35.0,0:0,9250000
8478424,Jansen,Harkins,1997-05-23,C,L,2019-20,29,2,5,7,0.24,-2,29,6.9,5,18481.0,10:37,0,5,5,0.0,8,10,7,7,0,0,0,0,122.0,0:4,0,0,0,0.0,0:0,767500
8478425,Brendan,Guhle,1997-07-29,D,L,2019-20,30,4,4,8,0.27,-2,39,10.26,10,30738.0,17:4,0,0,0,0.0,21,43,6,25,-19,0,0,0,176.0,0:5,0,0,0,1382.0,0:46,697500
8478427,Sebastian,Aho,1997-07-26,RW,L,2019-20,68,38,28,66,0.97,10,206,18.45,26,79249.0,19:25,409,480,889,46.01,55,20,71,58,13,8,9,17,11621.0,2:50,4,1,5,7364.0,1:48,8454000
8478430,Oliver,Kylington,1997-05-19,D,L,2019-20,48,2,5,7,0.15,-6,37,5.41,16,39475.0,13:42,0,0,0,0.0,36,34,8,29,-21,0,0,0,92.0,0:1,0,0,0,107.0,0:2,730833
8478431,Evgeny,Svechnikov,1996-10-31,RW,L,2019-20,4,0,0,0,0.0,-1,7,0.0,2,1998.0,8:19,0,0,0,0.0,5,1,0,3,-3,0,0,0,175.0,0:43,0,0,0,0.0,0:0,863333
8478432,Christian,Fischer,1997-04-15,RW,R,2019-20,56,6,3,9,0.16,2,83,7.23,16,37030.0,11:1,3,8,11,27.27,140,22,6,10,-4,0,0,0,318.0,0:5,0,0,0,8.0,0:0,821666
8478434,Keegan,Kolesar,1997-04-08,RW,R,2019-20,1,0,0,0,0.0,0,1,0.0,0,726.0,12:6,1,0,1,100.0,2,0,0,0,0,0,0,0,0.0,0:0,0,0,0,0.0,0:0,702500
8478436,David,Kase,1997-01-28,RW,L,2019-20,6,1,0,1,0.17,1,5,20.0,0,3520.0,9:46,1,0,1,100.0,4,1,2,1,1,0,0,0,14.0,0:2,0,0,0,39.0,0:6,768333
8478439,Travis,Konecny,1997-03-11,C,R,2019-20,69,24,39,63,0.91,2,145,16.55,30,69584.0,16:48,25,26,51,49.02,66,33,30,49,-19,5,18,23,12020.0,2:54,0,0,0,73.0,0:1,5500000
8478440,Dylan,Strome,1997-03-07,C,L,2019-20,58,12,26,38,0.66,1,97,12.37,16,55471.0,15:56,277,304,581,47.68,23,29,30,26,4,2,6,8,9062.0,2:36,0,0,0,88.0,0:1,863333
8478443,Brandon,Carlo,1996-11-26,D,R,2019-20,70,4,15,19,0.27,15,116,3.45,37,85573.0,20:22,0,0,0,0.0,128,78,32,33,-1,0,0,0,210.0,0:3,0,0,0,12720.0,3:1,2850000
8478444,Brock,Boeser,1997-02-25,RW,R,2019-20,57,16,29,45,0.79,5,169,9.47,14,63516.0,18:34,11,19,30,36.67,28,14,20,22,-2,5,9,14,14099.0,4:7,0,0,0,76.0,0:1,5875000
8478445,Mathew,Barzal,1997-05-26,C,R,2019-20,68,19,41,60,0.88,5,171,11.11,44,81775.0,20:2,228,320,548,41.61,22,43,70,103,-33,4,8,12,10751.0,2:38,0,0,0,36.0,0:0,863333
8478447,Nicholas,Merkley,1997-05-23,RW,L,2019-20,4,1,1,2,0.5,0,8,12.5,2,2727.0,11:21,0,0,0,0.0,9,2,2,2,0,0,0,0,147.0,0:36,0,0,0,0.0,0:0,863333
8478449,Roope,Hintz,1996-11-17,LW,L,2019-20,63,19,15,34,0.54,4,125,15.2,18,55859.0,14:46,182,183,365,49.86,75,29,25,36,-11,3,12,15,7437.0,1:58,2,0,2,1235.0,0:19,811667
8478451,Ethan,Bear,1997-06-26,D,R,2019-20,71,5,16,21,0.3,-4,99,5.05,33,93582.0,21:58,0,0,0,0.0,59,106,44,84,-40,1,1,2,3135.0,0:44,0,0,0,7937.0,1:51,720000
8478452,Caleb,Jones,1997-06-06,D,L,2019-20,43,4,5,9,0.21,-1,38,10.53,10,36456.0,14:7,0,0,0,0.0,33,46,8,26,-18,0,1,1,241.0,0:5,0,0,0,114.0,0:2,720000
8478455,Austin,Wagner,1997-06-23,LW,L,2019-20,65,6,5,11,0.17,-5,124,4.84,39,45797.0,11:44,3,6,9,33.33,145,19,20,21,-1,0,0,0,278.0,0:4,0,0,0,159.0,0:2,759167
8478458,Jack,Roslovic,1997-01-29,C,R,2019-20,71,12,17,29,0.41,4,117,10.26,12,63470.0,14:53,70,78,148,47.3,58,21,24,38,-14,1,1,2,5584.0,1:18,0,0,0,2.0,0:0,894166
8478460,Zach,Werenski,1997-07-19,D,L,2019-20,63,20,21,41,0.65,9,187,10.7,10,90665.0,23:59,0,0,0,0.0,36,58,32,47,-15,5,8,13,10314.0,2:43,1,0,1,7487.0,1:58,5000000
8478462,Nicolas,Roy,1997-02-05,C,R,2019-20,31,6,7,13,0.42,2,44,13.64,10,21852.0,11:44,108,115,223,48.43,41,8,12,9,3,1,0,1,181.0,0:5,0,0,0,1297.0,0:41,720000
8478463,Anthony,Beauvillier,1997-06-08,C,L,2019-20,68,18,21,39,0.57,-11,132,13.64,15,70421.0,17:15,9,4,13,69.23,86,36,29,51,-22,3,4,7,7249.0,1:46,1,0,1,2630.0,0:38,2100000
8478466,Daniel,Sprong,1997-03-17,RW,R,2019-20,8,1,1,2,0.25,-2,17,5.88,0,6768.0,14:6,0,0,0,0.0,4,3,1,0,1,1,0,1,803.0,1:40,0,0,0,0.0,0:0,750000
8478468,Jeremy,Lauzon,1997-04-28,D,L,2019-20,22,1,1,2,0.09,4,21,4.76,43,20311.0,15:23,0,0,0,0.0,40,25,3,6,-3,0,0,0,9.0,0:0,0,0,0,2160.0,1:38,747500
8478469,Thomas,Chabot,1997-01-30,D,L,2019-20,71,6,33,39,0.55,-18,186,3.23,42,110776.0,26:0,0,0,0,0.0,79,85,42,87,-45,0,11,11,13877.0,3:15,0,0,0,1038.0,0:14,863333
8478472,Mathieu,Joseph,1997-02-09,RW,L,2019-20,37,4,3,7,0.19,-2,35,11.43,16,25578.0,11:31,4,10,14,28.57,47,10,17,12,5,0,0,0,186.0,0:5,0,1,1,1718.0,0:46,728333
8478474,Lawson,Crouse,1997-06-23,LW,L,2019-20,66,15,10,25,0.38,0,109,13.76,33,53783.0,13:34,24,23,47,51.06,201,29,28,22,6,0,0,0,101.0,0:1,1,0,1,5606.0,1:24,1533333
8478476,Kyle,Capobianco,1997-08-13,D,L,2019-20,9,1,0,1,0.11,-1,10,10.0,2,7972.0,14:45,0,0,0,0.0,14,10,1,4,-3,0,0,0,81.0,0:9,0,0,0,444.0,0:49,745000
8478477,Mitchell,Stephens,1997-02-05,C,R,2019-20,41,4,3,7,0.17,-9,47,8.51,10,26692.0,10:51,200,187,387,51.68,43,10,6,4,2,0,0,0,154.0,0:3,0,0,0,2592.0,1:3,833333
8478483,Mitchell,Marner,1997-05-05,C,R,2019-20,59,16,51,67,1.14,6,154,10.39,16,76301.0,21:33,7,19,26,26.92,24,37,64,71,-7,6,18,24,11406.0,3:13,0,1,1,7784.0,2:11,10893000
8478485,Zach,Senyshyn,1997-03-30,RW,R,2019-20,4,0,2,2,0.5,1,1,0.0,0,2023.0,8:25,1,0,1,100.0,2,1,1,1,0,0,0,0,0.0,0:0,0,0,0,0.0,0:0,863333
8478488,Filip,Chlapik,1997-06-03,C,L,2019-20,31,3,3,6,0.19,-7,27,11.11,10,16312.0,8:46,12,19,31,38.71,71,11,8,6,2,0,0,0,162.0,0:5,0,0,0,34.0,0:1,728333
8478491,Jacob,Larsson,1997-04-29,D,L,2019-20,60,2,9,11,0.18,-9,58,3.45,12,58096.0,16:8,0,0,0,0.0,34,57,6,31,-25,0,0,0,186.0,0:3,0,0,0,3681.0,1:1,894166
8478493,Joel,Eriksson Ek,1997-01-29,C,L,2019-20,62,8,21,29,0.47,7,102,7.84,22,58468.0,15:43,367,428,795,46.16,93,43,19,18,1,1,0,1,276.0,0:4,0,1,1,7411.0,1:59,1487500
8478495,Denis,Gurianov,1997-06-07,RW,L,2019-20,67,20,9,29,0.43,2,138,14.49,13,52392.0,13:1,0,0,0,0.0,72,19,26,28,-2,7,5,12,7611.0,1:53,0,0,0,8.0,0:0,894166
8478498,Jake,DeBrusk,1996-10-17,LW,L,2019-20,68,20,16,36,0.53,0,165,12.12,16,65456.0,16:2,9,18,27,33.33,37,16,26,23,3,7,3,10,10454.0,2:33,0,0,0,27.0,0:0,863333
8478500,Ivan,Provorov,1997-01-13,D,L,2019-20,72,13,24,37,0.51,14,151,8.61,28,107376.0,24:51,0,0,0,0.0,85,114,17,72,-55,7,9,16,13360.0,3:5,0,1,1,11903.0,2:45,6750000
8478502,Dennis,Gilbert,1996-10-30,D,L,2019-20,21,1,2,3,0.14,-8,12,8.33,38,19789.0,15:42,0,0,0,0.0,74,33,2,4,-2,0,0,0,118.0,0:5,0,0,0,1549.0,1:13,925000
8478506,Gabriel,Carlsson,1997-01-02,D,L,2019-20,6,0,0,0,0.0,-1,3,0.0,2,3916.0,10:52,0,0,0,0.0,5,0,0,3,-3,0,0,0,57.0,0:9,0,0,0,165.0,0:27,894166
8478507,John,Marino,1997-05-21,D,R,2019-20,56,6,20,26,0.46,17,61,9.84,20,68015.0,20:14,0,0,0,0.0,72,77,37,42,-5,1,3,4,2525.0,0:45,0,0,0,6814.0,2:1,925000
8478508,Yakov,Trenin,1997-01-13,C,L,2019-20,21,2,4,6,0.29,1,25,8.0,9,12266.0,9:44,3,1,4,75.0,46,9,7,3,4,0,0,0,27.0,0:1,0,0,0,0.0,0:0,730833
8478512,Austin,Czarnik,1992-12-12,C,R,2019-20,8,2,1,3,0.38,1,9,22.22,0,4890.0,10:11,2,4,6,33.33,1,2,6,2,4,1,0,1,585.0,1:13,0,0,0,0.0,0:0,1250000
8478519,Anthony,Cirelli,1997-07-15,C,L,2019-20,71,16,28,44,0.62,26,116,13.79,32,78322.0,18:23,446,502,948,47.05,99,50,55,26,29,1,4,5,4016.0,0:56,1,1,2,11927.0,2:47,728333
8478542,Evan,Rodrigues,1993-07-28,LW,R,2019-20,45,6,4,10,0.22,-8,75,8.0,14,30473.0,11:17,120,137,257,46.69,24,15,14,13,1,1,0,1,1264.0,0:28,0,0,0,2032.0,0:45,2000000
8478550,Artemi,Panarin,1991-10-30,LW,R,2019-20,69,32,63,95,1.38,36,209,15.31,20,85300.0,20:36,1,1,2,50.0,25,18,56,82,-26,7,17,24,15454.0,3:43,0,0,0,83.0,0:1,11642857
8478567,Dean,Kukan,1993-07-08,D,L,2019-20,33,1,4,5,0.15,-9,51,1.96,12,31627.0,15:58,0,0,0,0.0,24,28,7,14,-7,1,0,1,1765.0,0:53,0,0,0,1.0,0:0,725000
8478569,Noel,Acciari,1991-12-01,C,R,2019-20,66,20,7,27,0.41,2,108,18.52,21,63227.0,15:57,381,413,794,47.98,121,103,32,21,11,0,0,0,327.0,0:4,1,0,1,10050.0,2:32,1666667
8478585,Derek,Ryan,1986-12-29,C,R,2019-20,68,10,19,29,0.43,9,102,9.8,10,59354.0,14:32,383,349,732,52.32,12,34,34,26,8,1,3,4,3377.0,0:49,1,1,2,6804.0,1:40,3125000
8478831,Kevin,Stenlund,1996-09-20,C,R,2019-20,32,6,4,10,0.31,2,57,10.53,8,26845.0,13:58,52,77,129,40.31,19,22,6,9,-3,3,2,5,3716.0,1:56,0,0,0,38.0,0:1,864166
8478833,J.C.,Beaudin,1997-03-25,C,R,2019-20,22,0,1,1,0.05,-4,18,0.0,7,11389.0,8:37,62,56,118,52.54,51,11,1,2,-1,0,0,0,65.0,0:2,0,0,0,378.0,0:17,765000
8478838,Lukas,Vejdemo,1996-01-25,C,L,2019-20,7,1,0,1,0.14,0,7,14.29,0,3369.0,8:1,1,4,5,20.0,8,3,2,2,0,0,0,0,13.0,0:1,0,0,0,0.0,0:0,792500
8478839,Aleksi,Saarela,1997-01-07,C,L,2019-20,9,2,2,4,0.44,2,15,13.33,0,6614.0,12:14,6,11,17,35.29,1,3,6,3,3,0,1,1,169.0,0:18,0,0,0,0.0,0:0,753333
8478841,Colton,White,1997-05-03,D,L,2019-20,6,0,0,0,0.0,-2,2,0.0,4,5035.0,13:59,0,0,0,0.0,3,4,2,6,-4,0,0,0,0.0,0:0,0,0,0,308.0,0:51,728333
8478843,Denis,Malgin,1997-01-18,C,R,2019-20,44,4,8,12,0.27,-9,50,8.0,14,31655.0,11:59,65,98,163,39.88,35,16,26,17,9,1,0,1,2364.0,0:53,0,1,1,522.0,0:11,750000
8478844,Mikhail,Vorobyev,1997-01-05,C,L,2019-20,20,1,2,3,0.15,-5,15,6.67,6,12516.0,10:25,78,62,140,55.71,4,3,5,4,1,0,0,0,74.0,0:3,0,0,0,709.0,0:35,-111
8478846,Christian,Wolanin,1995-03-17,D,L,2019-20,3,0,0,0,0.0,1,4,0.0,0,3183.0,17:41,0,0,0,0.0,0,4,0,2,-2,0,0,0,220.0,1:13,0,0,0,13.0,0:4,900000
8478851,Alexandre,Carrier,1996-10-08,D,R,2019-20,3,0,0,0,0.0,2,4,0.0,2,1940.0,10:46,0,0,0,0.0,3,0,0,0,0,0,0,0,0.0,0:0,0,0,0,0.0,0:0,688333
8478856,Conor,Garland,1996-03-11,RW,R,2019-20,68,22,17,39,0.57,1,158,13.92,20,57744.0,14:9,4,7,11,36.36,26,20,30,27,3,4,6,10,8557.0,2:5,0,0,0,27.0,0:0,775000
8478857,Dmytro,Timashov,1996-10-01,LW,L,2019-20,44,4,5,9,0.2,1,37,10.81,16,22523.0,8:31,0,0,0,0.0,93,11,5,7,-2,0,0,0,152.0,0:3,0,0,0,73.0,0:1,694444
8478859,Niko,Mikkola,1996-04-27,D,L,2019-20,5,0,1,1,0.2,3,10,0.0,0,4309.0,14:21,0,0,0,0.0,5,3,0,1,-1,0,0,0,0.0,0:0,0,0,0,272.0,0:54,842500
8478866,Dominik,Simon,1994-08-08,C,L,2019-20,64,7,15,22,0.34,-9,102,6.86,12,55324.0,14:24,15,27,42,35.71,57,20,41,31,10,0,1,1,1845.0,0:28,0,0,0,883.0,0:13,750000
8478868,Christian,Jaros,1996-04-02,D,R,2019-20,13,0,3,3,0.23,-2,5,0.0,6,8202.0,10:30,0,0,0,0.0,14,12,1,5,-4,0,0,0,0.0,0:0,0,1,1,642.0,0:49,755000
8478870,Rudolfs,Balcers,1997-04-08,LW,L,2019-20,15,1,2,3,0.2,-2,23,4.35,0,10925.0,12:8,0,2,2,0.0,19,7,7,5,2,0,0,0,1520.0,1:41,0,0,0,0.0,0:0,759167
8478873,Troy,Terry,1997-09-10,RW,R,2019-20,47,4,11,15,0.32,-5,73,5.48,6,40942.0,14:31,3,5,8,37.5,3,9,31,19,12,0,2,2,5048.0,1:47,0,0,0,23.0,0:0,925000
8478874,Adam,Gaudette,1996-10-03,C,R,2019-20,59,12,21,33,0.56,-7,75,16.0,37,43838.0,12:23,187,267,454,41.19,29,20,23,15,8,4,8,12,5345.0,1:30,0,0,0,13.0,0:0,916667
8478881,Brett,Seney,1996-02-28,LW,L,2019-20,2,0,0,0,0.0,-1,1,0.0,0,1192.0,9:56,0,2,2,0.0,2,0,1,3,-2,0,0,0,0.0,0:0,0,0,0,0.0,0:0,757500
8478882,Vladislav,Gavrikov,1995-11-21,D,L,2019-20,69,5,13,18,0.26,1,81,6.17,18,78574.0,18:58,0,0,0,0.0,79,92,16,33,-17,0,0,0,243.0,0:3,0,0,0,6133.0,1:28,925000
8478891,Mason,Appleton,1996-01-15,C,R,2019-20,46,5,3,8,0.17,-9,55,9.09,20,30808.0,11:9,5,8,13,38.46,20,12,11,10,1,0,0,0,311.0,0:6,1,0,1,2575.0,0:55,741667
8478906,Markus,Nutivaara,1994-06-06,D,L,2019-20,37,3,6,9,0.24,2,47,6.38,4,35345.0,15:55,0,0,0,0.0,35,33,6,13,-7,0,1,1,686.0,0:18,0,0,0,73.0,0:1,2700000
8478911,Matt,Roy,1995-03-01,D,R,2019-20,70,4,14,18,0.26,16,112,3.57,10,76114.0,18:7,0,0,0,0.0,132,100,7,43,-36,0,1,1,171.0,0:2,0,0,0,5932.0,1:24,700000
8478915,Sami,Niku,1996-10-10,D,L,2019-20,17,0,5,5,0.29,-2,27,0.0,12,16482.0,16:9,0,0,0,0.0,16,19,2,11,-9,0,0,0,532.0,0:31,0,0,0,11.0,0:0,775000
8478949,Kole,Sherwood,1997-01-22,RW,R,2019-20,3,0,0,0,0.0,0,6,0.0,2,1195.0,6:38,0,1,1,0.0,10,1,2,0,2,0,0,0,0.0,0:0,0,0,0,0.0,0:0,694444
8478996,Adam,Brooks,1996-05-06,C,L,2019-20,7,0,3,3,0.43,1,2,0.0,0,3298.0,7:51,5,5,10,50.0,0,1,2,1,1,0,0,0,42.0,0:6,0,0,0,118.0,0:16,759167
8479026,Philippe,Myers,1997-01-25,D,R,2019-20,53,5,12,17,0.32,23,85,5.88,30,54579.0,17:9,0,0,0,0.0,87,46,22,37,-15,0,0,0,449.0,0:8,0,0,0,1192.0,0:22,678889
8479291,Kevin,Rooney,1993-05-21,C,L,2019-20,49,4,5,9,0.18,8,59,6.78,20,34488.0,11:43,175,197,372,47.04,64,32,17,13,4,0,0,0,74.0,0:1,2,1,3,6171.0,2:5,700000
8479293,Brandon,Tanev,1991-12-31,LW,L,2019-20,68,11,14,25,0.37,-1,95,11.58,16,60221.0,14:45,6,9,15,40.0,244,65,33,37,-4,0,1,1,379.0,0:5,2,1,3,8950.0,2:11,3500000
8479314,Matthew,Tkachuk,1997-12-11,LW,L,2019-20,69,23,38,61,0.88,-5,188,12.23,74,75799.0,18:18,0,4,4,0.0,122,22,40,86,-46,5,14,19,11736.0,2:50,0,0,0,15.0,0:0,7000000
8479315,Joey,Anderson,1998-06-19,RW,R,2019-20,18,4,2,6,0.33,1,21,19.05,2,14274.0,13:13,3,3,6,50.0,16,6,4,7,-3,0,0,0,73.0,0:4,0,0,0,2123.0,1:57,925000
8479316,Luke,Kunin,1997-12-04,C,R,2019-20,63,15,16,31,0.49,-10,128,11.72,55,58460.0,15:27,210,262,472,44.49,64,54,9,15,-6,0,2,2,3011.0,0:47,1,0,1,5236.0,1:23,925000
8479318,Auston,Matthews,1997-09-17,C,L,2019-20,70,47,33,80,1.14,19,290,16.21,8,88072.0,20:58,506,414,920,55.0,40,60,78,48,30,12,13,25,13424.0,3:11,0,0,0,149.0,0:2,11634000
8479320,Maxime,Lajoie,1997-11-05,D,L,2019-20,6,0,0,0,0.0,0,3,0.0,0,2814.0,7:49,0,0,0,0.0,2,3,0,0,0,0,0,0,39.0,0:6,0,0,0,0.0,0:0,710000
8479323,Adam,Fox,1998-02-17,D,R,2019-20,70,8,34,42,0.6,22,125,6.4,32,79398.0,18:54,0,0,0,0.0,35,92,57,61,-4,1,12,13,8326.0,1:58,0,0,0,544.0,0:7,925000
8479324,Ryan,Lindgren,1998-02-11,D,L,2019-20,60,1,13,14,0.23,16,47,2.13,47,59640.0,16:34,0,0,0,0.0,94,70,28,25,3,0,0,0,103.0,0:1,0,0,0,7772.0,2:9,925000
8479325,Charlie,McAvoy,1997-12-21,D,R,2019-20,70,6,28,34,0.49,23,110,5.45,45,96979.0,23:5,0,0,0,0.0,138,134,39,74,-35,1,1,2,5647.0,1:20,0,1,1,7659.0,1:49,4900000
8479328,Julien,Gauthier,1997-10-15,RW,R,2019-20,17,0,3,3,0.18,1,10,0.0,8,8446.0,8:16,1,2,3,33.33,15,7,3,7,-4,0,0,0,74.0,0:4,0,0,0,3.0,0:0,863333
8479333,Libor,Hajek,1998-02-04,D,L,2019-20,28,0,5,5,0.18,-4,23,0.0,12,26854.0,15:59,0,0,0,0.0,24,44,8,17,-9,0,0,0,161.0,0:5,0,0,0,1522.0,0:54,833333
8479335,Rasmus,Asplund,1997-12-03,C,L,2019-20,29,1,2,3,0.1,-4,36,2.78,6,18851.0,10:50,49,65,114,42.98,20,7,5,7,-2,0,0,0,56.0,0:1,0,1,1,3087.0,1:46,845000
8479336,Carl,Grundstrom,1997-12-01,RW,L,2019-20,13,0,4,4,0.31,2,16,0.0,8,9956.0,12:45,0,0,0,0.0,29,4,0,4,-4,0,0,0,341.0,0:26,0,0,0,0.0,0:0,925000
8479337,Alex,DeBrincat,1997-12-18,RW,R,2019-20,70,18,27,45,0.64,-10,207,8.7,15,73474.0,17:29,7,13,20,35.0,58,19,41,37,4,10,6,16,14599.0,3:28,0,0,0,54.0,0:0,778333
8479339,Patrik,Laine,1998-04-19,RW,R,2019-20,68,28,35,63,0.93,8,226,12.39,22,79193.0,19:24,10,17,27,37.04,97,35,41,57,-16,8,8,16,13164.0,3:13,0,0,0,10.0,0:0,6750000
8479343,Clayton,Keller,1998-07-29,C,L,2019-20,70,17,27,44,0.63,-6,184,9.24,28,68440.0,16:17,8,13,21,38.1,20,13,34,32,2,2,13,15,11328.0,2:41,0,0,0,83.0,0:1,885833
8479345,Jakob,Chychrun,1998-03-31,D,L,2019-20,63,12,14,26,0.41,4,149,8.05,38,84803.0,22:26,0,0,0,0.0,75,95,27,52,-25,5,3,8,8302.0,2:11,0,0,0,5687.0,1:30,4600000
8479346,Dillon,Dube,1998-07-20,C,L,2019-20,45,6,10,16,0.36,0,60,10.0,6,34273.0,12:41,0,2,2,0.0,59,13,17,16,1,1,1,2,1464.0,0:32,0,0,0,428.0,0:9,778333
8479347,Tyler,Benson,1998-03-15,LW,L,2019-20,7,0,1,1,0.14,-1,5,0.0,0,4359.0,10:22,1,0,1,100.0,3,1,2,3,-1,0,0,0,171.0,0:24,0,0,0,0.0,0:0,808333
8479348,Kale,Clague,1998-06-05,D,L,2019-20,4,0,0,0,0.0,-3,2,0.0,2,3494.0,14:33,0,0,0,0.0,1,4,0,1,-1,0,0,0,53.0,0:13,0,0,0,0.0,0:0,761666
8479351,Sam,Steel,1998-02-03,C,L,2019-20,65,6,16,22,0.34,-13,85,7.06,20,60624.0,15:32,369,365,734,50.27,24,25,25,37,-12,1,7,8,6776.0,1:44,0,0,0,1275.0,0:19,863333
8479353,Brett,Howden,1998-03-29,C,L,2019-20,70,9,10,19,0.27,-11,64,14.06,28,55199.0,13:8,251,270,521,48.18,69,67,25,25,0,1,1,2,1217.0,0:17,0,2,2,8439.0,2:0,863333
8479356,Kieffer,Bellows,1998-06-10,LW,L,2019-20,8,2,1,3,0.38,3,11,18.18,2,5112.0,10:39,0,0,0,0.0,12,4,2,5,-3,0,0,0,5.0,0:0,0,0,0,0.0,0:0,894166
8479358,Carsen,Twarynski,1997-11-24,LW,L,2019-20,15,1,0,1,0.07,-2,14,7.14,4,9609.0,10:40,0,2,2,0.0,40,8,6,0,6,0,0,0,31.0,0:2,0,0,0,230.0,0:15,775833
8479359,Beck,Malenstyn,1998-02-04,LW,L,2019-20,3,0,0,0,0.0,-1,4,0.0,0,1669.0,9:16,0,0,0,0.0,5,1,1,0,1,0,0,0,0.0,0:0,0,0,0,286.0,1:35,736666
8479364,Tim,Gettinger,1998-04-14,LW,L,2019-20,2,0,1,1,0.5,1,3,0.0,0,1006.0,8:23,0,2,2,0.0,5,1,0,0,0,0,0,0,17.0,0:8,0,0,0,54.0,0:27,730000
8479365,Trent,Frederic,1998-02-11,C,L,2019-20,2,0,0,0,0.0,-1,1,0.0,0,771.0,6:25,0,0,0,0.0,8,0,0,0,0,0,0,0,0.0,0:0,0,0,0,0.0,0:0,925000
8479366,Logan,Brown,1998-03-05,C,L,2019-20,23,1,7,8,0.35,0,23,4.35,4,16225.0,11:45,55,79,134,41.04,13,11,10,16,-6,1,2,3,2660.0,1:55,0,0,0,69.0,0:3,863333
8479368,Max,Jones,1998-02-17,LW,L,2019-20,59,8,4,12,0.2,-6,102,7.84,36,50505.0,14:16,11,16,27,40.74,82,18,19,32,-13,0,1,1,1739.0,0:29,1,0,1,2535.0,0:42,863333
8479369,Andrew,Peeke,1998-03-17,D,R,2019-20,22,1,2,3,0.14,1,23,4.35,4,18290.0,13:51,0,0,0,0.0,25,21,3,8,-5,0,0,0,0.0,0:0,0,0,0,321.0,0:14,916667
8479370,Tyson,Jost,1998-03-14,C,L,2019-20,68,8,15,23,0.34,11,116,6.9,22,51909.0,12:43,85,171,256,33.2,58,18,18,12,6,1,4,5,6809.0,1:40,0,0,0,1131.0,0:16,885833
8479371,Dante,Fabbro,1998-06-20,D,R,2019-20,64,5,6,11,0.17,-7,92,5.43,38,73057.0,19:1,0,0,0,0.0,54,85,23,39,-16,1,0,1,1373.0,0:21,0,0,0,1909.0,0:29,925000
8479372,Josh,Mahura,1998-05-05,D,L,2019-20,11,1,3,4,0.36,-3,11,9.09,2,10710.0,16:13,0,0,0,0.0,2,11,2,5,-3,0,0,0,1045.0,1:35,0,0,0,51.0,0:4,745000
8479376,Victor,Mete,1998-06-07,D,L,2019-20,51,4,7,11,0.22,5,57,7.02,20,48936.0,15:59,0,0,0,0.0,20,60,8,35,-27,0,1,1,200.0,0:3,0,0,0,1900.0,0:37,748333
8479379,Givani,Smith,1998-02-27,RW,L,2019-20,21,2,1,3,0.14,-2,22,9.09,9,12200.0,9:40,0,0,0,0.0,42,3,2,6,-4,0,0,0,1682.0,1:20,0,0,0,0.0,0:0,714166
8479381,Nick,Caamano,1998-09-07,RW,L,2019-20,12,1,1,2,0.17,2,13,7.69,4,7175.0,9:57,1,1,2,50.0,17,3,1,2,-1,0,0,0,9.0,0:0,0,0,0,113.0,0:9,738333
8479382,Connor,Bunnaman,1998-04-16,C,L,2019-20,23,1,1,2,0.09,7,20,5.0,4,13153.0,9:31,37,61,98,37.76,29,2,1,5,-4,0,0,0,55.0,0:2,0,0,0,38.0,0:1,736666
8479385,Jordan,Kyrou,1998-05-05,C,R,2019-20,29,4,5,9,0.31,1,40,10.0,8,18849.0,10:49,2,3,5,40.0,8,8,13,7,6,0,1,1,634.0,0:21,0,0,0,0.0,0:0,758333
8479388,Riley,Stillman,1998-03-09,D,L,2019-20,34,0,5,5,0.15,-3,39,0.0,14,39002.0,19:7,0,0,0,0.0,59,57,13,28,-15,0,0,0,90.0,0:2,0,0,0,4842.0,2:22,773333
8479393,Noah,Gregor,1998-07-28,C,L,2019-20,28,3,2,5,0.18,-5,33,9.09,8,16899.0,10:3,6,13,19,31.58,50,6,6,7,-1,1,1,2,588.0,0:21,0,0,0,0.0,0:0,768333
8479395,Dennis,Cholowski,1998-02-15,D,L,2019-20,36,2,6,8,0.22,-26,51,3.92,6,41518.0,19:13,0,0,0,0.0,15,35,4,21,-17,1,4,5,5751.0,2:39,0,0,0,485.0,0:13,894166
8479398,Samuel,Girard,1998-05-12,D,L,2019-20,73,4,32,36,0.49,1,100,4.0,19,93103.0,21:15,0,0,0,0.0,48,95,38,40,-2,1,13,14,10605.0,2:25,0,0,0,411.0,0:5,728333
8479400,Pierre-Luc,Dubois,1998-06-24,C,L,2019-20,70,18,31,49,0.7,-2,158,11.39,49,75314.0,17:55,359,446,805,44.6,85,50,27,46,-19,1,9,10,11221.0,2:40,0,0,0,428.0,0:6,894166
8479404,Henrik,Borgstrom,1997-08-06,C,L,2019-20,4,0,0,0,0.0,-2,3,0.0,2,2972.0,12:23,13,14,27,48.15,1,0,3,1,2,0,0,0,363.0,1:30,0,0,0,45.0,0:11,925000
8479407,Jesper,Bratt,1998-07-30,LW,L,2019-20,60,16,16,32,0.53,-6,101,15.84,6,50338.0,13:58,3,10,13,23.08,29,22,18,24,-6,1,5,6,7247.0,2:0,0,0,0,114.0,0:1,749167
8479410,Mikhail,Sergachev,1998-06-25,D,L,2019-20,73,10,24,34,0.47,13,124,8.06,60,89447.0,20:25,0,0,0,0.0,112,101,19,43,-24,5,8,13,8088.0,1:50,1,0,1,5105.0,1:9,894166
8479411,Vitaly,Abramov,1998-05-08,RW,L,2019-20,2,1,0,1,0.5,0,3,33.33,2,694.0,5:47,0,0,0,0.0,0,0,0,1,-1,0,0,0,0.0,0:0,0,0,0,0.0,0:0,730833
8479415,Michael,McLeod,1998-02-03,C,R,2019-20,12,0,2,2,0.17,4,11,0.0,4,7365.0,10:13,40,40,80,50.0,19,6,4,0,4,0,0,0,12.0,0:1,0,0,0,102.0,0:8,863333
8479423,Alexander,Nylander,1998-03-02,RW,R,2019-20,65,10,16,26,0.4,-2,94,10.64,10,47327.0,12:8,5,14,19,26.32,29,14,25,23,2,0,2,2,4544.0,1:9,0,0,0,0.0,0:0,863333
8479424,German,Rubtsov,1998-06-27,C,L,2019-20,4,0,0,0,0.0,-1,1,0.0,0,1633.0,6:48,6,8,14,42.86,4,4,1,1,0,0,0,0,0.0,0:0,0,0,0,0.0,0:0,894166
8479425,Filip,Hronek,1997-11-02,D,R,2019-20,65,9,22,31,0.48,-38,125,7.2,46,93194.0,23:53,0,0,0,0.0,105,74,18,76,-58,1,9,10,11227.0,2:52,0,0,0,11300.0,2:53,714166
8479442,Troy,Stecher,1994-04-07,D,R,2019-20,69,5,12,17,0.25,10,86,5.81,32,63539.0,15:20,0,0,0,0.0,69,70,16,25,-9,0,0,0,324.0,0:4,0,0,0,2268.0,0:32,2325000
8479458,Nikita,Zaitsev,1991-10-29,D,R,2019-20,58,1,11,12,0.21,-8,64,1.56,22,77092.0,22:9,0,0,0,0.0,108,121,20,44,-24,0,0,0,476.0,0:8,0,0,0,10429.0,2:59,4500000
8479465,Drake,Caggiula,1994-06-20,LW,L,2019-20,40,9,6,15,0.38,-3,56,16.07,32,28357.0,11:48,4,10,14,28.57,81,16,19,5,14,1,0,1,388.0,0:9,0,1,1,1445.0,0:36,1500000
8479466,Patrick,Russell,1993-01-04,RW,R,2019-20,45,0,5,5,0.11,-11,58,0.0,12,30681.0,11:21,2,2,4,50.0,64,25,9,13,-4,0,0,0,165.0,0:3,0,0,0,1918.0,0:42,700000
8479482,Michal,Kempny,1990-09-08,D,L,2019-20,61,3,16,19,0.31,20,79,3.8,26,68341.0,18:40,0,0,0,0.0,52,74,13,38,-25,0,0,0,339.0,0:5,0,0,0,5697.0,1:33,2500000
8479510,Egor,Korshkov,1996-07-10,RW,L,2019-20,1,1,0,1,1.0,1,1,100.0,0,608.0,10:8,0,0,0,0.0,1,0,1,0,1,0,0,0,0.0,0:0,0,0,0,0.0,0:0,925000
8479523,Lucas,Carlsson,1997-07-05,D,L,2019-20,6,0,1,1,0.17,3,3,0.0,0,5090.0,14:8,0,0,0,0.0,11,6,1,0,1,0,0,0,95.0,0:15,0,0,0,104.0,0:17,792500
8479526,Otto,Koivula,1998-09-01,LW,L,2019-20,12,0,0,0,0.0,0,4,0.0,2,5696.0,7:54,24,41,65,36.92,12,4,2,3,-1,0,0,0,0.0,0:0,0,0,0,72.0,0:6,786666
8479542,Brandon,Hagel,1998-08-27,LW,L,2019-20,1,0,0,0,0.0,0,4,0.0,0,708.0,11:48,0,0,0,0.0,1,1,1,0,1,0,0,0,0.0,0:0,0,0,0,0.0,0:0,880833
8479557,Calvin,Thurkauf,1997-06-27,C,L,2019-20,3,0,0,0,0.0,0,1,0.0,0,1486.0,8:15,2,0,2,100.0,5,0,0,0,0,0,0,0,0.0,0:0,0,0,0,0.0,0:0,714444
8479571,Joachim,Blichfeld,1998-07-17,RW,R,2019-20,3,0,0,0,0.0,-2,3,0.0,2,2299.0,12:46,0,0,0,0.0,3,4,2,0,2,0,0,0,43.0,0:14,0,0,0,0.0,0:0,736666
8479580,Dylan,Gambrell,1996-08-26,C,R,2019-20,50,5,6,11,0.22,-8,43,11.63,17,35853.0,11:57,170,200,370,45.95,40,29,11,17,-6,0,1,1,2008.0,0:40,0,0,0,2857.0,0:57,700000
8479587,Rhett,Gardner,1996-02-28,C,L,2019-20,8,0,0,0,0.0,0,8,0.0,2,4865.0,10:8,25,28,53,47.17,8,2,1,3,-2,0,0,0,14.0,0:1,0,0,0,671.0,1:23,925000
8479644,Matt,Luff,1997-05-05,RW,R,2019-20,18,1,4,5,0.28,-5,25,4.0,2,11202.0,10:22,0,3,3,0.0,16,5,4,4,0,0,0,0,132.0,0:7,0,0,0,0.0,0:0,677777
8479671,Mathieu,Olivier,1997-02-11,RW,R,2019-20,8,0,1,1,0.12,1,6,0.0,4,3622.0,7:32,0,0,0,0.0,17,1,0,3,-3,0,0,0,0.0,0:0,0,0,0,0.0,0:0,730000
8479675,Trevor,Moore,1995-03-31,C,L,2019-20,42,6,4,10,0.24,-4,60,10.0,6,32503.0,12:53,4,10,14,28.57,60,17,21,20,1,0,0,0,1765.0,0:42,0,1,1,3269.0,1:17,775000
8479734,Brennan,Menell,1997-05-24,D,R,2019-20,5,0,0,0,0.0,1,4,0.0,2,4197.0,13:59,0,0,0,0.0,2,4,2,0,2,0,0,0,330.0,1:6,0,0,0,1.0,0:0,716666
8479748,Gage,Quinney,1995-07-29,C,L,2019-20,3,0,1,1,0.33,-1,2,0.0,0,1748.0,9:42,8,9,17,47.06,2,0,0,0,0,0,0,0,0.0,0:0,0,0,0,0.0,0:0,715000
8479772,Zack,MacEwen,1996-07-08,C,R,2019-20,17,5,1,6,0.35,6,17,29.41,20,9809.0,9:37,1,1,2,50.0,41,5,4,8,-4,0,0,0,66.0,0:3,0,0,0,0.0,0:0,847500
8479933,Gerald,Mayhew,1992-12-31,C,L,2019-20,13,2,0,2,0.15,4,16,12.5,2,9008.0,11:32,3,3,6,50.0,11,6,4,2,2,0,0,0,1002.0,1:17,0,0,0,10.0,0:0,700000
8479944,Zach,Aston-Reese,1994-08-10,C,L,2019-20,57,6,7,13,0.23,6,98,6.12,28,49343.0,14:25,7,16,23,30.43,136,30,20,21,-1,0,0,0,1799.0,0:31,1,0,1,5443.0,1:35,1000000
8479977,Kailer,Yamamoto,1998-09-29,RW,R,2019-20,27,11,15,26,0.96,17,44,25.0,12,28164.0,17:23,1,0,1,100.0,45,13,19,10,9,2,0,2,1426.0,0:52,0,0,0,93.0,0:3,894166
8479980,Nicolas,Hague,1998-12-05,D,L,2019-20,38,1,10,11,0.29,1,54,1.85,32,36670.0,16:5,0,0,0,0.0,69,26,13,10,3,1,3,4,2084.0,0:54,0,0,0,57.0,0:1,791667
8479982,Conor,Timmins,1998-09-18,D,R,2019-20,2,0,0,0,0.0,2,1,0.0,0,1249.0,10:24,0,0,0,0.0,0,0,1,0,1,0,0,0,4.0,0:2,0,0,0,73.0,0:36,925000
8479983,Mario,Ferraro,1998-09-17,D,L,2019-20,61,2,9,11,0.18,-15,63,3.17,30,58148.0,15:53,0,0,0,0.0,120,58,15,20,-5,0,0,0,1129.0,0:18,0,1,1,2770.0,0:45,925000
8479985,Cale,Fleury,1998-11-19,D,R,2019-20,41,1,0,1,0.02,-4,45,2.22,6,35305.0,14:21,0,0,0,0.0,102,45,5,31,-26,0,0,0,29.0,0:0,0,0,0,1900.0,0:46,771666
8479987,Morgan,Geekie,1998-07-20,C,R,2019-20,2,3,1,4,2.0,3,4,75.0,2,1414.0,11:47,12,10,22,54.55,1,4,1,0,1,0,0,0,212.0,1:46,0,0,0,82.0,0:41,763333
8479994,Jaret,Anderson-Dolan,1999-09-12,C,L,2019-20,4,0,0,0,0.0,-1,2,0.0,0,2462.0,10:15,5,8,13,38.46,3,0,0,2,-2,0,0,0,49.0,0:12,0,0,0,0.0,0:0,747500
8479996,Cody,Glass,1999-04-01,C,R,2019-20,39,5,7,12,0.31,-6,51,9.8,6,31249.0,13:21,60,83,143,41.96,15,6,18,17,1,1,5,6,5210.0,2:13,0,0,0,61.0,0:1,863333
8479998,Mikey,Anderson,1999-05-25,D,L,2019-20,6,1,0,1,0.17,4,9,11.11,0,6532.0,18:8,0,0,0,0.0,10,10,0,2,-2,0,0,0,0.0,0:0,0,0,0,520.0,1:26,925000
8479999,Casey,Mittelstadt,1998-11-22,C,L,2019-20,31,4,5,9,0.29,-5,34,11.76,2,23734.0,12:45,86,99,185,46.49,11,8,6,9,-3,1,1,2,3310.0,1:46,0,0,0,10.0,0:0,925000
8480001,Urho,Vaakanainen,1999-01-01,D,L,2019-20,5,0,0,0,0.0,2,2,0.0,0,5056.0,16:51,0,0,0,0.0,8,3,1,3,-2,0,0,0,106.0,0:21,0,0,0,361.0,1:12,894167
8480002,Nico,Hischier,1999-01-04,C,L,2019-20,58,14,22,36,0.62,-16,123,11.38,12,62852.0,18:3,507,473,980,51.73,48,37,42,28,14,2,8,10,9356.0,2:41,1,1,2,3201.0,0:55,925000
8480003,Jesper,Boqvist,1998-10-30,C,L,2019-20,35,4,0,4,0.11,-11,41,9.76,8,22994.0,10:56,5,11,16,31.25,37,16,13,11,2,1,0,1,1682.0,0:48,0,0,0,22.0,0:0,925000
8480011,Klim,Kostin,1999-05-05,C,L,2019-20,4,1,0,1,0.25,1,5,20.0,0,2049.0,8:32,0,0,0,0.0,6,0,0,1,-1,0,0,0,0.0,0:0,0,0,0,0.0,0:0,863333
8480012,Elias,Pettersson,1998-11-12,C,L,2019-20,68,27,39,66,0.97,17,162,16.67,18,75607.0,18:31,59,82,141,41.84,63,42,36,33,3,8,15,23,15821.0,3:52,0,0,0,126.0,0:1,925000
8480014,Gabriel,Vilardi,1999-08-16,C,R,2019-20,10,3,4,7,0.7,0,19,15.79,4,7710.0,12:51,49,43,92,53.26,1,4,1,0,1,1,1,2,861.0,1:26,0,0,0,5.0,0:0,894167
8480018,Nick,Suzuki,1999-08-10,C,R,2019-20,71,13,28,41,0.58,-15,138,9.42,6,68116.0,15:59,305,354,659,46.28,64,32,31,37,-6,6,8,14,9251.0,2:10,0,0,0,1263.0,0:17,863333
8480021,Jack,Studnicka,1999-02-18,C,R,2019-20,3,0,1,1,0.33,2,6,0.0,2,2151.0,11:57,10,6,16,62.5,2,0,0,3,-3,0,0,0,281.0,1:33,0,0,0,0.0,0:0,769167
8480023,Robert,Thomas,1999-07-02,C,R,2019-20,68,11,32,43,0.63,9,90,12.22,20,59415.0,14:33,139,185,324,42.9,13,13,46,30,16,1,6,7,6047.0,1:28,0,0,0,52.0,0:0,894166
8480027,Jason,Robertson,1999-07-22,LW,L,2019-20,3,0,1,1,0.33,0,4,0.0,0,2218.0,12:19,0,0,0,0.0,1,0,1,0,1,0,1,1,219.0,1:13,0,0,0,0.0,0:0,795000
8480028,Morgan,Frost,1999-05-14,C,L,2019-20,20,2,5,7,0.35,-3,31,6.45,4,16420.0,13:41,44,49,93,47.31,4,4,10,6,4,0,0,0,2717.0,2:15,1,0,1,19.0,0:0,863333
8480031,Max,Comtois,1999-01-08,LW,L,2019-20,29,5,6,11,0.38,-4,32,15.62,24,24314.0,13:58,3,13,16,18.75,61,8,5,19,-14,2,1,3,3879.0,2:13,0,0,0,159.0,0:5,820000
8480035,Henri,Jokiharju,1999-06-17,D,R,2019-20,69,4,11,15,0.22,-6,78,5.13,32,71278.0,17:13,0,0,0,0.0,74,63,7,30,-23,1,1,2,777.0,0:11,0,0,0,4514.0,1:5,925000
8480036,Miro,Heiskanen,1999-07-18,D,L,2019-20,71,8,31,39,0.55,14,171,4.68,14,101171.0,23:44,0,0,0,0.0,42,85,46,81,-35,0,8,8,9977.0,2:20,0,0,0,8711.0,2:2,894166
8480039,Martin,Necas,1999-01-15,C,R,2019-20,64,16,20,36,0.56,-6,88,18.18,20,54401.0,14:10,13,35,48,27.08,65,19,23,36,-13,5,4,9,6925.0,1:48,0,0,0,106.0,0:1,863333
8480043,Timothy,Liljegren,1999-04-30,D,R,2019-20,11,0,1,1,0.09,-5,2,0.0,2,6794.0,10:17,0,0,0,0.0,8,10,0,6,-6,0,0,0,0.0,0:0,0,0,0,348.0,0:31,863333
8480064,Josh,Norris,1999-05-05,C,L,2019-20,3,0,0,0,0.0,2,9,0.0,0,3225.0,17:55,30,19,49,61.22,3,2,1,0,1,0,0,0,504.0,2:48,0,0,0,0.0,0:0,925000
8480068,Ryan,Poehling,1999-01-03,C,L,2019-20,27,1,1,2,0.07,-4,26,3.85,4,16753.0,10:20,3,12,15,20.0,38,10,7,8,-1,0,0,0,400.0,0:14,0,0,0,970.0,0:35,925000
8480069,Cale,Makar,1998-10-30,D,R,2019-20,60,13,38,51,0.85,15,129,10.08,12,75907.0,21:5,0,0,0,0.0,50,48,34,41,-7,5,15,20,13931.0,3:52,0,0,0,351.0,0:5,880833
8480072,Lias,Andersson,1998-10-13,C,L,2019-20,17,0,1,1,0.06,-8,13,0.0,4,9735.0,9:32,41,47,88,46.59,20,8,8,4,4,0,0,0,55.0,0:3,0,0,0,2040.0,2:0,894166
8480073,Erik,Brannstrom,1999-09-02,D,L,2019-20,31,0,4,4,0.13,-9,38,0.0,16,27607.0,14:50,0,0,0,0.0,15,36,5,20,-15,0,1,1,2761.0,1:29,0,0,0,331.0,0:10,863333
8480074,Alexandre,Texier,1999-09-13,C,L,2019-20,36,6,7,13,0.36,3,49,12.24,10,27536.0,12:44,23,40,63,36.51,20,7,16,12,4,0,1,1,1203.0,0:33,0,0,0,79.0,0:2,897500
8480078,Filip,Chytil,1999-09-05,C,L,2019-20,60,14,9,23,0.38,-7,114,12.28,10,53427.0,14:50,198,317,515,38.45,13,31,33,33,0,1,2,3,4610.0,1:16,0,0,0,99.0,0:1,894166
8480113,Alex,Iafallo,1993-12-21,C,L,2019-20,70,17,26,43,0.61,1,142,11.97,14,79496.0,18:55,11,12,23,47.83,49,47,18,11,7,6,3,9,10405.0,2:28,0,0,0,6083.0,1:26,2425000
8480144,David,Kampf,1995-01-12,C,L,2019-20,70,8,8,16,0.23,-11,90,8.89,8,57401.0,13:40,313,285,598,52.34,52,26,37,17,20,0,0,0,173.0,0:2,1,0,1,9099.0,2:9,1000000
8480145,Neal,Pionk,1995-07-29,D,R,2019-20,71,6,39,45,0.63,10,177,3.39,32,99582.0,23:22,0,0,0,0.0,165,78,31,62,-31,3,22,25,12463.0,2:55,0,0,0,3827.0,0:53,3000000
8480147,Oscar,Fantenberg,1991-10-07,D,L,2019-20,36,1,5,6,0.17,-10,45,2.22,6,34376.0,15:54,0,0,0,0.0,67,62,7,11,-4,0,1,1,71.0,0:1,0,0,0,2723.0,1:15,850000
8480157,Calle,Rosen,1994-02-02,D,L,2019-20,12,0,3,3,0.25,0,14,0.0,4,9775.0,13:34,0,0,0,0.0,3,7,2,8,-6,0,0,0,429.0,0:35,0,0,0,21.0,0:1,750000
8480160,Radim,Simek,1992-09-20,D,L,2019-20,48,2,7,9,0.19,-13,40,5.0,14,49478.0,17:10,0,0,0,0.0,91,60,20,36,-16,0,0,0,114.0,0:2,0,0,0,4863.0,1:41,675000
8480172,Jan,Rutta,1990-07-29,D,R,2019-20,34,1,6,7,0.21,6,44,2.27,14,31791.0,15:35,0,0,0,0.0,19,24,2,9,-7,0,0,0,82.0,0:2,0,0,0,3435.0,1:41,1300000
8480184,Gustav,Lindstrom,1998-10-20,D,R,2019-20,16,0,1,1,0.06,-6,9,0.0,14,15877.0,16:32,0,0,0,0.0,19,15,3,7,-4,0,1,1,694.0,0:43,0,0,0,1297.0,1:21,775833
8480185,Eetu,Luostarinen,1998-09-02,C,L,2019-20,8,0,1,1,0.12,-2,9,0.0,0,4791.0,9:58,33,30,63,52.38,9,2,2,1,1,0,0,0,8.0,0:1,0,0,0,0.0,0:0,897500
8480186,Alexander,Volkov,1997-08-02,RW,L,2019-20,9,0,1,1,0.11,-6,7,0.0,6,5541.0,10:15,1,3,4,25.0,10,2,4,2,2,0,0,0,0.0,0:0,0,0,0,0.0,0:0,864167
8480205,Emil,Bemstrom,1999-06-01,C,R,2019-20,56,10,10,20,0.36,-10,97,10.31,8,41223.0,12:16,4,9,13,30.77,52,17,10,16,-6,5,3,8,4533.0,1:20,0,0,0,5.0,0:0,925000
8480208,Drake,Batherson,1998-04-27,C,R,2019-20,23,3,7,10,0.43,-12,32,9.38,13,21477.0,15:33,4,3,7,57.14,51,11,5,5,0,1,5,6,3071.0,2:13,0,0,0,18.0,0:0,736666
8480247,Jonathan,Davidsson,1997-03-12,RW,R,2019-20,6,0,1,1,0.17,0,3,0.0,0,1988.0,5:31,0,0,0,0.0,5,1,0,0,0,0,0,0,0.0,0:0,0,0,0,0.0,0:0,768333
8480314,Max,Veronneau,1995-12-12,RW,R,2019-20,4,0,0,0,0.0,-2,3,0.0,0,2020.0,8:25,0,0,0,0.0,2,2,0,1,-1,0,0,0,49.0,0:12,0,0,0,0.0,0:0,925000
8480326,Sheldon,Dries,1994-04-23,C,L,2019-20,5,0,0,0,0.0,-2,2,0.0,0,2059.0,6:51,4,2,6,66.67,16,2,0,1,-1,0,0,0,0.0,0:0,0,0,0,0.0,0:0,735000
8480336,Sean,Walker,1994-11-13,D,R,2019-20,70,5,19,24,0.34,-12,127,3.94,26,79078.0,18:49,0,0,0,0.0,81,84,25,65,-40,0,5,5,3438.0,0:49,0,0,0,5122.0,1:13,745000
8480341,Adam,Johnson,1994-06-22,C,L,2019-20,7,1,1,2,0.29,-1,5,20.0,2,2812.0,6:41,0,0,0,0.0,4,3,1,1,0,0,0,0,0.0,0:0,0,0,0,13.0,0:1,700000
8480384,Alexander,True,1997-07-17,C,L,2019-20,12,0,4,4,0.33,1,12,0.0,2,7203.0,10:0,32,37,69,46.38,23,2,2,5,-3,0,0,0,185.0,0:15,0,0,0,67.0,0:5,763333
8480727,Zach,Whitecloud,1996-11-28,D,R,2019-20,19,1,2,3,0.16,3,11,9.09,4,16260.0,14:15,0,0,0,0.0,17,21,8,3,5,0,0,0,0.0,0:0,0,0,0,1627.0,1:25,925000
8480748,Kiefer,Sherwood,1995-03-31,RW,R,2019-20,10,0,1,1,0.1,-1,17,0.0,6,7996.0,13:19,3,1,4,75.0,24,4,4,7,-3,0,0,0,25.0,0:2,0,0,0,606.0,1:0,925000
8480769,Joel,L'Esperance,1995-08-18,RW,R,2019-20,3,1,0,1,0.33,0,2,50.0,2,1322.0,7:20,0,1,1,0.0,1,1,1,2,-1,0,0,0,204.0,1:8,0,0,0,25.0,0:8,722500
8480780,Lukas,Radil,1990-08-05,C,R,2019-20,14,0,0,0,0.0,-3,12,0.0,8,7895.0,9:23,1,3,4,25.0,16,2,4,4,0,0,0,0,37.0,0:2,0,0,0,0.0,0:0,700000
8480789,Oliver,Wahlstrom,2000-06-13,RW,R,2019-20,9,0,0,0,0.0,-2,9,0.0,4,5556.0,10:17,0,3,3,0.0,10,4,1,5,-4,0,0,0,510.0,0:56,0,0,0,0.0,0:0,925000
8480796,Martin,Fehervary,1999-10-06,D,L,2019-20,7,0,1,1,0.14,-2,7,0.0,6,6665.0,15:52,0,0,0,0.0,21,3,2,3,-1,0,0,0,33.0,0:4,0,0,0,289.0,0:41,805833
8480797,Joel,Farabee,2000-02-25,LW,L,2019-20,54,9,14,23,0.43,7,85,10.59,39,45577.0,14:4,3,8,11,27.27,31,18,22,27,-5,1,1,2,4532.0,1:23,0,0,0,849.0,0:15,925000
8480800,Quinn,Hughes,1999-10-14,D,L,2019-20,68,8,45,53,0.78,-10,126,6.35,22,89289.0,21:53,0,0,0,0.0,7,46,35,60,-25,3,22,25,15554.0,3:48,0,0,0,188.0,0:2,916667
8480801,Brady,Tkachuk,1999-09-16,LW,L,2019-20,71,21,23,44,0.62,-14,259,8.11,106,80660.0,18:56,144,168,312,46.15,303,43,35,40,-5,2,6,8,12466.0,2:55,0,0,0,202.0,0:2,925000
8480806,Isac,Lundestrom,1999-11-06,C,L,2019-20,15,0,4,4,0.27,-2,10,0.0,0,12519.0,13:54,65,74,139,46.76,5,8,4,2,2,0,1,1,1426.0,1:35,0,0,0,227.0,0:15,925000
8480814,Nicolas,Beaudin,1999-10-07,D,L,2019-20,1,0,0,0,0.0,1,2,0.0,0,1021.0,17:1,0,0,0,0.0,2,2,0,1,-1,0,0,0,0.0,0:0,0,0,0,0.0,0:0,894167
8480821,Filip,Zadina,1999-11-27,RW,L,2019-20,28,8,7,15,0.54,-13,60,13.33,2,25491.0,15:10,1,0,1,100.0,11,10,12,17,-5,4,3,7,4250.0,2:31,0,0,0,20.0,0:0,894167
8480822,Martin,Kaut,1999-10-02,RW,R,2019-20,9,2,1,3,0.33,-1,13,15.38,2,5474.0,10:8,1,0,1,100.0,9,0,2,0,2,1,0,1,415.0,0:46,0,0,0,0.0,0:0,894167
8480829,Jesperi,Kotkaniemi,2000-07-06,C,L,2019-20,36,6,2,8,0.22,-11,55,10.91,23,28066.0,12:59,125,167,292,42.81,51,16,14,21,-7,1,1,2,3726.0,1:43,0,0,0,9.0,0:0,925000
8480830,Andrei,Svechnikov,2000-03-26,RW,L,2019-20,68,24,37,61,0.9,9,183,13.11,54,68291.0,16:44,0,1,1,0.0,116,27,29,66,-37,6,14,20,12065.0,2:57,0,0,0,66.0,0:0,925000
8480839,Rasmus,Dahlin,2000-04-13,D,L,2019-20,59,4,36,40,0.68,-7,90,4.44,38,68306.0,19:17,0,0,0,0.0,72,51,16,43,-27,2,17,19,11890.0,3:21,0,0,0,344.0,0:5,925000
8480849,Barrett,Hayton,2000-06-09,C,L,2019-20,20,1,3,4,0.2,2,27,3.7,14,13371.0,11:8,23,38,61,37.7,14,3,8,4,4,0,0,0,365.0,0:18,0,0,0,5.0,0:0,894167
8480853,Liam,Foudy,2000-02-04,C,L,2019-20,2,0,1,1,0.5,1,3,0.0,0,1706.0,14:13,0,0,0,0.0,3,0,1,0,1,0,0,0,0.0,0:0,0,0,0,0.0,0:0,894167
8480865,Noah,Dobson,2000-01-07,D,R,2019-20,34,1,6,7,0.21,-1,37,2.7,8,27085.0,13:16,0,0,0,0.0,25,31,8,24,-16,0,1,1,1827.0,0:53,0,0,0,117.0,0:3,894167
8480871,Adam,Boqvist,2000-08-15,D,R,2019-20,41,4,9,13,0.32,-3,50,8.0,6,39907.0,16:13,0,0,0,0.0,33,43,10,26,-16,0,2,2,5339.0,2:10,0,0,0,41.0,0:1,894167
8480873,Rasmus,Sandin,2000-03-07,D,L,2019-20,28,1,7,8,0.29,-7,22,4.55,10,24049.0,14:18,0,0,0,0.0,33,22,2,15,-13,0,2,2,1243.0,0:44,0,0,0,449.0,0:16,894167
8480901,Karson,Kuhlman,1995-09-26,C,R,2019-20,27,1,5,6,0.22,2,50,2.0,13,20318.0,12:32,1,5,6,16.67,41,8,3,5,-2,1,0,1,138.0,0:5,0,0,0,999.0,0:37,750000
8480913,Jordan,Gross,1995-05-09,D,R,2019-20,2,0,1,1,0.5,2,3,0.0,0,1941.0,16:10,0,0,0,0.0,0,1,1,2,-1,0,0,0,0.0,0:0,0,0,0,64.0,0:32,925000
8480935,Lawrence,Pilut,1995-12-30,D,L,2019-20,13,0,0,0,0.0,-4,6,0.0,4,12668.0,16:14,0,0,0,0.0,10,19,2,4,-2,0,0,0,39.0,0:3,0,0,0,1168.0,1:29,925000
8480940,Joel,Persson,1994-03-04,D,R,2019-20,13,0,2,2,0.15,-1,17,0.0,2,11944.0,15:18,0,0,0,0.0,6,10,2,8,-6,0,0,0,218.0,0:16,0,0,0,34.0,0:2,1000000
8480944,Par,Lindholm,1991-10-05,C,L,2019-20,40,3,3,6,0.15,6,35,8.57,4,26987.0,11:14,132,156,288,45.83,23,26,14,13,1,0,0,0,10.0,0:0,0,0,0,4118.0,1:42,850000
8480945,Juuso,Riikola,1993-11-09,D,L,2019-20,36,1,6,7,0.19,3,38,2.63,6,29993.0,13:53,0,0,0,0.0,74,24,8,16,-8,0,2,2,2506.0,1:9,0,0,0,161.0,0:4,850000
8480946,Dominik,Kahun,1995-07-02,C,L,2019-20,56,12,19,31,0.55,8,87,13.79,8,44633.0,13:17,29,31,60,48.33,5,22,18,9,9,1,1,2,3535.0,1:3,0,0,0,28.0,0:0,925000
8480950,Ilya,Lyubushkin,1994-04-06,D,R,2019-20,51,0,4,4,0.08,4,41,0.0,18,43426.0,14:11,0,0,0,0.0,151,53,13,20,-7,0,0,0,67.0,0:1,0,0,0,451.0,0:8,874125
8480965,Antti,Suomela,1994-03-17,C,L,2019-20,20,1,6,7,0.35,4,18,5.56,4,11626.0,9:41,51,42,93,54.84,27,5,6,4,2,0,0,0,57.0,0:2,0,0,0,326.0,0:16,700000
8481019,David,Gustafsson,2000-04-11,C,L,2019-20,22,1,0,1,0.05,-2,4,25.0,0,8108.0,6:8,33,30,63,52.38,5,6,0,1,-1,0,0,0,11.0,0:0,0,0,0,60.0,0:2,817500
8481105,Otto,Leskinen,1997-02-06,D,L,2019-20,5,0,0,0,0.0,0,2,0.0,0,3088.0,10:17,0,0,0,0.0,13,1,1,5,-4,0,0,0,0.0,0:0,0,0,0,0.0,0:0,925000
8481186,Logan,O'Connor,1996-08-14,RW,R,2019-20,16,2,0,2,0.12,0,15,13.33,2,8093.0,8:25,0,1,1,0.0,20,8,5,0,5,0,0,0,84.0,0:5,0,0,0,278.0,0:17,925000
8481433,Taro,Hirose,1996-06-30,LW,L,2019-20,26,2,5,7,0.27,-12,21,9.52,6,19585.0,12:33,0,5,5,0.0,13,16,6,20,-14,0,5,5,3883.0,2:29,0,0,0,74.0,0:2,925000
8481477,Nico,Sturm,1995-05-03,C,L,2019-20,6,0,2,2,0.33,2,2,0.0,0,4282.0,11:53,26,23,49,53.06,6,5,1,1,0,0,0,0,1.0,0:0,0,0,0,179.0,0:29,874125
8481481,Blake,Lizotte,1997-12-13,C,L,2019-20,65,6,17,23,0.35,-4,87,6.9,20,54444.0,13:57,312,310,622,50.16,42,22,22,21,1,2,1,3,3998.0,1:1,2,1,3,4314.0,1:6,925000
8481515,Danil,Yurtaykin,1997-07-01,LW,R,2019-20,4,0,0,0,0.0,-1,2,0.0,0,3120.0,13:0,0,0,0,0.0,3,2,2,0,2,0,0,0,256.0,1:4,0,0,0,2.0,0:0,925000
8481516,Joel,Kellman,1994-05-25,C,L,2019-20,31,3,4,7,0.23,-1,31,9.68,4,21537.0,11:34,112,126,238,47.06,28,18,8,8,0,0,0,0,62.0,0:2,0,1,1,1633.0,0:52,925000
8481523,Kirby,Dach,2001-01-21,C,R,2019-20,64,8,15,23,0.36,-1,101,7.92,24,54780.0,14:15,75,147,222,33.78,33,23,38,16,22,0,3,3,6025.0,1:34,0,0,0,136.0,0:2,925000
8481554,Kaapo,Kakko,2001-02-13,RW,L,2019-20,66,10,13,23,0.35,-26,109,9.17,14,56544.0,14:16,2,4,6,33.33,20,11,35,21,14,2,11,13,8821.0,2:13,0,0,0,74.0,0:1,925000
8481559,Jack,Hughes,2001-05-14,C,L,2019-20,61,7,14,21,0.34,-26,123,5.69,10,58067.0,15:51,167,295,462,36.15,12,21,42,53,-11,4,5,9,11622.0,3:10,0,0,0,66.0,0:1,925000
8481572,Ville,Heinola,2001-03-02,D,L,2019-20,8,1,4,5,0.62,3,10,10.0,4,8670.0,18:3,0,0,0,0.0,3,5,3,15,-12,0,1,1,430.0,0:53,0,0,0,37.0,0:4,925000
8481624,Ilya,Mikheyev,1994-10-10,RW,L,2019-20,39,8,15,23,0.59,7,98,8.16,4,36448.0,15:34,3,1,4,75.0,26,13,24,14,10,0,0,0,183.0,0:4,1,0,1,4503.0,1:55,925000
8481630,Alexander,Yelesin,1996-02-07,D,R,2019-20,4,0,0,0,0.0,0,2,0.0,0,2998.0,12:29,0,0,0,0.0,13,0,0,2,-2,0,0,0,0.0,0:0,0,0,0,0.0,0:0,925000
8481637,Anton,Wedin,1993-03-01,LW,L,2019-20,4,0,0,0,0.0,1,2,0.0,4,2177.0,9:4,0,0,0,0.0,5,1,1,0,1,0,0,0,0.0,0:0,0,0,0,0.0,0:0,925000
8481638,Joakim,Nygard,1993-01-08,LW,L,2019-20,33,3,6,9,0.27,0,39,7.69,8,21164.0,10:41,3,3,6,50.0,18,8,14,10,4,1,0,1,984.0,0:29,0,0,0,23.0,0:0,925000
8481640,Lean,Bergmann,1998-10-04,C,L,2019-20,12,0,1,1,0.08,-6,11,0.0,4,5953.0,8:16,0,2,2,0.0,29,5,3,0,3,0,0,0,21.0,0:1,0,0,0,47.0,0:3,836667
8481641,Joel,Kiviranta,1996-03-23,LW,L,2019-20,12,1,0,1,0.08,-1,15,6.67,4,7418.0,10:18,0,0,0,0.0,17,4,5,3,2,0,0,0,10.0,0:0,0,0,0,67.0,0:5,925000
8481642,Andrei,Chibisov,1993-02-26,RW,L,2019-20,2,0,0,0,0.0,0,1,0.0,0,894.0,7:27,0,0,0,0.0,1,1,0,0,0,0,0,0,0.0,0:0,0,0,0,0.0,0:0,792500
8481649,Joona,Luoto,1997-09-26,LW,L,2019-20,16,0,0,0,0.0,-3,9,0.0,2,6326.0,6:35,0,0,0,0.0,10,8,3,5,-2,0,0,0,2.0,0:0,0,0,0,70.0,0:4,741667
8481650,Jakob,Lilja,1993-07-23,LW,L,2019-20,37,2,3,5,0.14,5,23,8.7,2,21968.0,9:53,2,2,4,50.0,18,25,9,8,1,0,0,0,66.0,0:1,0,0,0,205.0,0:5,842500
8481813,Gaetan,Haas,1992-01-31,C,R,2019-20,58,5,5,10,0.17,-1,54,9.26,6,33749.0,9:41,172,236,408,42.16,58,28,22,22,0,0,1,1,1197.0,0:20,0,0,0,265.0,0:4,925000
